image_name,width,height,x0,y0,x1,y1,out_of_bounds,bbox_width,bbox_height,bbox_area
00001722.jpg,1333,2000,490,320,687,664,False,197,344,67768
00001044.jpg,2000,1333,791,119,1200,436,False,409,317,129653
00001050.jpg,667,1000,304,155,407,331,False,103,176,18128
00001736.jpg,626,417,147,14,519,303,False,372,289,107508
00003121.jpg,626,418,462,60,599,166,False,137,106,14522
00003121.jpg,626,418,316,157,441,254,False,125,97,12125
00003121.jpg,626,418,35,71,160,168,False,125,97,12125
00003121.jpg,626,418,254,94,376,187,False,122,93,11346
00003121.jpg,626,418,166,118,306,226,False,140,108,15120
00000400.jpg,600,400,148,61,377,242,False,229,181,41449
00002571.jpg,960,720,117,159,317,334,False,200,175,35000
00002571.jpg,960,720,596,203,772,354,False,176,151,26576
00000366.jpg,900,601,170,88,506,350,False,336,262,88032
00000366.jpg,900,601,303,2,639,144,False,336,142,47712
00002565.jpg,1267,712,241,40,963,513,False,722,473,341506
00001939.jpg,612,424,195,57,383,209,False,188,152,28576
00001087.jpg,1024,683,405,27,614,189,False,209,162,33858
00001093.jpg,821,1300,290,28,392,211,False,102,183,18666
00001905.jpg,612,408,137,20,394,224,False,257,204,52428
00001911.jpg,792,463,317,187,442,272,False,125,85,10625
00001911.jpg,792,463,386,110,570,236,False,184,126,23184
00001911.jpg,792,463,231,42,411,165,False,180,123,22140
00002997.jpg,882,588,269,245,363,318,False,94,73,6862
00002997.jpg,882,588,372,23,484,109,False,112,86,9632
00002997.jpg,882,588,567,113,682,202,False,115,89,10235
00003451.jpg,236,354,87,46,131,121,False,44,75,3300
00001246.jpg,600,419,210,32,361,158,False,151,126,19026
00001520.jpg,1098,732,684,251,987,486,False,303,235,71205
00001520.jpg,1098,732,34,195,344,435,False,310,240,74400
00001520.jpg,1098,732,375,279,678,509,False,303,230,69690
00001520.jpg,1098,732,486,239,796,474,False,310,235,72850
00001520.jpg,1098,732,913,215,1097,446,False,184,231,42504
00002029.jpg,345,520,149,66,207,167,False,58,101,5858
00003337.jpg,500,500,173,8,252,100,False,79,92,7268
00003337.jpg,500,500,176,219,248,304,False,72,85,6120
00003337.jpg,500,500,24,298,82,365,False,58,67,3886
00003323.jpg,408,612,170,77,247,208,False,77,131,10087
00001252.jpg,343,280,144,31,211,94,False,67,63,4221
00002983.jpg,1200,939,435,149,553,254,False,118,105,12390
00002983.jpg,1200,939,315,146,418,237,False,103,91,9373
00003445.jpg,236,314,44,21,95,97,False,51,76,3876
00002015.jpg,684,1024,147,71,528,720,False,381,649,247269
00000602.jpg,1300,956,368,184,622,402,False,254,218,55372
00000602.jpg,1300,956,696,360,980,608,False,284,248,70432
00000602.jpg,1300,956,900,461,1154,684,False,254,223,56642
00000602.jpg,1300,956,52,329,435,656,False,383,327,125241
00000602.jpg,1300,956,726,149,954,345,False,228,196,44688
00000616.jpg,910,607,458,373,644,514,False,186,141,26226
00002001.jpg,1500,1120,564,1,960,328,False,396,327,129492
00002767.jpg,900,600,240,36,864,531,False,624,495,308880
00000170.jpg,626,418,299,72,368,127,False,69,55,3795
00000170.jpg,626,418,363,155,442,217,False,79,62,4898
00000170.jpg,626,418,421,38,499,98,False,78,60,4680
00000170.jpg,626,418,294,134,369,192,False,75,58,4350
00002954.jpg,866,1300,166,448,355,778,False,189,330,62370
00002954.jpg,866,1300,339,62,528,384,False,189,322,60858
00002954.jpg,866,1300,553,505,726,801,False,173,296,51208
00003492.jpg,236,354,101,26,145,103,False,44,77,3388
00000825.jpg,367,550,161,32,236,163,False,75,131,9825
00000831.jpg,800,450,154,7,685,362,False,531,355,188505
00002798.jpg,1000,667,106,332,264,454,False,158,122,19276
00002798.jpg,1000,667,577,288,735,410,False,158,122,19276
00002798.jpg,1000,667,405,316,550,428,False,145,112,16240
00002798.jpg,1000,667,263,334,390,435,False,127,101,12827
00002798.jpg,1000,667,764,322,918,442,False,154,120,18480
00002940.jpg,1062,1092,386,360,481,474,False,95,114,10830
00002940.jpg,1062,1092,574,361,678,488,False,104,127,13208
00003486.jpg,236,157,64,24,169,106,False,105,82,8610
00000819.jpg,1024,683,289,20,640,292,False,351,272,95472
00001332.jpg,600,620,237,2,376,167,False,139,165,22935
00000992.jpg,1125,750,479,194,694,357,False,215,163,35045
00003243.jpg,500,488,157,284,215,350,False,58,66,3828
00000986.jpg,1600,900,832,488,1380,854,False,548,366,200568
00000986.jpg,1600,900,158,347,786,748,False,628,401,251828
00001440.jpg,3850,2567,1204,564,2289,1406,False,1085,842,913570
00001326.jpg,626,417,130,35,303,172,False,173,137,23701
00002607.jpg,626,417,279,48,456,185,False,177,137,24249
00002607.jpg,626,417,93,109,281,255,False,188,146,27448
00002607.jpg,626,417,368,144,560,293,False,192,149,28608
00002607.jpg,626,417,208,177,397,323,False,189,146,27594
00002161.jpg,1000,730,70,140,172,227,False,102,87,8874
00002161.jpg,1000,730,407,101,505,182,False,98,81,7938
00002161.jpg,1000,730,273,283,371,364,False,98,81,7938
00001468.jpg,600,419,276,55,589,309,False,313,254,79502
00000762.jpg,800,583,482,22,622,141,False,140,119,16660
00002613.jpg,2000,1333,369,324,984,800,False,615,476,292740
00002613.jpg,2000,1333,876,381,1465,838,False,589,457,269173
00000004.jpg,1000,1241,476,177,588,335,False,112,158,17696
00000789.jpg,2000,3019,735,296,1171,1062,False,436,766,333976
00000951.jpg,1356,1681,376,164,619,516,False,243,352,85536
00001497.jpg,600,336,125,26,344,172,False,219,146,31974
00001483.jpg,960,580,156,4,860,489,False,704,485,341440
00002808.jpg,500,333,179,59,336,183,False,157,124,19468
00003041.jpg,800,533,312,64,639,323,False,327,259,84693
00003041.jpg,800,533,145,149,444,376,False,299,227,67873
00000548.jpg,508,339,395,100,506,188,False,111,88,9768
00000548.jpg,508,339,78,1,179,76,False,101,75,7575
00000548.jpg,508,339,389,16,499,102,False,110,86,9460
00000548.jpg,508,339,141,67,267,164,False,126,97,12222
00000548.jpg,508,339,268,2,381,86,False,113,84,9492
00000548.jpg,508,339,239,90,347,174,False,108,84,9072
00000548.jpg,508,339,2,35,130,159,False,128,124,15872
00000548.jpg,508,339,199,1,305,69,False,106,68,7208
00001656.jpg,650,433,329,16,443,105,False,114,89,10146
00001130.jpg,867,1300,131,1,442,422,False,311,421,130931
00001124.jpg,500,333,81,1,412,183,False,331,182,60242
00001642.jpg,1125,750,452,219,677,393,False,225,174,39150
00003055.jpg,1300,957,191,187,527,475,False,336,288,96768
00003055.jpg,1300,957,689,162,979,416,False,290,254,73660
00002405.jpg,2048,1365,1266,105,1634,397,False,368,292,107456
00000206.jpg,1000,667,527,87,803,296,False,276,209,57684
00002411.jpg,840,560,470,76,678,237,False,208,161,33488
00003069.jpg,1023,713,224,319,483,529,False,259,210,54390
00003069.jpg,1023,713,62,302,276,472,False,214,170,36380
00003069.jpg,1023,713,415,294,633,467,False,218,173,37714
00003069.jpg,1023,713,566,314,749,460,False,183,146,26718
00003069.jpg,1023,713,664,428,844,573,False,180,145,26100
00003069.jpg,1023,713,722,315,993,539,False,271,224,60704
00003069.jpg,1023,713,1,364,139,513,False,138,149,20562
00003069.jpg,1023,713,859,328,1017,505,False,158,177,27966
00000560.jpg,1500,1001,769,81,1271,464,False,502,383,192266
00000560.jpg,1500,1001,335,244,1082,810,False,747,566,422802
00000560.jpg,1500,1001,417,50,814,351,False,397,301,119497
00000560.jpg,1500,1001,1,22,477,497,False,476,475,226100
00000560.jpg,1500,1001,1038,61,1499,590,False,461,529,243869
00001695.jpg,323,254,98,62,211,166,False,113,104,11752
00001681.jpg,626,417,250,48,386,156,False,136,108,14688
00001859.jpg,678,1024,313,126,397,274,False,84,148,12432
00001871.jpg,390,280,127,33,273,152,False,146,119,17374
00001865.jpg,1050,700,335,26,827,408,False,492,382,187944
00001864.jpg,1300,866,476,81,606,182,False,130,101,13130
00001870.jpg,676,1023,103,44,434,614,False,331,570,188670
00001858.jpg,1600,1156,890,74,1286,407,False,396,333,131868
00001680.jpg,600,419,245,43,358,134,False,113,91,10283
00003097.jpg,612,408,420,149,522,229,False,102,80,8160
00003097.jpg,612,408,295,66,434,175,False,139,109,15151
00003097.jpg,612,408,403,87,508,167,False,105,80,8400
00003083.jpg,1000,1500,379,207,490,402,False,111,195,21645
00001694.jpg,319,450,109,27,182,146,False,73,119,8687
00000207.jpg,1024,682,639,136,758,228,False,119,92,10948
00001119.jpg,400,600,133,1,238,176,False,105,175,18375
00000561.jpg,8192,5461,3976,2375,5544,3592,False,1568,1217,1908256
00000561.jpg,8192,5461,5212,2211,6815,3455,False,1603,1244,1994132
00000561.jpg,8192,5461,3189,1596,4567,2665,False,1378,1069,1473082
00000561.jpg,8192,5461,2145,1749,3748,2993,False,1603,1244,1994132
00003068.jpg,960,640,307,176,658,448,False,351,272,95472
00002376.jpg,800,547,162,39,741,500,False,579,461,266919
00000213.jpg,735,490,212,39,499,261,False,287,222,63714
00001125.jpg,1000,569,381,77,614,231,False,233,154,35882
00003054.jpg,960,720,637,132,792,267,False,155,135,20925
00003054.jpg,960,720,168,277,284,378,False,116,101,11716
00001643.jpg,1300,970,761,224,1005,435,False,244,211,51484
00001643.jpg,1300,970,238,274,456,464,False,218,190,41420
00001643.jpg,1300,970,456,193,700,400,False,244,207,50508
00001657.jpg,1500,1101,739,240,1081,538,False,342,298,101916
00000549.jpg,626,415,90,148,229,256,False,139,108,15012
00000549.jpg,626,415,348,169,517,299,False,169,130,21970
00000549.jpg,626,415,203,144,364,266,False,161,122,19642
00000549.jpg,626,415,432,120,624,289,False,192,169,32448
00002438.jpg,1400,1750,642,320,776,519,False,134,199,26666
00001131.jpg,366,540,99,34,258,301,False,159,267,42453
00003295.jpg,612,361,356,65,575,219,False,219,154,33726
00003295.jpg,612,361,15,35,240,190,False,225,155,34875
00003295.jpg,612,361,119,46,368,213,False,249,167,41583
00003295.jpg,612,361,253,142,433,266,False,180,124,22320
00001482.jpg,770,513,254,21,467,190,False,213,169,35997
00001482.jpg,770,513,497,147,692,298,False,195,151,29445
00000944.jpg,866,1390,431,78,564,328,False,133,250,33250
00002821.jpg,2500,1667,1266,393,1835,826,False,569,433,246377
00002821.jpg,2500,1667,610,266,1144,671,False,534,405,216270
00000788.jpg,590,788,252,67,358,232,False,106,165,17490
00002174.jpg,1067,1390,280,429,455,689,False,175,260,45500
00000763.jpg,955,1300,234,170,492,578,False,258,408,105264
00000005.jpg,1300,957,811,171,976,313,False,165,142,23430
00002606.jpg,640,480,334,75,410,142,False,76,67,5092
00002606.jpg,640,480,203,96,269,154,False,66,58,3828
00002606.jpg,640,480,505,105,604,191,False,99,86,8514
00000011.jpg,4256,2832,1481,830,2110,1317,False,629,487,306323
00000777.jpg,1024,683,312,98,678,389,False,366,291,106506
00001469.jpg,700,1050,353,35,438,183,False,85,148,12580
00002160.jpg,699,1050,192,331,442,768,False,250,437,109250
00001441.jpg,1470,980,496,62,938,405,False,442,343,151606
00000987.jpg,683,1023,297,42,442,296,False,145,254,36830
00003256.jpg,1024,1024,324,382,674,782,False,350,400,140000
00001327.jpg,1300,1300,355,124,691,515,False,336,391,131376
00001333.jpg,1000,667,602,67,835,248,False,233,181,42173
00001455.jpg,1001,1600,486,248,580,422,False,94,174,16356
00000993.jpg,1024,682,501,86,844,347,False,343,261,89523
00000993.jpg,1024,682,146,110,489,376,False,343,266,91238
00000830.jpg,500,327,210,43,319,126,False,109,83,9047
00003487.jpg,236,236,79,60,132,121,False,53,61,3233
00002941.jpg,464,700,141,261,224,407,False,83,146,12118
00002799.jpg,800,532,398,255,690,481,False,292,226,65992
00002799.jpg,800,532,148,160,476,419,False,328,259,84952
00001284.jpg,1300,863,302,39,646,304,False,344,265,91160
00001284.jpg,1300,863,771,41,1100,295,False,329,254,83566
00000824.jpg,333,519,116,26,194,167,False,78,141,10998
00002000.jpg,640,360,146,42,376,193,False,230,151,34730
00002000.jpg,640,360,386,80,563,198,False,177,118,20886
00000617.jpg,1024,683,123,114,328,273,False,205,159,32595
00000617.jpg,1024,683,717,130,913,282,False,196,152,29792
00000617.jpg,1024,683,344,3,509,131,False,165,128,21120
00000617.jpg,1024,683,371,190,666,419,False,295,229,67555
00000617.jpg,1024,683,239,51,407,179,False,168,128,21504
00000617.jpg,1024,683,561,30,740,173,False,179,143,25597
00002766.jpg,2048,1365,751,248,1516,841,False,765,593,453645
00003478.jpg,236,157,28,3,159,105,False,131,102,13362
00002772.jpg,866,1390,89,24,539,846,False,450,822,369900
00000165.jpg,681,1024,260,202,483,584,False,223,382,85186
00000603.jpg,1155,648,681,81,1077,340,False,396,259,102564
00000603.jpg,1155,648,492,211,1019,548,False,527,337,177599
00001535.jpg,333,519,149,1,307,277,False,158,276,43608
00003444.jpg,800,800,400,203,590,425,False,190,222,42180
00001253.jpg,626,626,162,151,381,406,False,219,255,55845
00000159.jpg,1000,667,259,251,383,347,False,124,96,11904
00000159.jpg,1000,667,442,153,583,262,False,141,109,15369
00000159.jpg,1000,667,605,175,731,273,False,126,98,12348
00000159.jpg,1000,667,385,254,533,369,False,148,115,17020
00001247.jpg,800,551,271,100,527,306,False,256,206,52736
00003450.jpg,236,353,112,143,141,194,False,29,51,1479
00003450.jpg,236,353,182,162,211,213,False,29,51,1479
00003336.jpg,1186,750,459,184,729,382,False,270,198,53460
00002028.jpg,1581,1054,637,87,1113,455,False,476,368,175168
00001910.jpg,598,900,171,70,426,518,False,255,448,114240
00001904.jpg,866,1390,96,107,517,878,False,421,771,324591
00001092.jpg,600,420,277,48,466,199,False,189,151,28539
00001938.jpg,360,254,61,17,241,162,False,180,145,26100
00001086.jpg,800,582,203,194,343,313,False,140,119,16660
00002564.jpg,464,600,150,158,256,317,False,106,159,16854
00002202.jpg,800,475,425,112,522,181,False,97,69,6693
00003108.jpg,504,483,280,233,355,314,False,75,81,6075
00003108.jpg,504,483,97,121,175,207,False,78,86,6708
00003108.jpg,504,483,216,44,287,122,False,71,78,5538
00003108.jpg,504,483,351,113,420,190,False,69,77,5313
00001079.jpg,866,1390,243,280,445,657,False,202,377,76154
00001051.jpg,1068,1700,448,30,718,530,False,270,500,135000
00000429.jpg,600,400,358,136,429,191,False,71,55,3905
00001737.jpg,1024,774,435,52,689,271,False,254,219,55626
00001723.jpg,1024,682,316,22,690,312,False,374,290,108460
00001045.jpg,450,315,159,26,355,190,False,196,164,32144
00001735.jpg,390,280,106,9,229,112,False,123,103,12669
00001735.jpg,390,280,219,23,350,133,False,131,110,14410
00001047.jpg,1300,1298,488,103,809,477,False,321,374,120054
00003136.jpg,894,610,329,294,433,377,False,104,83,8632
00002228.jpg,700,1050,244,67,354,259,False,110,192,21120
00001721.jpg,600,421,344,156,408,209,False,64,53,3392
00001709.jpg,4016,6016,1812,745,2969,2718,False,1157,1973,2282761
00002566.jpg,680,1019,306,113,383,251,False,77,138,10626
00002572.jpg,800,1200,332,39,514,350,False,182,311,56602
00000365.jpg,1000,667,503,65,804,293,False,301,228,68628
00001090.jpg,1039,1300,570,97,685,269,False,115,172,19780
00001084.jpg,390,280,164,16,233,73,False,69,57,3933
00001912.jpg,1500,1120,434,86,1065,634,False,631,548,345788
00001906.jpg,683,1024,364,109,510,363,False,146,254,37084
00001251.jpg,779,1000,407,81,492,207,False,85,126,10710
00002758.jpg,488,488,104,31,242,188,False,138,157,21666
00003320.jpg,640,960,264,312,453,634,False,189,322,60858
00001537.jpg,392,600,146,46,275,275,False,129,229,29541
00001523.jpg,2000,1333,495,282,1374,963,False,879,681,598599
00003334.jpg,612,408,90,126,336,317,False,246,191,46986
00003452.jpg,236,354,86,87,116,140,False,30,53,1590
00000615.jpg,1232,821,981,229,1193,394,False,212,165,34980
00000615.jpg,1232,821,607,225,809,383,False,202,158,31916
00000615.jpg,1232,821,752,263,930,402,False,178,139,24742
00002002.jpg,1300,956,152,2,996,535,False,844,533,449852
00002016.jpg,855,1390,249,193,675,980,False,426,787,335262
00003308.jpg,720,1076,387,87,581,425,False,194,338,65572
00000601.jpg,640,427,254,97,377,192,False,123,95,11685
00000601.jpg,640,427,136,181,273,285,False,137,104,14248
00000601.jpg,640,427,426,145,559,247,False,133,102,13566
00000601.jpg,640,427,194,124,295,201,False,101,77,7777
00000601.jpg,640,427,378,130,479,208,False,101,78,7878
00001279.jpg,209,140,75,32,148,90,False,73,58,4234
00002943.jpg,600,419,16,17,348,338,False,332,321,106572
00002943.jpg,600,419,390,1,600,217,False,210,216,45360
00002943.jpg,600,419,156,63,476,323,False,320,260,83200
00000832.jpg,590,887,253,34,371,236,False,118,202,23836
00000826.jpg,1024,682,368,50,617,243,False,249,193,48057
00001286.jpg,1000,668,502,135,690,281,False,188,146,27448
00001325.jpg,1300,956,88,1,1198,885,False,1110,884,981240
00003254.jpg,612,408,380,85,456,142,False,76,57,4332
00003254.jpg,612,408,460,99,529,152,False,69,53,3657
00000985.jpg,2000,3000,938,338,1540,1388,False,602,1050,632100
00001443.jpg,1600,1155,866,59,1147,295,False,281,236,66316
00001457.jpg,866,1300,283,216,384,388,False,101,172,17372
00003240.jpg,390,280,117,62,251,174,False,134,112,15008
00003240.jpg,390,280,19,101,127,191,False,108,90,9720
00003240.jpg,390,280,207,33,314,123,False,107,90,9630
00002638.jpg,1023,682,560,245,740,385,False,180,140,25200
00002610.jpg,1024,682,569,168,699,269,False,130,101,13130
00002610.jpg,1024,682,198,73,333,176,False,135,103,13905
00001319.jpg,333,519,145,46,220,180,False,75,134,10050
00000761.jpg,236,354,101,7,131,59,False,30,52,1560
00003268.jpg,509,340,300,87,406,169,False,106,82,8692
00002162.jpg,640,480,153,56,569,411,False,416,355,147680
00000775.jpg,1000,1498,356,570,539,889,False,183,319,58377
00002604.jpg,1300,956,496,89,923,454,False,427,365,155855
00002837.jpg,829,580,460,290,583,390,False,123,100,12300
00002837.jpg,829,580,333,185,476,304,False,143,119,17017
00002837.jpg,829,580,605,236,757,360,False,152,124,18848
00001480.jpg,1000,667,342,99,839,494,False,497,395,196315
00003297.jpg,735,490,199,81,356,203,False,157,122,19154
00003297.jpg,735,490,331,115,471,224,False,140,109,15260
00003297.jpg,735,490,421,89,604,231,False,183,142,25986
00003297.jpg,735,490,199,259,340,368,False,141,109,15369
00003297.jpg,735,490,127,85,262,190,False,135,105,14175
00003297.jpg,735,490,486,336,610,432,False,124,96,11904
00003283.jpg,800,533,388,71,526,178,False,138,107,14766
00000952.jpg,590,367,180,37,350,160,False,170,123,20910
00001494.jpg,450,320,306,21,389,90,False,83,69,5727
00002823.jpg,504,358,213,154,267,198,False,54,44,2376
00002823.jpg,504,358,173,74,235,126,False,62,52,3224
00002823.jpg,504,358,269,72,330,123,False,61,51,3111
00002823.jpg,504,358,332,160,383,203,False,51,43,2193
00001899.jpg,1300,957,525,125,933,475,False,408,350,142800
00001641.jpg,600,420,238,52,371,160,False,133,108,14364
00002348.jpg,2946,1960,1744,237,2473,801,False,729,564,411156
00003056.jpg,633,1234,194,683,402,1144,False,208,461,95888
00000239.jpg,500,486,117,181,174,245,False,57,64,3648
00000239.jpg,500,486,217,121,271,181,False,54,60,3240
00000239.jpg,500,486,401,129,452,186,False,51,57,2907
00000239.jpg,500,486,48,126,108,191,False,60,65,3900
00000239.jpg,500,486,326,141,375,195,False,49,54,2646
00001133.jpg,533,849,199,1,370,304,False,171,303,51813
00003042.jpg,3072,2304,1294,1,2025,480,False,731,479,350149
00001655.jpg,800,533,317,101,568,291,False,251,190,47690
00002374.jpg,789,900,579,148,700,306,False,121,158,19118
00002374.jpg,789,900,247,163,363,318,False,116,155,17980
00000563.jpg,650,433,115,130,239,226,False,124,96,11904
00000563.jpg,650,433,179,42,309,141,False,130,99,12870
00000563.jpg,650,433,280,143,404,240,False,124,97,12028
00000563.jpg,650,433,310,229,455,341,False,145,112,16240
00000205.jpg,800,582,499,92,636,208,False,137,116,15892
00002412.jpg,1500,1000,139,264,519,559,False,380,295,112100
00002412.jpg,1500,1000,1015,416,1364,682,False,349,266,92834
00002412.jpg,1500,1000,588,287,959,575,False,371,288,106848
00002406.jpg,1000,750,754,182,941,346,False,187,164,30668
00000211.jpg,534,849,175,202,271,380,False,96,178,17088
00000577.jpg,590,394,420,62,513,134,False,93,72,6696
00000577.jpg,590,394,7,51,150,162,False,143,111,15873
00000577.jpg,590,394,236,104,385,220,False,149,116,17284
00000577.jpg,590,394,342,85,435,157,False,93,72,6696
00000577.jpg,590,394,185,105,269,170,False,84,65,5460
00000577.jpg,590,394,242,74,317,132,False,75,58,4350
00001669.jpg,600,900,267,33,343,166,False,76,133,10108
00002360.jpg,381,600,150,131,207,234,False,57,103,5871
00003095.jpg,1300,959,266,207,762,633,False,496,426,211296
00001682.jpg,600,900,253,121,331,257,False,78,136,10608
00001696.jpg,390,280,205,22,290,93,False,85,71,6035
00000588.jpg,1800,1200,1244,293,1628,591,False,384,298,114432
00003081.jpg,616,823,177,99,483,565,False,306,466,142596
00001866.jpg,1000,1500,427,320,680,752,False,253,432,109296
00001872.jpg,1300,881,258,23,602,300,False,344,277,95288
00001873.jpg,800,582,417,99,658,303,False,241,204,49164
00003080.jpg,390,280,14,59,189,202,False,175,143,25025
00003080.jpg,390,280,129,61,254,163,False,125,102,12750
00003080.jpg,390,280,166,1,328,121,False,162,120,19440
00000589.jpg,590,433,53,30,112,81,False,59,51,3009
00000589.jpg,590,433,360,29,414,75,False,54,46,2484
00000589.jpg,590,433,478,48,533,95,False,55,47,2585
00001697.jpg,800,746,1,1,339,371,False,338,370,125060
00001668.jpg,626,417,245,45,373,144,False,128,99,12672
00000576.jpg,1500,1120,1005,53,1419,413,False,414,360,149040
00000576.jpg,1500,1120,852,349,1476,891,False,624,542,338208
00000576.jpg,1500,1120,602,297,1115,744,False,513,447,229311
00000576.jpg,1500,1120,437,279,953,728,False,516,449,231684
00000576.jpg,1500,1120,279,254,782,691,False,503,437,219811
00000576.jpg,1500,1120,95,259,600,759,False,505,500,252500
00000562.jpg,630,343,22,62,233,196,False,211,134,28274
00000562.jpg,630,343,310,23,561,182,False,251,159,39909
00000562.jpg,630,343,162,80,369,212,False,207,132,27324
00000562.jpg,630,343,226,90,452,233,False,226,143,32318
00002375.jpg,551,751,161,48,313,289,False,152,241,36632
00002413.jpg,3000,2000,1756,307,2219,666,False,463,359,166217
00000204.jpg,300,470,128,70,163,134,False,35,64,2240
00001132.jpg,450,347,205,56,369,207,False,164,151,24764
00003043.jpg,500,333,193,56,371,194,False,178,138,24564
00003057.jpg,227,340,107,92,150,166,False,43,74,3182
00003057.jpg,227,340,81,34,134,126,False,53,92,4876
00002349.jpg,612,408,163,44,364,203,False,201,159,31959
00000238.jpg,400,600,154,74,225,195,False,71,121,8591
00000953.jpg,1000,1500,392,123,588,465,False,196,342,67032
00002822.jpg,1024,683,621,298,854,479,False,233,181,42173
00002822.jpg,1024,683,389,304,589,460,False,200,156,31200
00002822.jpg,1024,683,248,255,486,440,False,238,185,44030
00002836.jpg,1300,956,460,176,640,330,False,180,154,27720
00003296.jpg,612,408,238,177,411,311,False,173,134,23182
00003296.jpg,612,408,80,65,245,190,False,165,125,20625
00003296.jpg,612,408,136,78,291,201,False,155,123,19065
00003296.jpg,612,408,408,103,612,285,False,204,182,37128
00001481.jpg,650,433,169,61,344,197,False,175,136,23800
00000947.jpg,682,1024,317,139,382,253,False,65,114,7410
00000774.jpg,736,1104,273,108,405,338,False,132,230,30360
00002163.jpg,918,1390,372,133,609,551,False,237,418,99066
00002605.jpg,960,702,300,204,454,339,False,154,135,20790
00000012.jpg,600,400,183,73,402,243,False,219,170,37230
00000006.jpg,2667,4000,1002,787,1547,1739,False,545,952,518840
00002611.jpg,466,700,87,96,129,169,False,42,73,3066
00002611.jpg,466,700,313,68,358,147,False,45,79,3555
00003269.jpg,612,415,131,118,300,251,False,169,133,22477
00000760.jpg,800,533,320,85,571,279,False,251,194,48694
00001456.jpg,667,1000,274,47,443,335,False,169,288,48672
00000990.jpg,612,408,236,27,497,235,False,261,208,54288
00001330.jpg,800,533,164,28,450,250,False,286,222,63492
00002639.jpg,1500,1219,842,341,980,469,False,138,128,17664
00001324.jpg,1000,667,454,66,629,203,False,175,137,23975
00001442.jpg,460,374,106,1,445,262,False,339,261,88479
00003255.jpg,800,800,113,304,316,539,False,203,235,47705
00000827.jpg,666,440,382,56,547,180,False,165,124,20460
00002956.jpg,497,347,174,58,321,176,False,147,118,17346
00001287.jpg,1600,1167,492,42,1092,551,False,600,509,305400
00001293.jpg,626,418,195,60,400,223,False,205,163,33415
00003484.jpg,543,810,104,57,465,682,False,361,625,225625
00000833.jpg,533,849,159,133,275,349,False,116,216,25056
00003309.jpg,612,408,366,104,499,206,False,133,102,13566
00003309.jpg,612,408,106,41,330,218,False,224,177,39648
00002771.jpg,2500,1891,1429,876,1679,1092,False,250,216,54000
00002771.jpg,2500,1891,842,666,1103,896,False,261,230,60030
00000166.jpg,1000,610,433,25,944,380,False,511,355,181405
00001278.jpg,600,397,316,49,504,191,False,188,142,26696
00000172.jpg,681,1024,319,141,455,375,False,136,234,31824
00002003.jpg,1024,684,162,30,1002,683,False,840,653,548520
00001522.jpg,626,417,362,63,490,165,False,128,102,13056
00001244.jpg,2000,1125,748,173,1175,452,False,427,279,119133
00003453.jpg,236,157,128,9,190,58,False,62,49,3038
00002995.jpg,2048,1362,965,161,1946,920,False,981,759,744579
00002759.jpg,1200,1200,420,372,621,607,False,201,235,47235
00003447.jpg,612,408,92,44,293,203,False,201,159,31959
00001536.jpg,626,417,330,55,591,262,False,261,207,54027
00001907.jpg,400,278,88,36,278,193,False,190,157,29830
00001913.jpg,867,1300,333,77,495,361,False,162,284,46008
00001085.jpg,1600,1000,339,1,1378,629,False,1039,628,652492
00001091.jpg,4000,6000,1408,1,2359,1617,False,951,1616,1536816
00000364.jpg,400,600,190,88,234,164,False,44,76,3344
00002573.jpg,960,720,562,151,780,346,False,218,195,42510
00002573.jpg,960,720,151,154,258,247,False,107,93,9951
00002215.jpg,612,487,362,36,493,157,False,131,121,15851
00002215.jpg,612,487,204,121,296,207,False,92,86,7912
00000416.jpg,1600,1167,609,70,861,285,False,252,215,54180
00001708.jpg,1500,1098,879,201,1228,498,False,349,297,103653
00002201.jpg,1200,633,779,293,1148,519,False,369,226,83394
00001046.jpg,390,280,122,3,365,202,False,243,199,48357
00000358.jpg,6000,4000,3241,724,4441,1655,False,1200,931,1117200
00001720.jpg,600,900,175,5,463,495,False,288,490,141120
00002229.jpg,374,580,166,161,273,351,False,107,190,20330
00003123.jpg,538,700,123,159,174,237,False,51,78,3978
00001734.jpg,1023,709,534,53,849,306,False,315,253,79695
00001052.jpg,500,813,181,9,372,370,False,191,361,68951
00002563.jpg,1280,855,444,13,804,294,False,360,281,101160
00002563.jpg,1280,855,700,247,1060,528,False,360,281,101160
00002205.jpg,861,1390,368,67,464,247,False,96,180,17280
00001718.jpg,398,600,149,66,225,200,False,76,134,10184
00000406.jpg,200,200,80,51,119,97,False,39,46,1794
00002211.jpg,1300,956,202,64,1156,862,False,954,798,761292
00002577.jpg,683,1024,295,338,423,557,False,128,219,28032
00000348.jpg,590,342,319,69,418,137,False,99,68,6732
00001056.jpg,2940,1960,1374,340,1961,797,False,587,457,268259
00001730.jpg,600,420,265,35,408,151,False,143,116,16588
00003127.jpg,6000,4000,3293,1004,4573,2019,False,1280,1015,1299200
00002239.jpg,1000,667,609,95,897,318,False,288,223,64224
00002239.jpg,1000,667,385,163,613,340,False,228,177,40356
00002239.jpg,1000,667,87,91,351,292,False,264,201,53064
00003133.jpg,612,408,174,230,273,306,False,99,76,7524
00003133.jpg,612,408,272,227,375,307,False,103,80,8240
00001724.jpg,407,612,93,99,283,423,False,190,324,61560
00001042.jpg,800,582,204,39,595,378,False,391,339,132549
00001917.jpg,1024,683,366,54,1016,569,False,650,515,334750
00001095.jpg,600,398,191,3,589,284,False,398,281,111838
00002588.jpg,1024,1024,540,115,892,517,False,352,402,141504
00002588.jpg,1024,1024,247,383,542,719,False,295,336,99120
00001081.jpg,509,339,193,33,319,131,False,126,98,12348
00000610.jpg,1500,1117,502,47,754,266,False,252,219,55188
00000610.jpg,1500,1117,736,329,1070,619,False,334,290,96860
00000610.jpg,1500,1117,557,305,857,565,False,300,260,78000
00002007.jpg,612,408,255,29,427,166,False,172,137,23564
00003319.jpg,800,533,306,29,800,441,False,494,412,203528
00000162.jpg,400,280,214,50,313,131,False,99,81,8019
00002775.jpg,1024,800,316,239,438,350,False,122,111,13542
00002013.jpg,1333,2000,430,134,840,850,False,410,716,293560
00000604.jpg,1600,1168,469,342,910,709,False,441,367,161847
00000604.jpg,1600,1168,103,204,594,622,False,491,418,205238
00000604.jpg,1600,1168,802,37,1350,502,False,548,465,254820
00003325.jpg,1200,750,345,85,767,392,False,422,307,129554
00001532.jpg,500,750,195,175,327,406,False,132,231,30492
00001254.jpg,1300,731,532,65,804,239,False,272,174,47328
00003443.jpg,236,330,97,30,152,119,False,55,89,4895
00002985.jpg,1300,868,638,47,876,233,False,238,186,44268
00003457.jpg,236,354,95,53,148,145,False,53,92,4876
00002991.jpg,1080,720,564,105,689,202,False,125,97,12125
00002991.jpg,1080,720,174,236,287,323,False,113,87,9831
00002991.jpg,1080,720,797,197,907,284,False,110,87,9570
00002991.jpg,1080,720,356,98,490,202,False,134,104,13936
00001240.jpg,500,749,198,174,298,344,False,100,170,17000
00001526.jpg,866,1390,399,35,618,444,False,219,409,89571
00003331.jpg,1600,1155,499,397,768,619,False,269,222,59718
00003331.jpg,1600,1155,688,32,1030,319,False,342,287,98154
00003331.jpg,1600,1155,833,304,1102,530,False,269,226,60794
00003331.jpg,1600,1155,636,330,917,556,False,281,226,63506
00000837.jpg,400,191,8,1,251,139,False,243,138,33534
00003480.jpg,236,156,80,21,148,73,False,68,52,3536
00001297.jpg,600,419,253,30,361,118,False,108,88,9504
00002952.jpg,1300,889,612,105,955,372,False,343,267,91581
00002952.jpg,1300,889,874,79,1233,358,False,359,279,100161
00000764.jpg,1001,1600,441,64,613,384,False,172,320,55040
00002615.jpg,1024,682,346,184,501,304,False,155,120,18600
00001308.jpg,1067,1700,479,156,644,455,False,165,299,49335
00003279.jpg,679,1024,254,401,334,542,False,80,141,11280
00002167.jpg,612,459,116,81,330,268,False,214,187,40018
00000770.jpg,590,396,194,21,389,173,False,195,152,29640
00001446.jpg,590,885,236,55,399,339,False,163,284,46292
00000758.jpg,1300,867,487,54,853,339,False,366,285,104310
00001320.jpg,682,1023,131,1,584,705,False,453,704,318912
00001452.jpg,1332,850,761,55,1077,290,False,316,235,74260
00000994.jpg,600,419,236,58,516,295,False,280,237,66360
00003245.jpg,800,800,665,426,794,583,False,129,157,20253
00001485.jpg,319,450,133,95,219,236,False,86,141,12126
00000943.jpg,533,800,167,12,428,458,False,261,446,116406
00003292.jpg,2000,1333,693,364,1363,895,False,670,531,355770
00002826.jpg,1300,956,581,89,947,403,False,366,314,114924
00002198.jpg,471,630,215,33,283,139,False,68,106,7208
00001491.jpg,1470,980,412,50,776,332,False,364,282,102648
00000957.jpg,2946,1960,1204,139,1492,362,False,288,223,64224
00000566.jpg,910,780,323,473,513,662,False,190,189,35910
00001678.jpg,450,319,188,46,269,112,False,81,66,5346
00002365.jpg,1600,1199,624,250,944,529,False,320,279,89280
00002403.jpg,313,512,70,12,172,203,False,102,191,19482
00001644.jpg,319,450,109,27,182,146,False,73,119,8687
00003053.jpg,1920,1534,477,179,665,354,False,188,175,32900
00003053.jpg,1920,1534,1430,240,1708,493,False,278,253,70334
00003053.jpg,1920,1534,740,235,941,421,False,201,186,37386
00003053.jpg,1920,1534,1127,357,1417,627,False,290,270,78300
00003053.jpg,1920,1534,113,521,390,779,False,277,258,71466
00002359.jpg,300,350,173,18,241,108,False,68,90,6120
00001888.jpg,600,418,267,68,419,189,False,152,121,18392
00001650.jpg,417,626,58,26,332,495,False,274,469,128506
00001877.jpg,1500,1120,652,53,972,338,False,320,285,91200
00003090.jpg,900,900,355,315,469,447,False,114,132,15048
00003090.jpg,900,900,72,507,144,592,False,72,85,6120
00001687.jpg,1300,956,381,98,605,289,False,224,191,42784
00001693.jpg,1023,682,406,50,796,352,False,390,302,117780
00003085.jpg,1000,1500,281,685,690,1400,False,409,715,292435
00003085.jpg,1000,1500,223,13,544,550,False,321,537,172377
00001692.jpg,1300,975,617,106,889,343,False,272,237,64464
00001692.jpg,1300,975,405,280,633,480,False,228,200,45600
00000598.jpg,1024,683,246,164,425,304,False,179,140,25060
00000598.jpg,1024,683,652,184,803,301,False,151,117,17667
00001686.jpg,559,309,110,5,497,254,False,387,249,96363
00001876.jpg,2000,1333,313,58,958,559,False,645,501,323145
00001862.jpg,540,720,169,74,444,500,False,275,426,117150
00001651.jpg,333,519,114,145,164,236,False,50,91,4550
00001889.jpg,1000,667,527,87,803,296,False,276,209,57684
00003046.jpg,533,800,258,252,340,396,False,82,144,11808
00003046.jpg,533,800,352,350,412,456,False,60,106,6360
00003046.jpg,533,800,217,179,279,288,False,62,109,6758
00003046.jpg,533,800,266,81,326,184,False,60,103,6180
00002358.jpg,637,960,377,58,478,234,False,101,176,17776
00001137.jpg,1068,1700,533,406,701,718,False,168,312,52416
00001123.jpg,1800,1202,693,309,1038,577,False,345,268,92460
00003052.jpg,280,370,84,73,129,143,False,45,70,3150
00003052.jpg,280,370,152,79,198,150,False,46,71,3266
00002364.jpg,2000,2000,635,241,1454,1194,False,819,953,780507
00002416.jpg,1280,720,921,135,1076,239,False,155,104,16120
00002416.jpg,1280,720,361,216,486,298,False,125,82,10250
00001679.jpg,866,1300,481,190,630,450,False,149,260,38740
00000567.jpg,1500,1000,450,302,1016,741,False,566,439,248474
00000567.jpg,1500,1000,2,413,504,830,False,502,417,209334
00000567.jpg,1500,1000,768,63,1328,497,False,560,434,243040
00002827.jpg,1000,667,590,187,777,333,False,187,146,27302
00002827.jpg,1000,667,102,208,281,344,False,179,136,24344
00002827.jpg,1000,667,330,254,488,377,False,158,123,19434
00000956.jpg,683,1024,232,122,362,350,False,130,228,29640
00003287.jpg,500,500,116,44,198,139,False,82,95,7790
00003287.jpg,500,500,255,27,337,121,False,82,94,7708
00002199.jpg,470,423,210,65,367,230,False,157,165,25905
00003293.jpg,736,981,188,170,309,354,False,121,184,22264
00001484.jpg,400,272,198,84,366,217,False,168,133,22344
00001335.jpg,1333,2000,626,186,781,457,False,155,271,42005
00003244.jpg,640,960,282,354,352,476,False,70,122,8540
00000995.jpg,800,534,92,16,313,188,False,221,172,38012
00001453.jpg,1024,768,417,68,617,243,False,200,175,35000
00000981.jpg,600,400,232,34,374,147,False,142,113,16046
00002628.jpg,601,900,362,123,449,274,False,87,151,13137
00002628.jpg,601,900,247,157,330,302,False,83,145,12035
00002600.jpg,570,778,274,1,343,100,False,69,99,6831
00002600.jpg,570,778,9,105,109,268,False,100,163,16300
00000765.jpg,768,1024,291,59,407,239,False,116,180,20880
00000003.jpg,500,350,101,25,176,87,False,75,62,4650
00002953.jpg,844,1023,531,116,638,267,False,107,151,16157
00001282.jpg,333,519,187,20,228,93,False,41,73,2993
00000836.jpg,1232,821,376,147,816,489,False,440,342,150480
00001296.jpg,1000,667,226,109,484,309,False,258,200,51600
00000188.jpg,640,427,85,93,155,147,False,70,54,3780
00003481.jpg,236,353,81,72,124,147,False,43,75,3225
00002748.jpg,1024,765,626,111,753,221,False,127,110,13970
00002748.jpg,1024,765,765,142,983,336,False,218,194,42292
00002990.jpg,1300,996,703,279,845,406,False,142,127,18034
00003456.jpg,236,337,80,257,117,319,False,37,62,2294
00001527.jpg,600,900,208,57,286,193,False,78,136,10608
00001533.jpg,1024,709,513,118,895,426,False,382,308,117656
00002984.jpg,682,1023,227,312,427,662,False,200,350,70000
00002984.jpg,682,1023,112,37,313,388,False,201,351,70551
00003442.jpg,459,612,191,145,313,329,False,122,184,22448
00001255.jpg,800,533,362,63,583,231,False,221,168,37128
00000605.jpg,800,534,131,96,313,234,False,182,138,25116
00000605.jpg,800,534,327,141,552,312,False,225,171,38475
00000605.jpg,800,534,524,162,735,326,False,211,164,34604
00000605.jpg,800,534,250,68,393,178,False,143,110,15730
00000605.jpg,800,534,424,40,602,176,False,178,136,24208
00002012.jpg,1500,1120,502,61,795,316,False,293,255,74715
00002006.jpg,800,553,220,22,717,431,False,497,409,203273
00000177.jpg,6000,4000,1308,92,3873,2125,False,2565,2033,5214645
00001902.jpg,2410,1465,881,222,1561,703,False,680,481,327080
00001916.jpg,1024,658,214,58,479,255,False,265,197,52205
00003132.jpg,1300,957,224,198,458,398,False,234,200,46800
00003132.jpg,1300,957,631,222,836,397,False,205,175,35875
00001043.jpg,500,333,201,76,323,170,False,122,94,11468
00001057.jpg,590,393,179,144,297,238,False,118,94,11092
00003126.jpg,533,800,125,62,363,468,False,238,406,96628
00001731.jpg,720,908,34,1,543,656,False,509,655,333395
00001719.jpg,768,1024,263,57,374,229,False,111,172,19092
00000361.jpg,2600,1734,1286,460,1743,815,False,457,355,162235
00000361.jpg,2600,1734,914,389,1391,759,False,477,370,176490
00000413.jpg,1058,1600,379,272,545,565,False,166,293,48638
00002204.jpg,626,417,207,45,423,212,False,216,167,36072
00002574.jpg,900,600,256,40,539,255,False,283,215,60845
00002574.jpg,900,600,434,155,687,348,False,253,193,48829
00000363.jpg,1281,681,192,149,484,330,False,292,181,52852
00002212.jpg,736,1104,242,73,410,366,False,168,293,49224
00000411.jpg,1080,1350,481,441,615,632,False,134,191,25594
00000377.jpg,1000,667,645,104,945,337,False,300,233,69900
00000377.jpg,1000,667,74,398,395,647,False,321,249,79929
00000377.jpg,1000,667,419,88,733,332,False,314,244,76616
00000377.jpg,1000,667,106,119,382,328,False,276,209,57684
00000377.jpg,1000,667,1,173,219,411,False,218,238,51884
00002560.jpg,512,354,50,1,508,353,False,458,352,161216
00001041.jpg,867,1390,191,183,343,467,False,152,284,43168
00002548.jpg,840,560,334,163,634,396,False,300,233,69900
00003130.jpg,868,1300,376,241,475,414,False,99,173,17127
00001727.jpg,1300,788,656,143,1073,437,False,417,294,122598
00001733.jpg,800,534,487,43,657,176,False,170,133,22610
00003124.jpg,500,751,124,213,197,339,False,73,126,9198
00001055.jpg,957,1300,285,173,379,321,False,94,148,13912
00001900.jpg,1500,1000,819,48,1300,421,False,481,373,179413
00001914.jpg,1300,956,337,11,1259,799,False,922,788,726536
00002010.jpg,590,394,258,100,347,169,False,89,69,6141
00001519.jpg,1000,694,232,47,526,279,False,294,232,68208
00002776.jpg,2500,1667,1552,237,1972,563,False,420,326,136920
00002776.jpg,2500,1667,1199,703,1517,944,False,318,241,76638
00002762.jpg,1000,1000,351,130,741,584,False,390,454,177060
00000175.jpg,1300,956,669,132,799,243,False,130,111,14430
00002004.jpg,600,419,271,74,358,144,False,87,70,6090
00001525.jpg,780,527,149,24,473,279,False,324,255,82620
00003332.jpg,679,960,313,375,485,658,False,172,283,48676
00003454.jpg,236,354,75,34,129,128,False,54,94,5076
00001243.jpg,343,280,144,31,211,94,False,67,63,4221
00003440.jpg,236,354,98,54,143,133,False,45,79,3555
00002986.jpg,960,640,4,111,142,219,False,138,108,14904
00002986.jpg,960,640,187,253,379,402,False,192,149,28608
00002986.jpg,960,640,671,4,843,134,False,172,130,22360
00002986.jpg,960,640,524,155,663,263,False,139,108,15012
00002986.jpg,960,640,796,89,950,209,False,154,120,18480
00002038.jpg,1024,781,335,44,763,424,False,428,380,162640
00002038.jpg,1024,781,102,211,523,585,False,421,374,157454
00003326.jpg,375,500,286,122,326,184,False,40,62,2480
00001531.jpg,612,410,63,1,574,398,False,511,397,202867
00002979.jpg,1200,631,422,128,833,380,False,411,252,103572
00000820.jpg,1078,1600,265,136,399,367,False,134,231,30954
00000820.jpg,1078,1600,708,227,823,430,False,115,203,23345
00001280.jpg,436,280,150,16,228,74,False,78,58,4524
00003497.jpg,236,354,64,130,138,256,False,74,126,9324
00003483.jpg,236,355,76,38,150,168,False,74,130,9620
00002945.jpg,1080,1350,263,173,851,1030,False,588,857,503916
00002945.jpg,1080,1350,5,300,502,1300,False,497,1000,497000
00000834.jpg,1000,635,220,11,790,431,False,570,420,239400
00000015.jpg,1333,2000,471,315,774,845,False,303,530,160590
00002602.jpg,800,533,435,113,606,245,False,171,132,22572
00001479.jpg,1600,1167,708,81,971,310,False,263,229,60227
00000767.jpg,1024,701,341,87,529,240,False,188,153,28764
00000997.jpg,699,1050,254,24,394,263,False,140,239,33460
00003246.jpg,626,417,290,56,563,273,False,273,217,59241
00003246.jpg,626,417,152,49,433,272,False,281,223,62663
00001337.jpg,1300,956,521,155,947,520,False,426,365,155490
00001323.jpg,391,280,137,21,247,113,False,110,92,10120
00001445.jpg,600,600,362,13,445,112,False,83,99,8217
00000983.jpg,866,1390,431,78,564,328,False,133,250,33250
00000968.jpg,866,1300,486,24,594,212,False,108,188,20304
00001492.jpg,880,660,531,171,719,331,False,188,160,30080
00001492.jpg,880,660,132,163,301,310,False,169,147,24843
00001492.jpg,880,660,334,38,466,154,False,132,116,15312
00002825.jpg,1280,853,608,126,763,249,False,155,123,19065
00000798.jpg,970,1455,327,1,619,494,False,292,493,143956
00003291.jpg,1024,681,610,174,762,289,False,152,115,17480
00003291.jpg,1024,681,438,252,565,352,False,127,100,12700
00003291.jpg,1024,681,227,78,375,193,False,148,115,17020
00001109.jpg,800,533,312,46,494,190,False,182,144,26208
00000571.jpg,626,417,231,179,393,304,False,162,125,20250
00002366.jpg,640,748,303,46,413,195,False,110,149,16390
00002366.jpg,640,748,470,49,565,178,False,95,129,12255
00000565.jpg,1024,769,751,231,979,431,False,228,200,45600
00000565.jpg,1024,769,542,276,756,463,False,214,187,40018
00000565.jpg,1024,769,438,441,781,735,False,343,294,100842
00000565.jpg,1024,769,277,378,531,596,False,254,218,55372
00000565.jpg,1024,769,1,219,337,553,False,336,334,112224
00000203.jpg,667,1000,292,4,619,573,False,327,569,186063
00000203.jpg,667,1000,96,124,382,611,False,286,487,139282
00000203.jpg,667,1000,190,45,517,579,False,327,534,174618
00002414.jpg,1400,933,584,128,1183,592,False,599,464,277936
00003044.jpg,5184,3456,2185,646,2829,1134,False,644,488,314272
00001653.jpg,1000,667,341,101,649,340,False,308,239,73612
00000559.jpg,1024,682,470,198,639,329,False,169,131,22139
00000559.jpg,1024,682,580,144,728,259,False,148,115,17020
00000559.jpg,1024,682,380,160,507,259,False,127,99,12573
00001647.jpg,800,533,403,49,624,220,False,221,171,37791
00002428.jpg,640,480,316,1,583,226,False,267,225,60075
00001121.jpg,334,519,147,27,213,148,False,66,121,7986
00001874.jpg,233,350,84,5,193,195,False,109,190,20710
00001860.jpg,360,254,99,11,270,152,False,171,141,24111
00001690.jpg,1470,980,641,145,969,399,False,328,254,83312
00001848.jpg,1300,947,480,81,770,327,False,290,246,71340
00003087.jpg,960,444,744,121,949,238,False,205,117,23985
00002399.jpg,900,600,399,130,811,450,False,412,320,131840
00003093.jpg,1440,1800,267,521,681,1125,False,414,604,250056
00003093.jpg,1440,1800,649,709,1211,1543,False,562,834,468708
00003093.jpg,1440,1800,810,83,1436,993,False,626,910,569660
00001684.jpg,1001,1600,189,49,579,775,False,390,726,283140
00001685.jpg,518,612,213,114,285,213,False,72,99,7128
00003092.jpg,236,354,83,58,126,131,False,43,73,3139
00003086.jpg,626,417,390,100,548,223,False,158,123,19434
00003086.jpg,626,417,98,129,234,232,False,136,103,14008
00003086.jpg,626,417,249,116,398,232,False,149,116,17284
00003086.jpg,626,417,471,165,626,290,False,155,125,19375
00003086.jpg,626,417,4,166,140,274,False,136,108,14688
00001691.jpg,1280,720,828,28,1188,264,False,360,236,84960
00001691.jpg,1280,720,184,24,489,223,False,305,199,60695
00001861.jpg,1300,922,416,64,774,360,False,358,296,105968
00003051.jpg,600,400,163,32,408,222,False,245,190,46550
00001646.jpg,680,1024,256,85,392,323,False,136,238,32368
00000558.jpg,622,415,161,207,230,261,False,69,54,3726
00000558.jpg,622,415,480,222,543,272,False,63,50,3150
00001120.jpg,612,408,128,14,543,343,False,415,329,136535
00002429.jpg,650,667,95,22,514,522,False,419,500,209500
00001652.jpg,781,1024,331,82,418,215,False,87,133,11571
00003045.jpg,700,466,390,107,550,230,False,160,123,19680
00000564.jpg,1300,957,223,192,597,513,False,374,321,120054
00000564.jpg,1300,957,447,94,875,461,False,428,367,157076
00000564.jpg,1300,957,715,96,1132,454,False,417,358,149286
00000564.jpg,1300,957,1,155,247,484,False,246,329,80934
00000564.jpg,1300,957,1031,361,1296,742,False,265,381,100965
00002373.jpg,682,1024,311,103,412,279,False,101,176,17776
00002415.jpg,500,280,121,1,499,259,False,378,258,97524
00001108.jpg,600,419,181,11,312,117,False,131,106,13886
00002367.jpg,700,350,81,2,563,271,False,482,269,129658
00002830.jpg,829,1200,95,326,182,471,False,87,145,12615
00002830.jpg,829,1200,414,119,506,271,False,92,152,13984
00002830.jpg,829,1200,354,272,434,405,False,80,133,10640
00002830.jpg,829,1200,535,471,643,652,False,108,181,19548
00002830.jpg,829,1200,522,156,610,305,False,88,149,13112
00000941.jpg,900,600,314,108,523,270,False,209,162,33858
00001487.jpg,400,620,158,52,241,203,False,83,151,12533
00000799.jpg,1300,957,185,29,494,299,False,309,270,83430
00000955.jpg,1000,1620,218,207,519,774,False,301,567,170667
00001493.jpg,1500,964,579,68,935,341,False,356,273,97188
00003284.jpg,612,408,387,158,520,262,False,133,104,13832
00003284.jpg,612,408,179,86,309,188,False,130,102,13260
00000969.jpg,853,1000,388,128,538,333,False,150,205,30750
00000982.jpg,533,849,256,145,314,253,False,58,108,6264
00003247.jpg,800,533,332,123,499,253,False,167,130,21710
00000996.jpg,1067,1700,308,169,508,540,False,200,371,74200
00000996.jpg,1067,1700,493,231,672,564,False,179,333,59607
00001450.jpg,850,1280,288,354,486,694,False,198,340,67320
00002617.jpg,1800,1200,1123,368,1508,666,False,385,298,114730
00002171.jpg,830,430,321,2,783,281,False,462,279,128898
00000772.jpg,600,475,123,51,246,164,False,123,113,13899
00002165.jpg,2760,1890,815,1,2020,915,False,1205,914,1101370
00002603.jpg,840,473,596,271,696,337,False,100,66,6600
00002603.jpg,840,473,330,28,409,80,False,79,52,4108
00002603.jpg,840,473,138,300,213,348,False,75,48,3600
00001295.jpg,749,937,128,235,215,361,False,87,126,10962
00001295.jpg,749,937,21,264,100,378,False,79,114,9006
00001295.jpg,749,937,248,185,328,301,False,80,116,9280
00001295.jpg,749,937,494,176,583,308,False,89,132,11748
00001295.jpg,749,937,355,233,446,365,False,91,132,12012
00002944.jpg,533,800,217,161,349,392,False,132,231,30492
00003482.jpg,236,157,88,48,133,83,False,45,35,1575
00000835.jpg,2946,1960,1827,136,2344,537,False,517,401,207317
00003496.jpg,235,307,74,26,105,74,False,31,48,1488
00002788.jpg,735,1000,218,131,459,504,False,241,373,89893
00001281.jpg,1300,957,355,98,691,386,False,336,288,96768
00002978.jpg,427,640,148,29,318,319,False,170,290,49300
00000809.jpg,2000,1333,813,216,1231,540,False,418,324,135432
00002987.jpg,960,444,386,56,853,302,False,467,246,114882
00001530.jpg,467,635,153,1,284,184,False,131,183,23973
00003327.jpg,612,413,219,121,295,182,False,76,61,4636
00003333.jpg,255,340,81,66,125,134,False,44,68,2992
00002993.jpg,1500,1500,793,326,1035,608,False,242,282,68244
00000174.jpg,1500,1125,31,202,616,712,False,585,510,298350
00000174.jpg,1500,1125,888,201,1486,722,False,598,521,311558
00002763.jpg,605,756,287,107,344,189,False,57,82,4674
00002763.jpg,605,756,130,306,190,392,False,60,86,5160
00002005.jpg,512,512,208,1,312,94,False,104,93,9672
00000612.jpg,900,601,284,183,464,323,False,180,140,25200
00000612.jpg,900,601,138,159,326,305,False,188,146,27448
00000612.jpg,900,601,463,156,655,309,False,192,153,29376
00002011.jpg,1600,1068,463,100,790,360,False,327,260,85020
00002777.jpg,1024,683,379,131,715,392,False,336,261,87696
00001929.jpg,600,900,126,46,288,328,False,162,282,45684
00001097.jpg,1300,957,413,96,679,328,False,266,232,61712
00001083.jpg,673,1024,241,77,548,620,False,307,543,166701
00001901.jpg,861,1300,385,105,547,389,False,162,284,46008
00001732.jpg,866,1300,431,152,553,366,False,122,214,26108
00002549.jpg,800,800,189,175,356,369,False,167,194,32398
00002549.jpg,800,800,426,158,619,383,False,193,225,43425
00001040.jpg,590,426,193,41,311,140,False,118,99,11682
00001726.jpg,1000,667,447,75,735,298,False,288,223,64224
00003131.jpg,682,1024,324,181,407,326,False,83,145,12035
00000362.jpg,1300,867,513,64,1057,495,False,544,431,234464
00000339.jpg,1000,1500,392,611,533,858,False,141,247,34827
00001027.jpg,3456,5184,486,1032,2500,4471,False,2014,3439,6926146
00001741.jpg,236,373,72,3,150,142,False,78,139,10842
00001999.jpg,400,225,27,7,320,199,False,293,192,56256
00003156.jpg,1200,1199,563,357,706,523,False,143,166,23738
00003156.jpg,1200,1199,721,305,870,478,False,149,173,25777
00003156.jpg,1200,1199,214,298,384,491,False,170,193,32810
00003142.jpg,735,490,175,84,567,389,False,392,305,119560
00001755.jpg,1300,956,616,100,870,323,False,254,223,56642
00001033.jpg,1024,704,354,75,587,266,False,233,191,44503
00000305.jpg,1200,1800,553,383,750,728,False,197,345,67965
00002512.jpg,660,373,338,19,504,129,False,166,110,18260
00001769.jpg,866,1390,339,160,520,498,False,181,338,61178
00002260.jpg,1280,720,21,1,1113,680,False,1092,679,741468
00001782.jpg,600,398,272,47,529,245,False,257,198,50886
00001796.jpg,590,393,208,53,559,325,False,351,272,95472
00001966.jpg,400,289,152,19,316,156,False,164,137,22468
00001972.jpg,1500,1120,570,27,1022,410,False,452,383,173116
00003354.jpg,900,900,414,61,569,242,False,155,181,28055
00001543.jpg,1001,1600,237,72,465,496,False,228,424,96672
00000885.jpg,333,500,67,45,189,259,False,122,214,26108
00001225.jpg,1300,957,354,58,644,306,False,290,248,71920
00003426.jpg,236,306,177,169,213,224,False,36,55,1980
00001231.jpg,2000,1335,896,277,1424,687,False,528,410,216480
00001557.jpg,993,1300,304,340,616,805,False,312,465,145080
00000891.jpg,1000,752,164,99,786,643,False,622,544,338368
00000661.jpg,1500,1000,120,97,273,216,False,153,119,18207
00000661.jpg,1500,1000,1318,114,1468,233,False,150,119,17850
00000661.jpg,1500,1000,406,133,535,235,False,129,102,13158
00002076.jpg,1500,1120,527,54,959,429,False,432,375,162000
00003368.jpg,1376,2000,782,231,949,520,False,167,289,48263
00002710.jpg,1300,957,751,90,979,285,False,228,195,44460
00002710.jpg,1300,957,259,373,503,582,False,244,209,50996
00002710.jpg,1300,957,528,336,777,549,False,249,213,53037
00002710.jpg,1300,957,181,1,435,195,False,254,194,49276
00002710.jpg,1300,957,344,25,598,243,False,254,218,55372
00001219.jpg,333,519,136,110,185,200,False,49,90,4410
00000107.jpg,2000,1335,775,364,998,537,False,223,173,38579
00002704.jpg,2048,1365,791,4,1371,308,False,580,304,176320
00002062.jpg,800,561,211,69,677,449,False,466,380,177080
00000675.jpg,750,501,189,106,268,167,False,79,61,4819
00000675.jpg,750,501,274,81,372,155,False,98,74,7252
00000675.jpg,750,501,376,76,473,151,False,97,75,7275
00000675.jpg,750,501,402,170,489,238,False,87,68,5916
00001580.jpg,333,519,179,88,214,149,False,35,61,2135
00003397.jpg,417,626,178,131,271,294,False,93,163,15159
00002089.jpg,370,280,203,22,285,95,False,82,73,5986
00002937.jpg,612,408,205,57,310,138,False,105,81,8505
00002937.jpg,612,408,140,96,204,145,False,64,49,3136
00002937.jpg,612,408,491,76,561,130,False,70,54,3780
00002923.jpg,720,480,395,193,542,307,False,147,114,16758
00002923.jpg,720,480,356,86,513,208,False,157,122,19154
00001594.jpg,683,1024,260,216,373,408,False,113,192,21696
00003220.jpg,500,333,237,82,293,125,False,56,43,2408
00000729.jpg,980,980,518,532,682,724,False,164,192,31488
00000729.jpg,980,980,237,495,432,723,False,195,228,44460
00000729.jpg,980,980,689,633,862,829,False,173,196,33908
00000729.jpg,980,980,558,331,746,549,False,188,218,40984
00000729.jpg,980,980,391,417,566,617,False,175,200,35000
00000729.jpg,980,980,770,497,965,721,False,195,224,43680
00000729.jpg,980,980,699,397,867,593,False,168,196,32928
00000729.jpg,980,980,80,360,304,620,False,224,260,58240
00001351.jpg,683,1024,317,204,392,334,False,75,130,9750
00002658.jpg,400,600,70,173,149,309,False,79,136,10744
00002658.jpg,400,600,230,70,281,156,False,51,86,4386
00002880.jpg,1000,714,389,167,665,402,False,276,235,64860
00001423.jpg,1067,1700,540,180,672,425,False,132,245,32340
00000715.jpg,1500,1000,798,357,1185,658,False,387,301,116487
00000715.jpg,1500,1000,342,297,764,625,False,422,328,138416
00000715.jpg,1500,1000,621,361,1017,662,False,396,301,119196
00002102.jpg,1000,667,501,47,866,331,False,365,284,103660
00000067.jpg,1333,2000,700,244,949,680,False,249,436,108564
00001379.jpg,1800,1200,460,113,844,411,False,384,298,114432
00002670.jpg,1470,980,553,580,806,772,False,253,192,48576
00002670.jpg,1470,980,830,571,1158,825,False,328,254,83312
00002116.jpg,1067,1700,461,47,675,443,False,214,396,84744
00000701.jpg,1000,1000,345,337,645,687,False,300,350,105000
00000701.jpg,1000,1000,678,439,960,767,False,282,328,92496
00000932.jpg,436,600,206,68,284,193,False,78,125,9750
00002843.jpg,900,663,256,105,363,197,False,107,92,9844
00002843.jpg,900,663,462,120,562,204,False,100,84,8400
00001392.jpg,1000,1500,406,580,610,936,False,204,356,72624
00001386.jpg,760,434,136,1,682,347,False,546,346,188916
00002857.jpg,612,408,164,128,307,238,False,143,110,15730
00002857.jpg,612,408,336,47,505,181,False,169,134,22646
00002857.jpg,612,408,200,142,345,255,False,145,113,16385
00002857.jpg,612,408,240,154,389,269,False,149,115,17135
00002857.jpg,612,408,1,66,144,212,False,143,146,20878
00002857.jpg,612,408,372,45,582,218,False,210,173,36330
00002857.jpg,612,408,90,78,218,173,False,128,95,12160
00000926.jpg,1356,1681,376,164,619,516,False,243,352,85536
00001635.jpg,407,612,166,88,269,268,False,103,180,18540
00003036.jpg,1200,800,350,118,829,489,False,479,371,177709
00001621.jpg,1307,1960,224,374,363,618,False,139,244,33916
00001147.jpg,500,334,124,60,208,124,False,84,64,5376
00002466.jpg,1024,682,126,80,478,353,False,352,273,96096
00002300.jpg,962,1215,359,132,661,576,False,302,444,134088
00000517.jpg,2000,1333,4,244,460,621,False,456,377,171912
00000517.jpg,2000,1333,747,506,1264,899,False,517,393,203181
00001609.jpg,1300,956,777,322,981,494,False,204,172,35088
00000503.jpg,1300,1043,650,500,946,777,False,296,277,81992
00000503.jpg,1300,1043,292,331,536,554,False,244,223,54412
00000503.jpg,1300,1043,600,331,838,549,False,238,218,51884
00000503.jpg,1300,1043,317,561,566,793,False,249,232,57768
00000503.jpg,1300,1043,456,255,640,426,False,184,171,31464
00000503.jpg,1300,1043,611,185,773,335,False,162,150,24300
00000503.jpg,1300,1043,879,282,1238,624,False,359,342,122778
00002314.jpg,448,600,272,143,324,225,False,52,82,4264
00002314.jpg,448,600,150,151,202,233,False,52,82,4264
00002472.jpg,640,468,177,154,282,243,False,105,89,9345
00002472.jpg,640,468,406,144,523,244,False,117,100,11700
00000265.jpg,667,1000,295,170,519,560,False,224,390,87360
00001190.jpg,236,340,49,1,134,139,False,85,138,11730
00002499.jpg,800,675,248,1,800,555,False,552,554,305808
00001184.jpg,1024,683,350,131,538,277,False,188,146,27448
00001806.jpg,1050,700,296,96,978,625,False,682,529,360778
00001807.jpg,1200,798,569,122,945,413,False,376,291,109416
00001813.jpg,683,1024,160,293,485,860,False,325,567,184275
00001191.jpg,1000,714,421,55,674,266,False,253,211,53383
00000502.jpg,1300,956,647,219,843,387,False,196,168,32928
00000502.jpg,1300,956,293,369,531,573,False,238,204,48552
00000502.jpg,1300,956,265,225,453,382,False,188,157,29516
00000502.jpg,1300,956,811,410,1065,628,False,254,218,55372
00000502.jpg,1300,956,779,136,971,304,False,192,168,32256
00001608.jpg,1000,709,566,90,789,273,False,223,183,40809
00000516.jpg,1300,956,365,164,589,355,False,224,191,42784
00000516.jpg,1300,956,603,129,978,457,False,375,328,123000
00000516.jpg,1300,956,472,35,726,258,False,254,223,56642
00000516.jpg,1300,956,980,249,1282,508,False,302,259,78218
00000516.jpg,1300,956,113,262,409,521,False,296,259,76664
00000516.jpg,1300,956,190,101,378,262,False,188,161,30268
00002301.jpg,1200,1800,492,293,717,685,False,225,392,88200
00001620.jpg,1000,667,450,95,785,361,False,335,266,89110
00001152.jpg,1257,1300,524,171,731,421,False,207,250,51750
00003023.jpg,549,309,415,121,520,188,False,105,67,7035
00003023.jpg,549,309,130,128,235,197,False,105,69,7245
00003023.jpg,549,309,409,31,512,99,False,103,68,7004
00003023.jpg,549,309,104,9,192,67,False,88,58,5104
00003023.jpg,549,309,243,52,361,129,False,118,77,9086
00001634.jpg,500,333,205,36,322,129,False,117,93,10881
00002856.jpg,612,408,265,118,445,258,False,180,140,25200
00000099.jpg,950,1300,334,349,501,609,False,167,260,43420
00000099.jpg,950,1300,582,471,732,705,False,150,234,35100
00000099.jpg,950,1300,314,119,461,348,False,147,229,33663
00001387.jpg,2940,1960,737,231,1467,786,False,730,555,405150
00000933.jpg,683,1024,232,122,362,350,False,130,228,29640
00002842.jpg,480,360,157,13,255,96,False,98,83,8134
00002842.jpg,480,360,255,26,344,103,False,89,77,6853
00002842.jpg,480,360,70,92,149,163,False,79,71,5609
00002842.jpg,480,360,332,63,406,127,False,74,64,4736
00002842.jpg,480,360,214,116,288,180,False,74,64,4736
00002117.jpg,1300,1152,557,14,823,288,False,266,274,72884
00002117.jpg,1300,1152,741,75,985,327,False,244,252,61488
00002103.jpg,1500,1120,519,35,933,402,False,414,367,151938
00000072.jpg,612,407,360,54,515,176,False,155,122,18910
00001344.jpg,920,1380,155,244,364,610,False,209,366,76494
00001422.jpg,667,1000,344,250,480,493,False,136,243,33048
00001436.jpg,1333,2000,516,249,839,825,False,323,576,186048
00002659.jpg,1500,1371,783,728,970,926,False,187,198,37026
00001350.jpg,600,900,242,47,318,179,False,76,132,10032
00002922.jpg,868,1300,461,135,572,331,False,111,196,21756
00000853.jpg,1315,2000,610,173,770,456,False,160,283,45280
00001595.jpg,1000,854,367,54,615,300,False,248,246,61008
00000847.jpg,4083,5104,1541,1215,2412,2456,False,871,1241,1080911
00001581.jpg,656,1024,288,142,440,420,False,152,278,42256
00002705.jpg,960,641,318,160,713,467,False,395,307,121265
00002063.jpg,867,1390,368,319,451,474,False,83,155,12865
00003369.jpg,612,485,11,74,136,189,False,125,115,14375
00003369.jpg,612,485,260,47,380,158,False,120,111,13320
00002077.jpg,267,400,90,52,220,278,False,130,226,29380
00002711.jpg,786,469,153,45,310,152,False,157,107,16799
00002739.jpg,626,418,290,83,384,156,False,94,73,6862
00003427.jpg,612,408,135,42,476,307,False,341,265,90365
00001556.jpg,608,342,35,1,566,291,False,531,290,153990
00000884.jpg,1024,663,281,35,403,127,False,122,92,11224
00001542.jpg,2269,1960,1689,251,1921,489,False,232,238,55216
00003433.jpg,236,354,78,61,123,140,False,45,79,3555
00001973.jpg,654,980,204,101,347,345,False,143,244,34892
00001967.jpg,1024,678,558,194,746,339,False,188,145,27260
00001797.jpg,958,1277,277,139,705,788,False,428,649,277772
00000489.jpg,750,1127,371,329,489,536,False,118,207,24426
00001783.jpg,958,1231,425,127,678,506,False,253,379,95887
00003194.jpg,612,433,465,32,535,89,False,70,57,3990
00001768.jpg,1024,683,359,198,654,426,False,295,228,67260
00002275.jpg,612,408,219,45,464,235,False,245,190,46550
00001754.jpg,600,849,231,197,362,413,False,131,216,28296
00003143.jpg,1285,2048,533,511,872,1141,False,339,630,213570
00003143.jpg,1285,2048,484,1051,720,1479,False,236,428,101008
00001032.jpg,1000,1250,357,377,595,723,False,238,346,82348
00001026.jpg,418,626,145,99,232,252,False,87,153,13311
00000338.jpg,640,427,158,103,263,183,False,105,80,8400
00000338.jpg,640,427,342,50,455,137,False,113,87,9831
00000338.jpg,640,427,237,72,342,153,False,105,81,8505
00002249.jpg,1330,919,128,82,1197,905,False,1069,823,879787
00001740.jpg,1470,980,359,254,896,671,False,537,417,223929
00003141.jpg,600,397,56,112,176,204,False,120,92,11040
00003141.jpg,600,397,397,217,523,311,False,126,94,11844
00003141.jpg,600,397,134,156,299,283,False,165,127,20955
00003141.jpg,600,397,20,212,186,339,False,166,127,21082
00003141.jpg,600,397,277,143,414,246,False,137,103,14111
00003141.jpg,600,397,467,133,598,236,False,131,103,13493
00003141.jpg,600,397,1,147,84,228,False,83,81,6723
00001756.jpg,800,533,243,1,797,411,False,554,410,227140
00000448.jpg,650,433,528,192,624,266,False,96,74,7104
00000448.jpg,650,433,176,177,250,235,False,74,58,4292
00000448.jpg,650,433,242,120,318,178,False,76,58,4408
00001742.jpg,360,255,149,45,221,104,False,72,59,4248
00003155.jpg,700,466,181,5,563,294,False,382,289,110398
00002263.jpg,2560,1627,192,646,447,835,False,255,189,48195
00003169.jpg,500,500,228,145,308,238,False,80,93,7440
00000460.jpg,1300,956,715,62,975,289,False,260,227,59020
00002511.jpg,1300,957,454,204,642,368,False,188,164,30832
00001795.jpg,1024,683,1,1,1005,683,False,1004,682,684728
00003196.jpg,509,339,249,57,439,205,False,190,148,28120
00003196.jpg,509,339,181,64,364,209,False,183,145,26535
00001959.jpg,996,1600,368,131,543,458,False,175,327,57225
00001781.jpg,682,1024,197,97,509,628,False,312,531,165672
00001971.jpg,1300,956,513,14,773,236,False,260,222,57720
00001965.jpg,590,393,214,93,384,224,False,170,131,22270
00001554.jpg,626,417,363,56,532,187,False,169,131,22139
00003343.jpg,1000,1000,745,595,874,743,False,129,148,19092
00003425.jpg,800,800,305,178,405,294,False,100,116,11600
00000138.jpg,390,280,159,70,234,132,False,75,62,4650
00003431.jpg,736,1111,169,470,257,620,False,88,150,13200
00003431.jpg,736,1111,332,254,436,437,False,104,183,19032
00003431.jpg,736,1111,198,320,284,471,False,86,151,12986
00003431.jpg,736,1111,431,342,515,486,False,84,144,12096
00002049.jpg,1600,1167,605,99,918,365,False,313,266,83258
00003357.jpg,844,1390,139,146,308,470,False,169,324,54756
00001540.jpg,1600,1087,696,221,1310,706,False,614,485,297790
00000886.jpg,800,1200,283,237,415,466,False,132,229,30228
00001568.jpg,626,417,265,32,437,166,False,172,134,23048
00000110.jpg,1600,1168,514,89,1260,737,False,746,648,483408
00002707.jpg,500,333,188,35,402,200,False,214,165,35310
00002713.jpg,1024,683,456,139,684,316,False,228,177,40356
00002713.jpg,1024,683,699,80,1022,354,False,323,274,88502
00000104.jpg,950,1300,334,349,501,609,False,167,260,43420
00000104.jpg,950,1300,582,471,732,705,False,150,234,35100
00000104.jpg,950,1300,314,119,461,348,False,147,229,33663
00002075.jpg,1024,694,447,94,748,331,False,301,237,71337
00001597.jpg,1300,956,634,270,888,487,False,254,217,55118
00000851.jpg,612,612,1,41,408,564,False,407,523,212861
00002920.jpg,1024,681,193,154,569,445,False,376,291,109416
00002920.jpg,1024,681,405,273,713,516,False,308,243,74844
00002934.jpg,1170,550,628,39,1037,268,False,409,229,93661
00002934.jpg,1170,550,367,147,711,335,False,344,188,64672
00002934.jpg,1170,550,36,93,420,303,False,384,210,80640
00001583.jpg,2000,1333,536,94,1112,531,False,576,437,251712
00000845.jpg,600,439,178,31,464,279,False,286,248,70928
00003394.jpg,612,433,261,191,416,321,False,155,130,20150
00003394.jpg,612,433,198,142,329,250,False,131,108,14148
00003394.jpg,612,433,119,164,231,257,False,112,93,10416
00003394.jpg,612,433,147,41,254,129,False,107,88,9416
00002908.jpg,533,800,186,86,366,400,False,180,314,56520
00000879.jpg,2000,3019,656,296,1092,1062,False,436,766,333976
00001420.jpg,800,1200,334,162,490,436,False,156,274,42744
00003237.jpg,500,604,221,256,315,388,False,94,132,12408
00002129.jpg,1300,866,583,235,860,450,False,277,215,59555
00002897.jpg,612,408,222,56,395,190,False,173,134,23182
00000058.jpg,2000,1268,707,292,1259,690,False,552,398,219696
00000058.jpg,2000,1268,511,336,1039,718,False,528,382,201696
00001352.jpg,1001,1600,426,412,609,754,False,183,342,62586
00002883.jpg,1536,1024,164,196,1039,874,False,875,678,593250
00002115.jpg,626,418,355,60,564,223,False,209,163,34067
00000702.jpg,736,736,368,275,477,399,False,109,124,13516
00000702.jpg,736,736,469,277,580,406,False,111,129,14319
00000702.jpg,736,736,257,285,359,403,False,102,118,12036
00000702.jpg,736,736,151,358,278,505,False,127,147,18669
00000702.jpg,736,736,287,194,366,288,False,79,94,7426
00002667.jpg,600,419,257,65,445,218,False,188,153,28764
00002101.jpg,1000,667,381,267,535,386,False,154,119,18326
00002101.jpg,1000,667,530,146,698,277,False,168,131,22008
00001385.jpg,695,1050,400,209,476,340,False,76,131,9956
00002854.jpg,900,600,225,2,785,409,False,560,407,227920
00002698.jpg,4800,3600,2708,446,4091,1653,False,1383,1207,1669281
00002698.jpg,4800,3600,1233,468,1792,955,False,559,487,272233
00001391.jpg,450,288,144,15,190,50,False,46,35,1610
00000931.jpg,1000,1620,299,152,508,546,False,209,394,82346
00002868.jpg,400,600,148,75,323,387,False,175,312,54600
00001144.jpg,267,400,74,112,159,259,False,85,147,12495
00003035.jpg,390,280,54,75,131,139,False,77,64,4928
00003035.jpg,390,280,140,50,239,134,False,99,84,8316
00003035.jpg,390,280,270,50,355,121,False,85,71,6035
00003035.jpg,390,280,150,144,240,220,False,90,76,6840
00001622.jpg,866,1300,388,317,491,496,False,103,179,18437
00000528.jpg,1300,957,798,279,1047,492,False,249,213,53037
00000528.jpg,1300,957,416,214,676,437,False,260,223,57980
00000528.jpg,1300,957,193,318,483,561,False,290,243,70470
00000528.jpg,1300,957,662,153,900,353,False,238,200,47600
00001636.jpg,864,1300,236,83,382,332,False,146,249,36354
00003021.jpg,550,374,32,77,229,233,False,197,156,30732
00002459.jpg,1200,1800,239,1,1162,1346,False,923,1345,1241435
00002471.jpg,568,433,37,8,220,170,False,183,162,29646
00002471.jpg,568,433,301,11,436,131,False,135,120,16200
00001178.jpg,1600,1167,576,190,1057,599,False,481,409,196729
00000266.jpg,700,467,352,88,576,258,False,224,170,38080
00002317.jpg,682,1024,225,64,413,393,False,188,329,61852
00003009.jpg,500,701,183,171,260,297,False,77,126,9702
00002303.jpg,2061,3000,515,452,1354,1874,False,839,1422,1193058
00000272.jpg,399,620,148,93,198,184,False,50,91,4550
00001839.jpg,866,1300,177,8,566,687,False,389,679,264131
00001193.jpg,800,582,133,88,384,301,False,251,213,53463
00001805.jpg,1300,956,543,75,926,402,False,383,327,125241
00001811.jpg,907,1390,221,267,461,694,False,240,427,102480
00001810.jpg,408,612,127,15,264,253,False,137,238,32606
00001192.jpg,1300,957,632,210,998,524,False,366,314,114924
00001186.jpg,1500,1143,616,97,903,351,False,287,254,72898
00000298.jpg,768,512,77,118,184,200,False,107,82,8774
00000298.jpg,768,512,203,97,289,165,False,86,68,5848
00001838.jpg,500,333,186,25,295,109,False,109,84,9156
00001179.jpg,800,534,404,39,611,199,False,207,160,33120
00003008.jpg,1242,918,158,1,1083,309,False,925,308,284900
00003020.jpg,414,230,160,96,255,157,False,95,61,5795
00001637.jpg,1307,1960,499,570,778,1047,False,279,477,133083
00001151.jpg,1331,2000,476,613,754,1099,False,278,486,135108
00001623.jpg,433,650,152,187,244,349,False,92,162,14904
00003034.jpg,1000,1527,622,667,725,849,False,103,182,18746
00002869.jpg,681,1024,228,127,394,410,False,166,283,46978
00001390.jpg,334,519,153,38,231,176,False,78,138,10764
00002841.jpg,480,360,272,69,362,148,False,90,79,7110
00000930.jpg,800,533,153,35,306,154,False,153,119,18207
00000924.jpg,735,980,341,69,492,303,False,151,234,35334
00002855.jpg,1080,720,392,59,787,371,False,395,312,123240
00002855.jpg,1080,720,625,164,936,405,False,311,241,74951
00001384.jpg,710,1024,219,161,423,504,False,204,343,69972
00000717.jpg,1600,1138,593,163,787,324,False,194,161,31234
00000717.jpg,1600,1138,916,194,1087,335,False,171,141,24111
00000717.jpg,1600,1138,734,365,965,557,False,231,192,44352
00001409.jpg,800,582,357,126,450,205,False,93,79,7347
00000703.jpg,1024,576,410,55,692,240,False,282,185,52170
00000703.jpg,1024,576,156,87,394,243,False,238,156,37128
00002114.jpg,500,625,283,42,387,194,False,104,152,15808
00002114.jpg,500,625,112,204,224,362,False,112,158,17696
00002672.jpg,688,1024,235,246,376,490,False,141,244,34404
00001353.jpg,2000,1333,571,94,1318,673,False,747,579,432513
00001435.jpg,1300,821,186,1,1049,572,False,863,571,492773
00003222.jpg,236,354,114,71,153,138,False,39,67,2613
00002128.jpg,390,280,100,34,278,186,False,178,152,27056
00001421.jpg,1600,1090,781,144,1177,458,False,396,314,124344
00001347.jpg,861,1300,389,76,519,304,False,130,228,29640
00002896.jpg,2000,1333,1081,311,1448,595,False,367,284,104228
00002896.jpg,2000,1333,503,390,894,693,False,391,303,118473
00002909.jpg,960,444,127,108,336,218,False,209,110,22990
00003395.jpg,612,408,410,74,513,152,False,103,78,8034
00003395.jpg,612,408,492,70,612,165,False,120,95,11400
00003395.jpg,612,408,342,111,416,169,False,74,58,4292
00003395.jpg,612,408,1,56,75,144,False,74,88,6512
00003395.jpg,612,408,136,75,217,138,False,81,63,5103
00003395.jpg,612,408,35,92,123,160,False,88,68,5984
00000844.jpg,372,280,166,11,271,103,False,105,92,9660
00001582.jpg,957,1000,1,45,433,603,False,432,558,241056
00001582.jpg,957,1000,539,57,957,587,False,418,530,221540
00000850.jpg,600,400,98,107,303,267,False,205,160,32800
00003381.jpg,612,408,231,131,346,220,False,115,89,10235
00002921.jpg,870,580,325,99,429,181,False,104,82,8528
00000105.jpg,1800,1200,689,102,1026,364,False,337,262,88294
00002712.jpg,500,334,285,88,340,130,False,55,42,2310
00002074.jpg,608,406,278,47,461,189,False,183,142,25986
00001569.jpg,600,900,243,83,444,434,False,201,351,70551
00000677.jpg,678,446,205,146,344,254,False,139,108,15012
00000677.jpg,678,446,383,158,537,276,False,154,118,18172
00002060.jpg,640,640,42,109,297,406,False,255,297,75735
00002060.jpg,640,640,343,44,631,379,False,288,335,96480
00002706.jpg,612,408,163,123,291,222,False,128,99,12672
00002706.jpg,612,408,223,51,356,152,False,133,101,13433
00002706.jpg,612,408,50,122,204,242,False,154,120,18480
00002706.jpg,612,408,281,6,418,112,False,137,106,14522
00002706.jpg,612,408,278,189,412,292,False,134,103,13802
00003418.jpg,800,800,325,306,468,473,False,143,167,23881
00003430.jpg,800,800,388,45,479,151,False,91,106,9646
00001541.jpg,408,544,148,20,252,180,False,104,160,16640
00001541.jpg,408,544,158,207,268,378,False,110,171,18810
00002048.jpg,1300,867,585,120,862,335,False,277,215,59555
00003342.jpg,736,1103,250,365,366,563,False,116,198,22968
00003342.jpg,736,1103,411,479,519,669,False,108,190,20520
00000893.jpg,300,300,60,37,118,105,False,58,68,3944
00001555.jpg,1500,1500,414,122,1102,923,False,688,801,551088
00001233.jpg,667,1000,225,63,465,481,False,240,418,100320
00003424.jpg,736,508,224,104,336,194,False,112,90,10080
00003424.jpg,736,508,474,3,581,88,False,107,85,9095
00003424.jpg,736,508,81,129,194,219,False,113,90,10170
00003424.jpg,736,508,505,160,595,230,False,90,70,6300
00001964.jpg,600,418,241,37,377,145,False,136,108,14688
00001964.jpg,600,418,147,31,290,144,False,143,113,16159
00001958.jpg,400,326,101,16,272,182,False,171,166,28386
00003197.jpg,1024,681,381,96,819,435,False,438,339,148482
00003183.jpg,960,481,579,76,960,325,False,381,249,94869
00003183.jpg,960,481,41,82,499,354,False,458,272,124576
00001794.jpg,866,1390,298,62,630,669,False,332,607,201524
00002276.jpg,1326,1800,362,606,760,1236,False,398,630,250740
00003168.jpg,1300,957,463,114,673,290,False,210,176,36960
00001019.jpg,640,761,307,52,446,246,False,139,194,26966
00003154.jpg,612,408,313,45,509,198,False,196,153,29988
00001743.jpg,600,900,252,28,462,394,False,210,366,76860
00001025.jpg,867,1300,393,96,574,405,False,181,309,55929
00002538.jpg,400,267,102,4,361,201,False,259,197,51023
00001757.jpg,1300,1360,501,147,761,464,False,260,317,82420
00003140.jpg,630,354,124,9,630,354,False,506,345,174570
00003178.jpg,2000,1333,1487,244,1776,469,False,289,225,65025
00003178.jpg,2000,1333,1115,313,1353,498,False,238,185,44030
00003178.jpg,2000,1333,514,453,791,668,False,277,215,59555
00000317.jpg,1001,1600,460,90,624,397,False,164,307,50348
00000317.jpg,1001,1600,357,273,518,573,False,161,300,48300
00000303.jpg,389,280,102,103,238,219,False,136,116,15776
00000303.jpg,389,280,205,51,347,170,False,142,119,16898
00002514.jpg,716,996,286,226,402,412,False,116,186,21576
00002272.jpg,1024,746,292,179,675,503,False,383,324,124092
00003144.jpg,481,323,26,87,168,198,False,142,111,15762
00001753.jpg,976,1300,532,97,651,281,False,119,184,21896
00001035.jpg,682,1023,154,1,359,282,False,205,281,57605
00001021.jpg,1012,1390,309,72,607,538,False,298,466,138868
00001747.jpg,1600,1167,414,23,916,450,False,502,427,214354
00000459.jpg,3024,4032,1235,1651,1766,2475,False,531,824,437544
00003150.jpg,750,502,483,30,612,131,False,129,101,13029
00003150.jpg,750,502,130,61,254,157,False,124,96,11904
00001974.jpg,1050,700,405,84,614,247,False,209,163,34067
00001960.jpg,1300,861,661,159,1087,488,False,426,329,140154
00001948.jpg,1000,1500,285,151,561,632,False,276,481,132756
00001790.jpg,800,533,234,60,644,377,False,410,317,129970
00002299.jpg,375,500,83,106,193,277,False,110,171,18810
00003187.jpg,510,340,97,62,186,132,False,89,70,6230
00003187.jpg,510,340,390,118,444,160,False,54,42,2268
00003187.jpg,510,340,257,193,331,250,False,74,57,4218
00003193.jpg,1000,1000,222,609,340,747,False,118,138,16284
00000115.jpg,1024,683,267,132,472,291,False,205,159,32595
00002702.jpg,1362,2048,442,343,931,1182,False,489,839,410271
00002064.jpg,1600,1167,605,99,918,365,False,313,266,83258
00000667.jpg,2000,1125,749,421,1338,807,False,589,386,227354
00000667.jpg,2000,1125,1196,27,1772,412,False,576,385,221760
00000667.jpg,2000,1125,7,152,622,572,False,615,420,258300
00000667.jpg,2000,1125,857,96,1224,331,False,367,235,86245
00000667.jpg,2000,1125,973,94,1356,340,False,383,246,94218
00000667.jpg,2000,1125,412,80,976,449,False,564,369,208116
00001237.jpg,1300,731,532,65,804,239,False,272,174,47328
00000129.jpg,1600,1156,695,231,893,398,False,198,167,33066
00000897.jpg,1000,1777,291,295,707,1137,False,416,842,350272
00001551.jpg,800,558,382,52,633,251,False,251,199,49949
00002058.jpg,800,533,556,103,685,203,False,129,100,12900
00002058.jpg,800,533,336,51,483,164,False,147,113,16611
00002058.jpg,800,533,103,109,226,206,False,123,97,11931
00001545.jpg,684,1024,284,385,388,565,False,104,180,18720
00001223.jpg,1300,1300,468,77,859,532,False,391,455,177905
00003434.jpg,447,497,109,235,213,367,False,104,132,13728
00002919.jpg,1000,600,124,32,362,199,False,238,167,39746
00002919.jpg,1000,600,1,116,156,265,False,155,149,23095
00002919.jpg,1000,600,836,64,1000,223,False,164,159,26076
00002919.jpg,1000,600,339,138,553,287,False,214,149,31886
00002919.jpg,1000,600,494,99,752,279,False,258,180,46440
00003385.jpg,736,689,248,52,377,193,False,129,141,18189
00003385.jpg,736,689,307,185,436,323,False,129,138,17802
00003385.jpg,736,689,366,421,484,550,False,118,129,15222
00003385.jpg,736,689,235,226,337,337,False,102,111,11322
00003385.jpg,736,689,451,293,546,395,False,95,102,9690
00000854.jpg,1358,1045,428,205,771,506,False,343,301,103243
00001592.jpg,2940,1960,1046,144,1822,746,False,776,602,467152
00000840.jpg,1300,866,438,191,903,552,False,465,361,167865
00001586.jpg,800,533,309,70,503,224,False,194,154,29876
00002931.jpg,800,800,89,509,224,665,False,135,156,21060
00000061.jpg,339,508,194,97,239,176,False,45,79,3555
00002676.jpg,467,700,171,69,335,354,False,164,285,46740
00002110.jpg,2000,1125,444,203,941,521,False,497,318,158046
00002110.jpg,2000,1125,1082,89,1577,413,False,495,324,160380
00001419.jpg,3005,1960,994,76,2365,1116,False,1371,1040,1425840
00000707.jpg,720,405,414,17,641,169,False,227,152,34504
00000707.jpg,720,405,330,131,556,282,False,226,151,34126
00000707.jpg,720,405,107,116,415,313,False,308,197,60676
00000707.jpg,720,405,483,160,719,336,False,236,176,41536
00000707.jpg,720,405,244,1,480,148,False,236,147,34692
00000713.jpg,1280,853,269,73,646,365,False,377,292,110084
00000713.jpg,1280,853,593,59,866,270,False,273,211,57603
00002662.jpg,650,433,228,108,462,285,False,234,177,41418
00000075.jpg,1000,597,52,7,634,402,False,582,395,229890
00002892.jpg,1200,675,351,1,1165,517,False,814,516,420024
00001343.jpg,892,1000,369,75,615,396,False,246,321,78966
00001425.jpg,1280,853,891,204,1092,360,False,201,156,31356
00003232.jpg,960,641,140,17,454,257,False,314,240,75360
00003232.jpg,960,641,346,1,648,210,False,302,209,63118
00003232.jpg,960,641,403,172,652,365,False,249,193,48057
00002138.jpg,1300,917,473,78,824,366,False,351,288,101088
00001431.jpg,1000,667,428,153,661,334,False,233,181,42173
00001357.jpg,866,1300,188,266,280,428,False,92,162,14904
00001357.jpg,866,1300,562,388,661,560,False,99,172,17028
00000908.jpg,1300,866,260,87,544,307,False,284,220,62480
00001380.jpg,1000,1500,449,433,649,782,False,200,349,69800
00002851.jpg,1400,788,69,140,816,630,False,747,490,366030
00002689.jpg,500,751,126,264,206,405,False,80,141,11280
00002689.jpg,500,751,249,286,322,415,False,73,129,9417
00002689.jpg,500,751,65,343,124,447,False,59,104,6136
00000920.jpg,1600,1167,421,33,1109,629,False,688,596,410048
00002845.jpg,1000,1500,511,368,616,551,False,105,183,19215
00002312.jpg,651,1024,283,125,361,264,False,78,139,10842
00002474.jpg,1023,716,1,41,575,558,False,574,517,296758
00002474.jpg,1023,716,455,56,1023,585,False,568,529,300472
00000263.jpg,960,864,732,112,846,231,False,114,119,13566
00000263.jpg,960,864,412,142,506,240,False,94,98,9212
00000263.jpg,960,864,573,114,674,219,False,101,105,10605
00001169.jpg,1470,980,487,106,969,472,False,482,366,176412
00002306.jpg,700,933,345,69,538,368,False,193,299,57707
00003018.jpg,360,540,110,64,181,184,False,71,120,8520
00003018.jpg,360,540,193,72,249,169,False,56,97,5432
00003018.jpg,360,540,120,205,204,351,False,84,146,12264
00003030.jpg,1023,697,194,48,670,426,False,476,378,179928
00000539.jpg,1125,750,854,4,1089,187,False,235,183,43005
00000539.jpg,1125,750,88,310,551,670,False,463,360,166680
00000539.jpg,1125,750,725,71,981,270,False,256,199,50944
00000539.jpg,1125,750,9,1,378,261,False,369,260,95940
00000539.jpg,1125,750,579,126,876,352,False,297,226,67122
00000539.jpg,1125,750,325,284,678,552,False,353,268,94604
00000539.jpg,1125,750,841,186,1125,711,False,284,525,149100
00001627.jpg,333,519,160,78,252,241,False,92,163,14996
00002448.jpg,1000,750,111,95,338,289,False,227,194,44038
00002448.jpg,1000,750,463,33,808,334,False,345,301,103845
00001155.jpg,1300,956,464,220,823,520,False,359,300,107700
00001633.jpg,1066,1689,321,138,670,769,False,349,631,220219
00001814.jpg,1000,667,666,293,787,385,False,121,92,11132
00001814.jpg,1000,667,346,228,470,325,False,124,97,12028
00001814.jpg,1000,667,466,150,593,249,False,127,99,12573
00001814.jpg,1000,667,449,344,556,427,False,107,83,8881
00001182.jpg,866,1390,400,231,478,376,False,78,145,11310
00001196.jpg,1474,980,848,94,1101,290,False,253,196,49588
00001829.jpg,1024,684,344,51,639,280,False,295,229,67555
00001815.jpg,333,519,135,25,189,120,False,54,95,5130
00001801.jpg,612,408,307,142,465,265,False,158,123,19434
00001801.jpg,612,408,66,22,386,270,False,320,248,79360
00001801.jpg,612,408,414,134,556,242,False,142,108,15336
00001154.jpg,1024,684,185,37,850,553,False,665,516,343140
00003025.jpg,480,480,273,16,365,121,False,92,105,9660
00001632.jpg,390,280,174,16,299,121,False,125,105,13125
00000538.jpg,650,434,475,196,626,313,False,151,117,17667
00003031.jpg,500,384,258,113,317,164,False,59,51,3009
00002449.jpg,512,512,116,50,401,382,False,285,332,94620
00001140.jpg,1000,667,434,81,652,251,False,218,170,37060
00001168.jpg,866,1300,313,123,498,445,False,185,322,59570
00000510.jpg,1300,867,417,74,707,299,False,290,225,65250
00000510.jpg,1300,867,570,153,842,360,False,272,207,56304
00000510.jpg,1300,867,799,105,1108,345,False,309,240,74160
00000510.jpg,1300,867,702,217,986,437,False,284,220,62480
00003019.jpg,800,534,75,100,512,439,False,437,339,148143
00002307.jpg,512,768,152,5,381,397,False,229,392,89768
00002313.jpg,680,1023,220,61,488,530,False,268,469,125692
00000504.jpg,1500,1101,221,244,453,442,False,232,198,45936
00000504.jpg,1500,1101,399,384,680,619,False,281,235,66035
00000504.jpg,1500,1101,824,364,1087,584,False,263,220,57860
00000504.jpg,1500,1101,515,201,741,394,False,226,193,43618
00000504.jpg,1500,1101,579,379,854,609,False,275,230,63250
00000504.jpg,1500,1101,739,238,933,404,False,194,166,32204
00000504.jpg,1500,1101,1008,241,1239,438,False,231,197,45507
00002475.jpg,540,349,210,175,264,215,False,54,40,2160
00000935.jpg,1232,821,491,177,754,386,False,263,209,54967
00001395.jpg,1000,667,189,1,1000,665,False,811,664,538504
00002850.jpg,1333,2000,479,180,694,555,False,215,375,80625
00001381.jpg,2000,1333,822,107,1308,484,False,486,377,183222
00000921.jpg,509,339,255,1,442,144,False,187,143,26741
00002878.jpg,736,489,298,186,449,302,False,151,116,17516
00001430.jpg,538,612,197,92,331,268,False,134,176,23584
00002139.jpg,1000,667,55,19,577,424,False,522,405,211410
00002887.jpg,940,529,77,261,257,379,False,180,118,21240
00002887.jpg,940,529,601,224,801,353,False,200,129,25800
00002887.jpg,940,529,376,21,635,191,False,259,170,44030
00002887.jpg,940,529,164,100,412,266,False,248,166,41168
00001356.jpg,800,533,259,47,521,251,False,262,204,53448
00002893.jpg,1300,960,236,194,779,661,False,543,467,253581
00002893.jpg,1300,960,588,139,1207,671,False,619,532,329308
00003233.jpg,800,800,337,197,475,357,False,138,160,22080
00001424.jpg,1066,1600,457,739,739,1231,False,282,492,138744
00002105.jpg,450,300,1,1,420,193,False,419,192,80448
00000074.jpg,1300,945,471,112,755,347,False,284,235,66740
00002663.jpg,650,488,79,83,275,254,False,196,171,33516
00002663.jpg,650,488,342,78,638,337,False,296,259,76664
00002677.jpg,500,333,145,36,373,217,False,228,181,41268
00000706.jpg,6000,4000,410,1034,1037,1531,False,627,497,311619
00001418.jpg,2825,4237,1327,402,1663,988,False,336,586,196896
00002111.jpg,1024,683,315,93,873,536,False,558,443,247194
00003390.jpg,1080,828,258,30,762,488,False,504,458,230832
00000699.jpg,1000,1000,345,337,645,687,False,300,350,105000
00000699.jpg,1000,1000,678,439,960,767,False,282,328,92496
00001587.jpg,2325,3500,1142,862,1516,1519,False,374,657,245718
00000841.jpg,1500,1000,500,1,1372,621,False,872,620,540640
00002930.jpg,1068,1689,228,335,471,783,False,243,448,108864
00001593.jpg,334,500,93,53,167,180,False,74,127,9398
00003384.jpg,1333,2000,539,550,759,933,False,220,383,84260
00002918.jpg,2370,1350,1259,332,1666,602,False,407,270,109890
00000869.jpg,1300,956,501,56,918,413,False,417,357,148869
00001544.jpg,1000,672,397,42,679,262,False,282,220,62040
00000882.jpg,683,1023,359,184,434,317,False,75,133,9975
00003353.jpg,390,280,171,108,214,145,False,43,37,1591
00003435.jpg,640,960,143,117,309,406,False,166,289,47974
00003435.jpg,640,960,352,280,504,540,False,152,260,39520
00001222.jpg,800,501,487,47,694,195,False,207,148,30636
00000128.jpg,910,607,491,201,662,333,False,171,132,22572
00001236.jpg,600,900,179,18,356,326,False,177,308,54516
00003421.jpg,736,490,136,21,438,254,False,302,233,70366
00003421.jpg,736,490,369,67,626,271,False,257,204,52428
00002059.jpg,408,612,116,73,250,306,False,134,233,31222
00001550.jpg,683,1024,294,37,377,182,False,83,145,12035
00000896.jpg,1232,821,398,146,794,453,False,396,307,121572
00002071.jpg,867,1390,336,103,473,363,False,137,260,35620
00001578.jpg,1307,1960,381,505,678,1024,False,297,519,154143
00000100.jpg,1333,2000,664,478,974,1008,False,310,530,164300
00000114.jpg,600,900,127,29,267,268,False,140,239,33460
00000672.jpg,800,583,517,144,779,371,False,262,227,59474
00000672.jpg,800,583,45,60,303,278,False,258,218,56244
00000672.jpg,800,583,181,133,523,423,False,342,290,99180
00000672.jpg,800,583,362,5,602,200,False,240,195,46800
00000672.jpg,800,583,234,1,437,162,False,203,161,32683
00002065.jpg,1024,830,444,51,624,217,False,180,166,29880
00001785.jpg,1300,929,1,1,1053,498,False,1052,497,522844
00003192.jpg,800,533,382,60,633,254,False,251,194,48694
00003192.jpg,800,533,199,112,415,280,False,216,168,36288
00001791.jpg,590,393,225,56,427,212,False,202,156,31512
00001961.jpg,1000,667,305,71,695,374,False,390,303,118170
00001975.jpg,1000,667,381,57,657,271,False,276,214,59064
00002529.jpg,420,512,187,1,260,74,False,73,73,5329
00003151.jpg,1024,664,354,137,522,264,False,168,127,21336
00003151.jpg,1024,664,254,184,430,313,False,176,129,22704
00003151.jpg,1024,664,154,162,306,276,False,152,114,17328
00001746.jpg,2000,1334,738,311,1340,778,False,602,467,281134
00001752.jpg,1061,1300,414,92,600,352,False,186,260,48360
00003145.jpg,500,331,44,34,373,287,False,329,253,83237
00001034.jpg,600,438,87,24,215,133,False,128,109,13952
00002273.jpg,1000,838,302,142,603,435,False,301,293,88193
00002267.jpg,590,394,166,8,436,219,False,270,211,56970
00000470.jpg,1000,562,291,124,495,258,False,204,134,27336
00001008.jpg,1000,667,364,34,611,226,False,247,192,47424
00002271.jpg,1800,1692,789,334,1354,939,False,565,605,341825
00001778.jpg,866,1300,373,15,713,621,False,340,606,206040
00000466.jpg,600,400,318,129,392,188,False,74,59,4366
00000300.jpg,1000,667,185,165,339,284,False,154,119,18326
00000300.jpg,1000,667,525,272,644,364,False,119,92,10948
00002517.jpg,960,441,65,111,261,216,False,196,105,20580
00002517.jpg,960,441,259,320,451,423,False,192,103,19776
00002517.jpg,960,441,302,27,486,123,False,184,96,17664
00002517.jpg,960,441,734,11,918,109,False,184,98,18032
00002517.jpg,960,441,513,105,713,210,False,200,105,21000
00002517.jpg,960,441,416,285,574,370,False,158,85,13430
00002503.jpg,780,520,281,41,734,393,False,453,352,159456
00000472.jpg,1200,630,521,195,782,355,False,261,160,41760
00002265.jpg,4248,3416,804,261,1635,1039,False,831,778,646518
00002265.jpg,4248,3416,2565,248,3311,946,False,746,698,520708
00002265.jpg,4248,3416,1962,506,2589,1093,False,627,587,368049
00001744.jpg,650,434,223,99,427,258,False,204,159,32436
00003153.jpg,612,408,275,90,380,171,False,105,81,8505
00003153.jpg,612,408,48,76,149,155,False,101,79,7979
00003153.jpg,612,408,481,84,578,159,False,97,75,7275
00003153.jpg,612,408,385,111,477,183,False,92,72,6624
00000328.jpg,1470,980,859,170,1106,362,False,247,192,47424
00003147.jpg,640,960,338,229,421,374,False,83,145,12035
00002259.jpg,634,407,377,52,482,130,False,105,78,8190
00002259.jpg,634,407,248,40,352,118,False,104,78,8112
00001977.jpg,1300,861,401,59,957,487,False,556,428,237968
00001787.jpg,1024,683,136,99,406,309,False,270,210,56700
00003184.jpg,612,408,320,59,379,105,False,59,46,2714
00003184.jpg,612,408,95,83,157,132,False,62,49,3038
00003184.jpg,612,408,470,109,543,166,False,73,57,4161
00002715.jpg,1200,1200,744,244,880,403,False,136,159,21624
00002715.jpg,1200,1200,619,101,800,308,False,181,207,37467
00002715.jpg,1200,1200,431,107,583,284,False,152,177,26904
00002715.jpg,1200,1200,482,396,610,545,False,128,149,19072
00000664.jpg,600,400,249,117,367,209,False,118,92,10856
00000664.jpg,600,400,65,114,170,195,False,105,81,8505
00000664.jpg,600,400,184,138,272,207,False,88,69,6072
00000664.jpg,600,400,233,75,323,143,False,90,68,6120
00002073.jpg,1000,662,297,49,625,296,False,328,247,81016
00002067.jpg,1300,861,367,77,1003,578,False,636,501,318636
00003379.jpg,612,408,93,255,226,358,False,133,103,13699
00003379.jpg,612,408,428,20,593,148,False,165,128,21120
00003379.jpg,612,408,232,111,375,219,False,143,108,15444
00003379.jpg,612,408,239,215,375,323,False,136,108,14688
00000670.jpg,1600,1155,403,173,737,454,False,334,281,93854
00000670.jpg,1600,1155,674,191,1015,478,False,341,287,97867
00000670.jpg,1600,1155,963,160,1327,460,False,364,300,109200
00001208.jpg,600,900,350,106,415,220,False,65,114,7410
00002701.jpg,1000,714,239,171,498,382,False,259,211,54649
00002701.jpg,1000,714,353,147,606,357,False,253,210,53130
00003437.jpg,236,354,103,63,141,131,False,38,68,2584
00003351.jpg,236,354,94,86,132,156,False,38,70,2660
00000894.jpg,1428,2000,315,82,1165,1438,False,850,1356,1152600
00001552.jpg,683,1024,380,449,454,579,False,74,130,9620
00001234.jpg,800,582,256,124,518,341,False,262,217,56854
00002932.jpg,2000,1334,673,79,1081,403,False,408,324,132192
00002932.jpg,2000,1334,674,553,1074,863,False,400,310,124000
00000843.jpg,700,1055,482,84,560,220,False,78,136,10608
00001585.jpg,407,612,67,54,257,379,False,190,325,61750
00002098.jpg,281,519,109,4,167,131,False,58,127,7366
00000857.jpg,1000,667,359,29,732,319,False,373,290,108170
00001591.jpg,390,280,129,22,236,112,False,107,90,9630
00002926.jpg,650,895,568,168,635,272,False,67,104,6968
00001368.jpg,1500,1120,687,99,956,333,False,269,234,62946
00003219.jpg,866,1390,302,281,657,943,False,355,662,235010
00002113.jpg,800,533,108,37,500,341,False,392,304,119168
00000704.jpg,612,387,114,87,276,203,False,162,116,18792
00000704.jpg,612,387,278,110,507,278,False,229,168,38472
00000704.jpg,612,387,339,47,449,126,False,110,79,8690
00000704.jpg,612,387,113,42,206,110,False,93,68,6324
00000704.jpg,612,387,265,38,364,111,False,99,73,7227
00002675.jpg,505,340,127,56,363,240,False,236,184,43424
00001354.jpg,2000,1333,871,102,1388,503,False,517,401,207317
00002885.jpg,504,370,307,167,369,219,False,62,52,3224
00002885.jpg,504,370,180,72,253,132,False,73,60,4380
00002885.jpg,504,370,234,177,294,227,False,60,50,3000
00002885.jpg,504,370,189,207,245,255,False,56,48,2688
00002885.jpg,504,370,267,95,330,149,False,63,54,3402
00002885.jpg,504,370,141,161,205,215,False,64,54,3456
00003225.jpg,389,280,149,98,191,132,False,42,34,1428
00003225.jpg,389,280,251,112,291,146,False,40,34,1360
00001432.jpg,800,530,337,86,644,327,False,307,241,73987
00001426.jpg,500,750,197,243,289,403,False,92,160,14720
00000738.jpg,750,500,447,67,576,167,False,129,100,12900
00000738.jpg,750,500,95,23,224,123,False,129,100,12900
00000738.jpg,750,500,1,56,127,186,False,126,130,16380
00000738.jpg,750,500,305,111,418,199,False,113,88,9944
00003231.jpg,1200,1200,429,357,554,500,False,125,143,17875
00002891.jpg,390,280,162,48,263,132,False,101,84,8484
00001340.jpg,3840,5760,1042,1127,2035,2860,False,993,1733,1720869
00002846.jpg,236,354,77,47,129,136,False,52,89,4628
00001397.jpg,462,280,199,31,380,156,False,181,125,22625
00000089.jpg,1000,1500,374,295,550,602,False,176,307,54032
00000923.jpg,2888,2007,1346,169,1623,393,False,277,224,62048
00001383.jpg,1000,1500,312,49,778,863,False,466,814,379324
00002852.jpg,800,531,178,108,578,417,False,400,309,123600
00002305.jpg,640,960,216,234,347,462,False,131,228,29868
00002477.jpg,1000,1268,639,33,819,298,False,180,265,47700
00002477.jpg,1000,1268,218,303,418,598,False,200,295,59000
00000506.jpg,1024,683,211,221,373,346,False,162,125,20250
00000506.jpg,1024,683,661,153,819,276,False,158,123,19434
00000506.jpg,1024,683,479,189,717,374,False,238,185,44030
00002311.jpg,559,800,181,183,364,482,False,183,299,54717
00001630.jpg,1600,1132,41,8,1321,995,False,1280,987,1263360
00002339.jpg,450,300,114,8,359,194,False,245,186,45570
00003027.jpg,1470,980,954,335,1125,465,False,171,130,22230
00001156.jpg,450,347,205,56,369,207,False,164,151,24764
00003033.jpg,1024,688,246,265,547,506,False,301,241,72541
00003033.jpg,1024,688,467,176,775,416,False,308,240,73920
00001624.jpg,1300,1390,505,135,904,632,False,399,497,198303
00001817.jpg,626,417,143,23,387,216,False,244,193,47092
00001803.jpg,600,420,102,40,467,337,False,365,297,108405
00001195.jpg,1300,866,215,70,566,342,False,351,272,95472
00001180.jpg,417,626,46,47,255,412,False,209,365,76285
00002489.jpg,400,267,95,23,208,111,False,113,88,9944
00001802.jpg,678,1024,252,148,376,362,False,124,214,26536
00001631.jpg,236,327,97,114,134,173,False,37,59,2183
00000249.jpg,600,420,369,52,468,130,False,99,78,7722
00002310.jpg,866,1300,400,257,593,595,False,193,338,65234
00000507.jpg,2000,1333,1246,52,1702,405,False,456,353,160968
00000507.jpg,2000,1333,660,415,1200,834,False,540,419,226260
00000507.jpg,2000,1333,945,327,1431,696,False,486,369,179334
00000507.jpg,2000,1333,1,134,473,632,False,472,498,235056
00000507.jpg,2000,1333,814,373,1309,765,False,495,392,194040
00002462.jpg,385,280,187,35,298,129,False,111,94,10434
00000275.jpg,600,600,229,70,342,199,False,113,129,14577
00002853.jpg,1030,693,318,170,443,268,False,125,98,12250
00002853.jpg,1030,693,438,176,569,278,False,131,102,13362
00002853.jpg,1030,693,600,185,733,290,False,133,105,13965
00001382.jpg,1066,1689,413,95,589,419,False,176,324,57024
00000088.jpg,3456,5184,1372,715,2048,1871,False,676,1156,781456
00001396.jpg,612,494,314,52,587,315,False,273,263,71799
00002847.jpg,350,350,113,76,225,204,False,112,128,14336
00000936.jpg,1000,667,397,59,718,308,False,321,249,79929
00003230.jpg,2000,1331,1039,271,1466,601,False,427,330,140910
00001427.jpg,390,280,136,25,237,109,False,101,84,8484
00001341.jpg,1600,1157,627,129,868,332,False,241,203,48923
00002890.jpg,735,1104,260,209,467,571,False,207,362,74934
00002884.jpg,1500,1253,785,253,1085,545,False,300,292,87600
00002884.jpg,1500,1253,1049,274,1362,578,False,313,304,95152
00002884.jpg,1500,1253,290,132,590,423,False,300,291,87300
00002884.jpg,1500,1253,467,231,748,511,False,281,280,78680
00001355.jpg,1600,1167,335,1,1148,671,False,813,670,544710
00001433.jpg,866,1300,341,111,510,407,False,169,296,50024
00003224.jpg,612,408,94,162,345,356,False,251,194,48694
00003224.jpg,612,408,224,173,515,394,False,291,221,64311
00000705.jpg,2048,1365,788,242,1207,566,False,419,324,135756
00000705.jpg,2048,1365,1292,527,1547,724,False,255,197,50235
00002674.jpg,612,405,42,112,210,242,False,168,130,21840
00002674.jpg,612,405,328,133,490,258,False,162,125,20250
00002674.jpg,612,405,195,101,350,218,False,155,117,18135
00001369.jpg,434,650,141,208,244,388,False,103,180,18540
00000077.jpg,667,1000,262,162,332,281,False,70,119,8330
00002660.jpg,626,417,194,57,359,185,False,165,128,21120
00002106.jpg,600,420,233,11,356,111,False,123,100,12300
00003218.jpg,500,334,272,101,352,163,False,80,62,4960
00000711.jpg,480,320,58,111,165,194,False,107,83,8881
00000711.jpg,480,320,258,91,358,169,False,100,78,7800
00000711.jpg,480,320,139,138,235,211,False,96,73,7008
00001590.jpg,1200,1800,130,474,569,1240,False,439,766,336274
00001590.jpg,1200,1800,725,476,1193,1348,False,468,872,408096
00000856.jpg,683,1023,257,193,324,307,False,67,114,7638
00002099.jpg,1024,886,513,76,689,249,False,176,173,30448
00002099.jpg,1024,886,617,135,793,312,False,176,177,31152
00003393.jpg,800,800,250,103,376,250,False,126,147,18522
00001584.jpg,319,450,164,91,221,185,False,57,94,5358
00000842.jpg,750,1124,250,186,330,326,False,80,140,11200
00000842.jpg,750,1124,397,251,466,371,False,69,120,8280
00003344.jpg,1182,1208,506,495,647,662,False,141,167,23547
00003344.jpg,1182,1208,845,456,971,606,False,126,150,18900
00003344.jpg,1182,1208,339,535,477,698,False,138,163,22494
00003344.jpg,1182,1208,197,477,323,627,False,126,150,18900
00003344.jpg,1182,1208,783,626,901,767,False,118,141,16638
00003344.jpg,1182,1208,694,504,803,630,False,109,126,13734
00000895.jpg,512,704,59,68,370,566,False,311,498,154878
00001235.jpg,600,419,187,1,593,250,False,406,249,101094
00002728.jpg,866,1390,274,62,599,657,False,325,595,193375
00003436.jpg,612,408,249,95,394,208,False,145,113,16385
00001221.jpg,867,1000,381,90,544,308,False,163,218,35534
00001547.jpg,1300,956,606,77,942,364,False,336,287,96432
00000881.jpg,1500,1000,558,97,1000,440,False,442,343,151606
00003378.jpg,600,400,267,122,358,191,False,91,69,6279
00003378.jpg,600,400,171,78,274,158,False,103,80,8240
00003378.jpg,600,400,336,76,439,155,False,103,79,8137
00003378.jpg,600,400,90,119,177,184,False,87,65,5655
00003378.jpg,600,400,183,162,258,220,False,75,58,4350
00003378.jpg,600,400,394,130,475,194,False,81,64,5184
00002066.jpg,1500,1120,509,16,897,353,False,388,337,130756
00001209.jpg,800,582,266,71,548,309,False,282,238,67116
00000103.jpg,1264,1500,576,418,957,943,False,381,525,200025
00002714.jpg,390,280,97,26,292,189,False,195,163,31785
00000665.jpg,2940,1960,1184,459,2191,1241,False,1007,782,787474
00000665.jpg,2940,1960,674,583,1539,1254,False,865,671,580415
00003185.jpg,640,457,371,53,617,257,False,246,204,50184
00003185.jpg,640,457,186,1,464,232,False,278,231,64218
00001792.jpg,1335,2000,622,184,767,437,False,145,253,36685
00001786.jpg,1300,956,316,170,823,614,False,507,444,225108
00003191.jpg,500,333,174,69,331,191,False,157,122,19154
00001976.jpg,350,263,58,40,141,113,False,83,73,6059
00001962.jpg,632,420,190,11,406,179,False,216,168,36288
00001989.jpg,1000,710,411,1,725,244,False,314,243,76302
00001751.jpg,1136,1300,504,185,768,537,False,264,352,92928
00002258.jpg,910,607,6,1,910,594,False,904,593,536072
00003146.jpg,626,418,495,124,600,206,False,105,82,8610
00003146.jpg,626,418,271,83,378,166,False,107,83,8881
00003146.jpg,626,418,143,150,253,235,False,110,85,9350
00003146.jpg,626,418,348,167,458,252,False,110,85,9350
00003146.jpg,626,418,37,149,140,229,False,103,80,8240
00003152.jpg,800,533,382,60,633,254,False,251,194,48694
00003152.jpg,800,533,199,112,415,280,False,216,168,36288
00001745.jpg,1300,866,514,110,905,413,False,391,303,118473
00001023.jpg,364,500,146,44,216,155,False,70,111,7770
00000315.jpg,335,254,83,31,195,130,False,112,99,11088
00002264.jpg,718,1024,205,105,492,582,False,287,477,136899
00001779.jpg,667,1000,282,158,391,346,False,109,188,20492
00002516.jpg,2946,1960,874,264,1687,893,False,813,629,511377
00000301.jpg,867,1300,437,392,599,670,False,162,278,45036
00001006.jpg,450,321,11,14,297,257,False,286,243,69498
00003177.jpg,150,150,48,1,98,48,False,50,47,2350
00002269.jpg,1280,720,515,19,1276,625,False,761,606,461166
00001760.jpg,1024,684,178,37,857,553,False,679,516,350364
00003163.jpg,682,1023,415,360,532,565,False,117,205,23985
00001012.jpg,1000,1500,431,435,627,784,False,196,349,68404
00000442.jpg,768,1151,278,239,457,551,False,179,312,55848
00001984.jpg,509,339,240,54,453,222,False,213,168,35784
00001990.jpg,350,525,115,1,185,120,False,70,119,8330
00002296.jpg,1000,667,449,39,877,378,False,428,339,145092
00003188.jpg,1000,1000,227,225,410,443,False,183,218,39894
00002282.jpg,800,600,85,67,301,255,False,216,188,40608
00002282.jpg,800,600,580,77,734,211,False,154,134,20636
00002282.jpg,800,600,460,239,560,325,False,100,86,8600
00001562.jpg,735,946,415,51,499,174,False,84,123,10332
00001562.jpg,735,946,299,25,392,161,False,93,136,12648
00003413.jpg,626,445,126,126,241,221,False,115,95,10925
00003413.jpg,626,445,254,133,361,222,False,107,89,9523
00003413.jpg,626,445,196,57,306,148,False,110,91,10010
00003413.jpg,626,445,315,72,432,169,False,117,97,11349
00003413.jpg,626,445,460,159,574,254,False,114,95,10830
00001204.jpg,1000,667,370,2,752,285,False,382,283,108106
00001210.jpg,450,300,174,9,277,89,False,103,80,8240
00003407.jpg,612,459,384,158,453,219,False,69,61,4209
00003407.jpg,612,459,280,164,351,226,False,71,62,4402
00003407.jpg,612,459,108,158,175,215,False,67,57,3819
00003361.jpg,1024,683,241,378,464,551,False,223,173,38579
00003361.jpg,1024,683,639,115,839,268,False,200,153,30600
00003361.jpg,1024,683,779,158,975,310,False,196,152,29792
00003361.jpg,1024,683,474,333,684,495,False,210,162,34020
00003361.jpg,1024,683,476,145,660,284,False,184,139,25576
00003361.jpg,1024,683,211,207,407,360,False,196,153,29988
00003361.jpg,1024,683,305,160,497,309,False,192,149,28608
00003361.jpg,1024,683,826,312,1022,493,False,196,181,35476
00003361.jpg,1024,683,1,348,192,514,False,191,166,31706
00001576.jpg,1500,1138,674,111,1288,653,False,614,542,332788
00002057.jpg,683,1024,387,97,513,311,False,126,214,26964
00000640.jpg,1500,1101,154,254,550,599,False,396,345,136620
00000640.jpg,1500,1101,517,290,968,667,False,451,377,170027
00000640.jpg,1500,1101,1035,295,1423,619,False,388,324,125712
00000640.jpg,1500,1101,789,73,1168,398,False,379,325,123175
00000640.jpg,1500,1101,372,68,768,406,False,396,338,133848
00000898.jpg,675,900,265,56,403,275,False,138,219,30222
00001238.jpg,1024,683,33,22,492,379,False,459,357,163863
00002725.jpg,640,960,222,156,411,478,False,189,322,60858
00002043.jpg,626,417,195,37,332,142,False,137,105,14385
00002916.jpg,866,1390,434,308,539,509,False,105,201,21105
00002916.jpg,866,1390,288,238,396,435,False,108,197,21276
00002902.jpg,1080,1080,268,96,870,796,False,602,700,421400
00002094.jpg,662,1000,284,66,463,380,False,179,314,56206
00002080.jpg,682,1023,46,1,638,409,False,592,408,241536
00001589.jpg,867,1300,408,196,509,372,False,101,176,17776
00000697.jpg,1500,1000,656,44,1118,402,False,462,358,165396
00000697.jpg,1500,1000,145,234,559,555,False,414,321,132894
00000697.jpg,1500,1000,950,1,1475,346,False,525,345,181125
00000697.jpg,1500,1000,348,210,735,511,False,387,301,116487
00001416.jpg,333,519,86,26,156,152,False,70,126,8820
00002679.jpg,866,1390,321,61,644,665,False,323,604,195092
00001370.jpg,333,519,151,17,226,151,False,75,134,10050
00001364.jpg,1000,678,384,169,593,334,False,209,165,34485
00001402.jpg,2940,1960,1012,103,1319,336,False,307,233,71531
00001402.jpg,2940,1960,1546,184,1828,402,False,282,218,61476
00002123.jpg,682,1024,167,86,573,780,False,406,694,281764
00000734.jpg,1900,1068,376,63,773,317,False,397,254,100838
00000734.jpg,1900,1068,1341,212,1729,466,False,388,254,98552
00000734.jpg,1900,1068,601,156,989,410,False,388,254,98552
00002645.jpg,325,280,38,69,102,133,False,64,64,4096
00002645.jpg,325,280,173,70,235,132,False,62,62,3844
00002651.jpg,750,500,287,198,447,320,False,160,122,19520
00002651.jpg,750,500,187,169,370,311,False,183,142,25986
00002889.jpg,1024,683,86,1,811,499,False,725,498,361050
00001358.jpg,1300,956,406,84,861,473,False,455,389,176995
00002137.jpg,407,612,122,66,247,280,False,125,214,26750
00000913.jpg,1500,1353,590,53,807,281,False,217,228,49476
00002876.jpg,700,467,309,163,440,265,False,131,102,13362
00002876.jpg,700,467,352,39,449,114,False,97,75,7275
00000091.jpg,400,600,98,79,347,505,False,249,426,106074
00000085.jpg,467,700,147,83,276,308,False,129,225,29025
00002692.jpg,970,646,446,104,911,464,False,465,360,167400
00002692.jpg,970,646,69,64,575,448,False,506,384,194304
00003003.jpg,2000,1333,995,289,1912,1000,False,917,711,651987
00003003.jpg,2000,1333,544,210,1345,832,False,801,622,498222
00003003.jpg,2000,1333,89,197,1001,904,False,912,707,644784
00001600.jpg,1333,2000,322,42,1097,1396,False,775,1354,1049350
00003017.jpg,1300,806,440,113,917,458,False,477,345,164565
00000536.jpg,1232,821,105,288,501,595,False,396,307,121572
00000536.jpg,1232,821,366,221,770,541,False,404,320,129280
00000536.jpg,1232,821,538,160,962,488,False,424,328,139072
00001628.jpg,2000,1333,884,121,1390,514,False,506,393,198858
00000522.jpg,612,408,58,106,250,255,False,192,149,28608
00000522.jpg,612,408,25,32,133,115,False,108,83,8964
00000522.jpg,612,408,305,109,420,196,False,115,87,10005
00000522.jpg,612,408,236,143,394,266,False,158,123,19434
00000522.jpg,612,408,365,22,475,107,False,110,85,9350
00000522.jpg,612,408,423,84,575,201,False,152,117,17784
00002484.jpg,1600,900,514,229,894,473,False,380,244,92720
00001833.jpg,1300,957,406,97,1012,616,False,606,519,314514
00001827.jpg,1500,1120,604,70,924,355,False,320,285,91200
00002490.jpg,572,380,228,44,467,225,False,239,181,43259
00002490.jpg,572,380,111,66,340,243,False,229,177,40533
00001199.jpg,390,280,129,31,289,167,False,160,136,21760
00001826.jpg,1600,1167,622,42,942,313,False,320,271,86720
00001198.jpg,682,1024,307,63,388,205,False,81,142,11502
00002491.jpg,1200,940,558,83,832,327,False,274,244,66856
00002491.jpg,1200,940,302,144,564,378,False,262,234,61308
00002485.jpg,1072,1549,242,259,351,443,False,109,184,20056
00002485.jpg,1072,1549,706,416,811,593,False,105,177,18585
00002485.jpg,1072,1549,510,544,615,721,False,105,177,18585
00001832.jpg,1024,682,174,50,824,543,False,650,493,320450
00000523.jpg,1500,1004,826,377,1062,561,False,236,184,43424
00000523.jpg,1500,1004,1061,385,1277,554,False,216,169,36504
00000523.jpg,1500,1004,457,273,631,412,False,174,139,24186
00000523.jpg,1500,1004,94,327,335,511,False,241,184,44344
00000523.jpg,1500,1004,387,554,628,743,False,241,189,45549
00002334.jpg,736,1104,251,48,408,317,False,157,269,42233
00002452.jpg,660,373,91,92,511,368,False,420,276,115920
00002446.jpg,900,602,499,80,611,167,False,112,87,9744
00001629.jpg,450,319,188,46,269,112,False,81,66,5346
00003016.jpg,1960,1634,1007,326,1525,817,False,518,491,254338
00001601.jpg,800,534,504,107,638,212,False,134,105,14070
00001167.jpg,626,417,277,56,458,196,False,181,140,25340
00001615.jpg,2000,1331,772,95,1503,661,False,731,566,413746
00003002.jpg,1300,957,455,471,751,724,False,296,253,74888
00003002.jpg,1300,957,189,142,491,401,False,302,259,78218
00003002.jpg,1300,957,703,342,1005,601,False,302,259,78218
00003002.jpg,1300,957,253,557,549,806,False,296,249,73704
00003002.jpg,1300,957,457,62,773,333,False,316,271,85636
00002687.jpg,504,330,85,137,176,206,False,91,69,6279
00002687.jpg,504,330,246,144,331,209,False,85,65,5525
00002687.jpg,504,330,183,69,261,128,False,78,59,4602
00002687.jpg,504,330,333,147,417,211,False,84,64,5376
00002687.jpg,504,330,288,77,369,139,False,81,62,5022
00002877.jpg,2500,3745,736,226,1215,1061,False,479,835,399965
00002877.jpg,2500,3745,1022,886,1490,1685,False,468,799,373932
00002863.jpg,1200,1185,811,426,923,555,False,112,129,14448
00001359.jpg,626,417,141,105,293,223,False,152,118,17936
00000047.jpg,1300,891,819,93,1057,283,False,238,190,45220
00000047.jpg,1300,891,641,279,845,443,False,204,164,33456
00002650.jpg,1200,630,484,102,1031,436,False,547,334,182698
00002136.jpg,480,320,89,5,201,90,False,112,85,9520
00002136.jpg,480,320,283,107,399,198,False,116,91,10556
00003228.jpg,960,640,1,1,960,633,False,959,632,606088
00000735.jpg,1098,732,497,187,622,284,False,125,97,12125
00002122.jpg,1400,1130,434,257,636,447,False,202,190,38380
00002122.jpg,1400,1130,637,343,771,469,False,134,126,16884
00001365.jpg,600,419,237,80,360,178,False,123,98,12054
00001403.jpg,700,1050,263,189,419,461,False,156,272,42432
00003200.jpg,495,639,287,182,346,270,False,59,88,5192
00001417.jpg,608,406,138,11,423,232,False,285,221,62985
00001371.jpg,910,1213,154,70,715,941,False,561,871,488631
00002678.jpg,800,533,206,111,452,306,False,246,195,47970
00002678.jpg,800,533,342,90,622,302,False,280,212,59360
00001588.jpg,509,339,196,2,423,182,False,227,180,40860
00002081.jpg,1500,2123,641,146,887,553,False,246,407,100122
00002095.jpg,1500,1120,491,42,1028,508,False,537,466,250242
00000682.jpg,640,860,301,220,413,396,False,112,176,19712
00000682.jpg,640,860,477,387,587,559,False,110,172,18920
00000682.jpg,640,860,285,401,400,580,False,115,179,20585
00000682.jpg,640,860,55,221,192,439,False,137,218,29866
00002903.jpg,3024,4032,1028,409,1504,1149,False,476,740,352240
00000872.jpg,390,280,153,22,246,100,False,93,78,7254
00000866.jpg,2037,1274,819,4,2032,1199,False,1213,1195,1449535
00002042.jpg,1050,700,404,21,628,195,False,224,174,38976
00000899.jpg,1000,667,185,61,641,423,False,456,362,165072
00000641.jpg,1000,667,489,314,660,448,False,171,134,22914
00000641.jpg,1000,667,77,324,241,452,False,164,128,20992
00000641.jpg,1000,667,329,272,501,406,False,172,134,23048
00000641.jpg,1000,667,296,161,438,271,False,142,110,15620
00000641.jpg,1000,667,635,144,742,227,False,107,83,8881
00000641.jpg,1000,667,639,216,800,344,False,161,128,20608
00000641.jpg,1000,667,225,229,346,324,False,121,95,11495
00000641.jpg,1000,667,492,142,636,252,False,144,110,15840
00003348.jpg,612,408,363,176,535,309,False,172,133,22876
00003348.jpg,612,408,104,237,284,377,False,180,140,25200
00003348.jpg,612,408,182,98,391,265,False,209,167,34903
00002730.jpg,1024,681,567,137,795,313,False,228,176,40128
00000127.jpg,458,700,192,325,238,408,False,46,83,3818
00001239.jpg,866,1390,413,293,507,473,False,94,180,16920
00002718.jpg,720,576,354,73,526,236,False,172,163,28036
00003406.jpg,800,800,518,510,671,688,False,153,178,27234
00003406.jpg,800,800,151,68,329,276,False,178,208,37024
00003406.jpg,800,800,544,53,700,236,False,156,183,28548
00003406.jpg,800,800,135,473,295,660,False,160,187,29920
00001577.jpg,735,492,156,24,309,144,False,153,120,18360
00003374.jpg,587,600,139,327,234,437,False,95,110,10450
00003374.jpg,587,600,356,324,446,432,False,90,108,9720
00003374.jpg,587,600,251,290,348,403,False,97,113,10961
00001563.jpg,612,408,270,68,485,235,False,215,167,35905
00001205.jpg,1000,1500,336,232,772,994,False,436,762,332232
00002283.jpg,500,508,167,53,335,247,False,168,194,32592
00000480.jpg,800,600,330,132,592,361,False,262,229,59998
00002297.jpg,441,600,287,58,352,161,False,65,103,6695
00002297.jpg,441,600,91,65,155,166,False,64,101,6464
00001991.jpg,1116,1600,220,1,883,993,False,663,992,657696
00002240.jpg,2000,1333,405,188,933,598,False,528,410,216480
00000331.jpg,667,1000,301,427,382,568,False,81,141,11421
00000325.jpg,1000,667,320,58,590,263,False,270,205,55350
00002254.jpg,427,640,186,67,259,195,False,73,128,9344
00001985.jpg,493,280,179,1,327,94,False,148,93,13764
00003162.jpg,1000,1000,227,225,410,443,False,183,218,39894
00001775.jpg,1000,667,194,14,740,428,False,546,414,226044
00001013.jpg,1162,1700,406,184,727,730,False,321,546,175266
00001007.jpg,683,1024,276,168,393,373,False,117,205,23985
00001761.jpg,800,582,270,75,522,283,False,252,208,52416
00002518.jpg,350,200,21,8,207,132,False,186,124,23064
00001011.jpg,390,280,132,23,269,139,False,137,116,15892
00000469.jpg,735,494,107,217,199,287,False,92,70,6440
00003160.jpg,1280,720,259,28,869,436,False,610,408,248880
00001763.jpg,699,1050,150,1,699,1050,False,549,1049,575901
00000333.jpg,700,467,216,53,477,256,False,261,203,52983
00002524.jpg,700,906,141,27,648,791,False,507,764,387348
00002242.jpg,1600,1143,523,208,1207,777,False,684,569,389196
00002242.jpg,1600,1143,227,344,730,753,False,503,409,205727
00001993.jpg,450,378,217,19,303,103,False,86,84,7224
00000441.jpg,1600,1168,373,4,1191,683,False,818,679,555422
00001987.jpg,1300,1066,286,2,1291,961,False,1005,959,963795
00003148.jpg,390,280,125,25,299,170,False,174,145,25230
00002530.jpg,612,408,241,32,422,171,False,181,139,25159
00001039.jpg,1200,1800,367,118,684,672,False,317,554,175618
00001978.jpg,1104,1300,402,138,531,314,False,129,176,22704
00000496.jpg,682,1023,312,132,445,365,False,133,233,30989
00001788.jpg,509,339,182,38,349,167,False,167,129,21543
00002281.jpg,504,650,183,93,328,307,False,145,214,31030
00002295.jpg,408,612,99,68,308,424,False,209,356,74404
00001944.jpg,1024,683,354,65,901,490,False,547,425,232475
00003362.jpg,424,490,106,94,158,164,False,52,70,3640
00003362.jpg,424,490,275,118,323,183,False,48,65,3120
00003362.jpg,424,490,194,41,251,117,False,57,76,4332
00003362.jpg,424,490,195,264,237,320,False,42,56,2352
00003404.jpg,682,1024,271,73,376,257,False,105,184,19320
00003410.jpg,338,508,156,59,240,205,False,84,146,12264
00000119.jpg,698,1050,270,192,348,325,False,78,133,10374
00001561.jpg,361,254,125,1,321,143,False,196,142,27832
00002068.jpg,2000,1204,715,121,1141,420,False,426,299,127374
00000657.jpg,600,450,407,204,466,255,False,59,51,3009
00000657.jpg,600,450,154,55,212,105,False,58,50,2900
00000657.jpg,600,450,234,158,291,208,False,57,50,2850
00000657.jpg,600,450,131,204,198,261,False,67,57,3819
00000657.jpg,600,450,167,134,223,184,False,56,50,2800
00000657.jpg,600,450,323,200,379,249,False,56,49,2744
00000657.jpg,600,450,237,241,294,292,False,57,51,2907
00000657.jpg,600,450,290,250,347,299,False,57,49,2793
00000657.jpg,600,450,368,267,429,321,False,61,54,3294
00000657.jpg,600,450,471,271,532,326,False,61,55,3355
00000657.jpg,600,450,453,323,510,373,False,57,50,2850
00000657.jpg,600,450,341,342,396,390,False,55,48,2640
00001549.jpg,319,450,134,102,205,221,False,71,119,8449
00002040.jpg,332,519,150,39,215,157,False,65,118,7670
00003438.jpg,800,800,179,429,272,537,False,93,108,10044
00002726.jpg,650,969,507,159,575,276,False,68,117,7956
00002726.jpg,650,969,406,81,476,198,False,70,117,8190
00002726.jpg,650,969,470,277,531,385,False,61,108,6588
00000643.jpg,2121,1414,388,249,1039,755,False,651,506,329406
00000643.jpg,2121,1414,835,208,1561,759,False,726,551,400026
00000643.jpg,2121,1414,1211,407,1986,1008,False,775,601,465775
00000870.jpg,1000,1500,401,331,551,594,False,150,263,39450
00000864.jpg,970,776,155,104,487,407,False,332,303,100596
00000858.jpg,1600,1157,369,183,689,452,False,320,269,86080
00003389.jpg,626,418,79,82,248,213,False,169,131,22139
00003389.jpg,626,418,276,106,435,229,False,159,123,19557
00003216.jpg,600,400,159,86,351,236,False,192,150,28800
00001401.jpg,480,720,209,299,260,389,False,51,90,4590
00001373.jpg,601,900,251,88,321,212,False,70,124,8680
00001415.jpg,850,1280,331,238,603,716,False,272,478,130016
00003202.jpg,1068,1600,243,309,777,1220,False,534,911,486474
00000723.jpg,1240,828,725,239,1020,469,False,295,230,67850
00000723.jpg,1240,828,387,167,700,405,False,313,238,74494
00000723.jpg,1240,828,925,115,1239,386,False,314,271,85094
00000723.jpg,1240,828,238,138,492,331,False,254,193,49022
00002134.jpg,1500,1089,708,77,1179,466,False,471,389,183219
00002652.jpg,632,994,414,129,505,297,False,91,168,15288
00000045.jpg,1600,1167,193,140,654,540,False,461,400,184400
00000051.jpg,700,375,42,14,377,223,False,335,209,70015
00002120.jpg,700,1050,302,367,387,515,False,85,148,12580
00000737.jpg,662,576,147,25,221,99,False,74,74,5476
00000737.jpg,662,576,138,118,220,201,False,82,83,6806
00000737.jpg,662,576,511,137,580,206,False,69,69,4761
00000737.jpg,662,576,537,220,602,286,False,65,66,4290
00000737.jpg,662,576,6,48,75,118,False,69,70,4830
00000737.jpg,662,576,43,106,113,179,False,70,73,5110
00000737.jpg,662,576,277,56,340,121,False,63,65,4095
00000737.jpg,662,576,377,88,438,149,False,61,61,3721
00000737.jpg,662,576,433,98,501,166,False,68,68,4624
00002875.jpg,360,254,128,31,228,112,False,100,81,8100
00000910.jpg,2000,1333,498,250,1588,1096,False,1090,846,922140
00001398.jpg,1300,1062,272,49,1013,737,False,741,688,509808
00000086.jpg,1300,867,446,52,650,211,False,204,159,32436
00002691.jpg,650,650,94,78,575,637,False,481,559,268879
00002685.jpg,823,576,240,117,412,257,False,172,140,24080
00002685.jpg,823,576,444,121,609,256,False,165,135,22275
00001165.jpg,1100,824,127,312,237,407,False,110,95,10450
00001165.jpg,1100,824,516,42,633,145,False,117,103,12051
00001165.jpg,1100,824,313,4,446,124,False,133,120,15960
00001165.jpg,1100,824,651,281,759,375,False,108,94,10152
00001165.jpg,1100,824,862,307,969,401,False,107,94,10058
00001165.jpg,1100,824,394,536,495,624,False,101,88,8888
00001603.jpg,390,280,46,65,126,132,False,80,67,5360
00003000.jpg,600,338,351,1,561,113,False,210,112,23520
00000509.jpg,612,408,273,157,407,258,False,134,101,13534
00000509.jpg,612,408,382,165,518,270,False,136,105,14280
00000509.jpg,612,408,176,200,309,304,False,133,104,13832
00000509.jpg,612,408,36,209,188,327,False,152,118,17936
00000509.jpg,612,408,102,187,235,289,False,133,102,13566
00001617.jpg,390,280,63,63,234,206,False,171,143,24453
00001171.jpg,682,1024,223,253,356,481,False,133,228,30324
00002478.jpg,600,412,45,48,193,167,False,148,119,17612
00002478.jpg,600,412,364,43,512,162,False,148,119,17612
00001159.jpg,1024,682,419,92,771,360,False,352,268,94336
00002336.jpg,250,326,100,42,145,110,False,45,68,3060
00000521.jpg,1184,790,684,112,1145,470,False,461,358,165038
00000521.jpg,1184,790,330,234,744,562,False,414,328,135792
00000521.jpg,1184,790,456,51,756,283,False,300,232,69600
00000521.jpg,1184,790,9,136,461,494,False,452,358,161816
00000521.jpg,1184,790,226,1,539,223,False,313,222,69486
00000535.jpg,1600,1167,1039,108,1481,483,False,442,375,165750
00000535.jpg,1600,1167,192,111,581,441,False,389,330,128370
00000535.jpg,1600,1167,443,278,875,644,False,432,366,158112
00000535.jpg,1600,1167,733,185,1184,560,False,451,375,169125
00000535.jpg,1600,1167,15,340,428,691,False,413,351,144963
00002322.jpg,700,350,1,12,566,345,False,565,333,188145
00002493.jpg,715,536,317,208,483,350,False,166,142,23572
00001824.jpg,600,495,309,31,398,116,False,89,85,7565
00001830.jpg,1000,667,348,64,721,360,False,373,296,110408
00002487.jpg,533,800,187,58,303,261,False,116,203,23548
00002486.jpg,600,400,228,61,356,160,False,128,99,12672
00000285.jpg,867,1300,437,392,599,670,False,162,278,45036
00002492.jpg,362,512,222,89,266,161,False,44,72,3168
00001825.jpg,2000,1334,463,167,1282,802,False,819,635,520065
00001819.jpg,1024,682,365,24,557,172,False,192,148,28416
00002323.jpg,1331,1080,360,203,1085,888,False,725,685,496625
00002445.jpg,385,450,156,105,204,168,False,48,63,3024
00002451.jpg,1800,1200,204,1,1506,884,False,1302,883,1149666
00001158.jpg,533,849,199,1,370,304,False,171,303,51813
00000520.jpg,400,290,299,93,374,156,False,75,63,4725
00000520.jpg,400,290,32,75,137,166,False,105,91,9555
00000520.jpg,400,290,150,81,225,144,False,75,63,4725
00000520.jpg,400,290,102,43,180,109,False,78,66,5148
00000520.jpg,400,290,262,64,323,115,False,61,51,3111
00000520.jpg,400,290,187,44,246,93,False,59,49,2891
00000508.jpg,1500,1000,273,307,622,578,False,349,271,94579
00000508.jpg,1500,1000,975,410,1354,704,False,379,294,111426
00000508.jpg,1500,1000,932,198,1219,421,False,287,223,64001
00000508.jpg,1500,1000,1120,301,1427,529,False,307,228,69996
00000508.jpg,1500,1000,788,356,1109,599,False,321,243,78003
00000508.jpg,1500,1000,485,451,872,745,False,387,294,113778
00000508.jpg,1500,1000,593,247,965,535,False,372,288,107136
00000508.jpg,1500,1000,1,562,359,869,False,358,307,109906
00000508.jpg,1500,1000,258,649,719,1000,False,461,351,161811
00000508.jpg,1500,1000,819,791,1147,1000,False,328,209,68552
00003001.jpg,940,529,376,108,556,224,False,180,116,20880
00001170.jpg,1300,957,431,138,797,452,False,366,314,114924
00001164.jpg,1600,1156,1055,92,1222,236,False,167,144,24048
00001602.jpg,612,408,144,107,400,310,False,256,203,51968
00002684.jpg,1024,682,266,118,510,303,False,244,185,45140
00002684.jpg,1024,682,459,108,713,304,False,254,196,49784
00000939.jpg,960,678,515,37,615,117,False,100,80,8000
00002848.jpg,337,450,132,29,176,97,False,44,68,2992
00000087.jpg,870,580,108,41,359,235,False,251,194,48694
00000087.jpg,870,580,530,52,781,242,False,251,190,47690
00001399.jpg,433,650,84,70,215,293,False,131,223,29213
00002860.jpg,900,675,678,160,770,240,False,92,80,7360
00002860.jpg,900,675,480,56,568,133,False,88,77,6776
00002860.jpg,900,675,79,114,186,208,False,107,94,10058
00002874.jpg,2048,2048,497,583,1158,1352,False,661,769,508309
00002647.jpg,1000,1294,415,321,643,657,False,228,336,76608
00000050.jpg,1065,1300,425,209,593,447,False,168,238,39984
00001428.jpg,590,885,201,89,382,406,False,181,317,57377
00002121.jpg,359,254,74,17,156,84,False,82,67,5494
00002135.jpg,792,1200,521,189,648,409,False,127,220,27940
00002135.jpg,792,1200,155,507,272,713,False,117,206,24102
00000044.jpg,873,580,314,70,626,311,False,312,241,75192
00002653.jpg,1000,1500,434,146,755,706,False,321,560,179760
00001372.jpg,270,420,96,28,129,87,False,33,59,1947
00003203.jpg,612,408,299,240,413,329,False,114,89,10146
00003203.jpg,612,408,147,206,252,287,False,105,81,8505
00003203.jpg,612,408,282,130,378,205,False,96,75,7200
00003203.jpg,612,408,221,52,311,122,False,90,70,6300
00003203.jpg,612,408,111,65,202,135,False,91,70,6370
00003203.jpg,612,408,190,140,298,223,False,108,83,8964
00001400.jpg,2000,1333,540,178,1026,555,False,486,377,183222
00003217.jpg,1024,683,341,240,569,417,False,228,177,40356
00003217.jpg,1024,683,464,4,723,200,False,259,196,50764
00001366.jpg,800,568,269,90,499,276,False,230,186,42780
00002928.jpg,1200,630,824,319,1097,486,False,273,167,45591
00002096.jpg,600,420,221,37,377,163,False,156,126,19656
00000681.jpg,650,433,387,100,509,194,False,122,94,11468
00000681.jpg,650,433,256,122,352,196,False,96,74,7104
00000681.jpg,650,433,133,67,231,143,False,98,76,7448
00000681.jpg,650,433,229,62,325,137,False,96,75,7200
00000859.jpg,891,980,185,125,458,475,False,273,350,95550
00002914.jpg,1070,580,611,109,849,260,False,238,151,35938
00000642.jpg,1200,800,235,170,465,349,False,230,179,41170
00000642.jpg,1200,800,377,104,602,279,False,225,175,39375
00000642.jpg,1200,800,402,287,813,599,False,411,312,128232
00000642.jpg,1200,800,775,363,1188,683,False,413,320,132160
00000642.jpg,1200,800,610,239,816,399,False,206,160,32960
00000642.jpg,1200,800,769,204,1014,390,False,245,186,45570
00000642.jpg,1200,800,100,356,367,563,False,267,207,55269
00001548.jpg,3896,5999,1675,1118,2582,2743,False,907,1625,1473875
00000656.jpg,700,525,149,243,298,373,False,149,130,19370
00000656.jpg,700,525,223,67,343,172,False,120,105,12600
00000656.jpg,700,525,340,135,445,227,False,105,92,9660
00000656.jpg,700,525,502,63,608,155,False,106,92,9752
00000656.jpg,700,525,2,105,217,349,False,215,244,52460
00002727.jpg,868,1300,496,356,592,525,False,96,169,16224
00002727.jpg,868,1300,248,371,338,529,False,90,158,14220
00003439.jpg,612,409,241,60,417,194,False,176,134,23584
00000118.jpg,951,1000,321,127,547,398,False,226,271,61246
00003377.jpg,390,280,56,18,139,88,False,83,70,5810
00003377.jpg,390,280,203,38,285,106,False,82,68,5576
00003377.jpg,390,280,135,82,212,145,False,77,63,4851
00002069.jpg,1500,1203,1,47,683,728,False,682,681,464442
00001560.jpg,1470,980,563,194,905,460,False,342,266,90972
00003405.jpg,360,239,162,24,241,84,False,79,60,4740
00003405.jpg,360,239,112,73,193,134,False,81,61,4941
00003405.jpg,360,239,73,92,142,145,False,69,53,3657
00001212.jpg,612,423,269,44,391,145,False,122,101,12322
00002294.jpg,1050,1400,188,73,699,866,False,511,793,405223
00002280.jpg,1000,750,593,62,846,283,False,253,221,55913
00001789.jpg,1000,667,1,1,676,348,False,675,347,234225
00001951.jpg,500,333,198,122,317,214,False,119,92,10948
00001979.jpg,612,424,195,57,383,209,False,188,152,28576
00001986.jpg,800,582,176,21,673,442,False,497,421,209237
00001038.jpg,721,720,277,11,476,242,False,199,231,45969
00002525.jpg,1200,800,99,46,839,621,False,740,575,425500
00002243.jpg,750,500,166,28,298,130,False,132,102,13464
00001762.jpg,722,1390,322,179,435,434,False,113,255,28815
00003175.jpg,1000,1500,631,372,744,566,False,113,194,21922
00001010.jpg,1120,1680,345,441,784,1191,False,439,750,329250
00003161.jpg,508,340,125,77,253,178,False,128,101,12928
00001776.jpg,591,519,259,26,352,122,False,93,96,8928
00003159.jpg,960,641,339,106,809,479,False,470,373,175310
00002247.jpg,640,357,563,108,639,201,False,76,93,7068
00001996.jpg,1500,1101,607,108,882,343,False,275,235,64625
00001028.jpg,1000,667,295,123,704,440,False,409,317,129653
00002521.jpg,1024,683,350,81,633,301,False,283,220,62260
00002535.jpg,960,720,459,66,708,282,False,249,216,53784
00000322.jpg,800,582,315,66,522,241,False,207,175,36225
00001982.jpg,626,417,311,12,473,137,False,162,125,20250
00001772.jpg,1335,2000,553,143,832,629,False,279,486,135594
00003165.jpg,262,280,75,197,119,250,False,44,53,2332
00003165.jpg,262,280,209,199,251,251,False,42,52,2184
00003165.jpg,262,280,15,5,52,50,False,37,45,1665
00003165.jpg,262,280,143,3,184,54,False,41,51,2091
00003165.jpg,262,280,140,136,180,186,False,40,50,2000
00003165.jpg,262,280,15,200,51,245,False,36,45,1620
00003165.jpg,262,280,77,7,115,54,False,38,47,1786
00003165.jpg,262,280,12,134,49,180,False,37,46,1702
00003165.jpg,262,280,16,74,51,118,False,35,44,1540
00003165.jpg,262,280,213,71,246,113,False,33,42,1386
00003165.jpg,262,280,82,135,116,177,False,34,42,1428
00001014.jpg,1200,1800,278,80,691,786,False,413,706,291578
00002509.jpg,390,480,151,60,216,154,False,65,94,6110
00003171.jpg,682,1023,415,360,532,565,False,117,205,23985
00001766.jpg,1600,1157,676,19,945,246,False,269,227,61063
00001766.jpg,1600,1157,968,1,1255,230,False,287,229,65723
00000478.jpg,1023,819,437,135,788,462,False,351,327,114777
00001955.jpg,640,797,98,48,396,480,False,298,432,128736
00001955.jpg,640,797,338,235,568,568,False,230,333,76590
00001941.jpg,861,1300,311,43,576,508,False,265,465,123225
00001799.jpg,333,519,43,88,217,396,False,174,308,53592
00001969.jpg,667,1024,259,91,443,412,False,184,321,59064
00002723.jpg,1000,1500,231,175,641,874,False,410,699,286590
00000652.jpg,920,634,482,66,593,155,False,111,89,9879
00000652.jpg,920,634,177,68,292,158,False,115,90,10350
00000652.jpg,920,634,402,128,487,195,False,85,67,5695
00002045.jpg,1500,1000,1191,257,1497,559,False,306,302,92412
00002045.jpg,1500,1000,231,51,398,183,False,167,132,22044
00002045.jpg,1500,1000,105,133,265,257,False,160,124,19840
00002045.jpg,1500,1000,500,97,663,224,False,163,127,20701
00002045.jpg,1500,1000,490,394,680,542,False,190,148,28120
00002045.jpg,1500,1000,317,358,477,482,False,160,124,19840
00002051.jpg,345,520,149,66,207,167,False,58,101,5858
00001558.jpg,500,333,285,16,404,108,False,119,92,10948
00000120.jpg,736,1104,344,234,448,420,False,104,186,19344
00003429.jpg,300,450,67,16,129,124,False,62,108,6696
00003429.jpg,300,450,146,15,203,116,False,57,101,5757
00002737.jpg,1800,1200,1461,536,1727,742,False,266,206,54796
00002737.jpg,1800,1200,488,491,693,650,False,205,159,32595
00002737.jpg,1800,1200,671,333,881,495,False,210,162,34020
00001216.jpg,236,354,101,3,158,97,False,57,94,5358
00001570.jpg,590,393,298,100,370,156,False,72,56,4032
00001564.jpg,866,1390,327,83,599,580,False,272,497,135184
00002938.jpg,550,309,21,29,278,205,False,257,176,45232
00002938.jpg,550,309,251,1,424,110,False,173,109,18857
00002938.jpg,550,309,239,89,381,182,False,142,93,13206
00002938.jpg,550,309,412,40,548,215,False,136,175,23800
00002086.jpg,300,450,46,21,171,240,False,125,219,27375
00000849.jpg,636,1024,296,36,375,184,False,79,148,11692
00002092.jpg,626,418,374,35,540,163,False,166,128,21248
00002904.jpg,2048,1365,965,371,1402,710,False,437,339,148143
00000875.jpg,800,582,513,153,711,321,False,198,168,33264
00002910.jpg,480,320,120,195,191,250,False,71,55,3905
00002910.jpg,480,320,187,116,277,185,False,90,69,6210
00002910.jpg,480,320,268,160,338,214,False,70,54,3780
00002910.jpg,480,320,200,37,260,83,False,60,46,2760
00002657.jpg,236,354,93,45,169,177,False,76,132,10032
00001438.jpg,640,960,132,127,291,403,False,159,276,43884
00000726.jpg,1300,956,533,39,811,271,False,278,232,64496
00000726.jpg,1300,956,229,315,545,586,False,316,271,85636
00000726.jpg,1300,956,483,309,779,563,False,296,254,75184
00000726.jpg,1300,956,618,512,927,771,False,309,259,80031
00000726.jpg,1300,956,750,329,1086,617,False,336,288,96768
00000726.jpg,1300,956,728,166,924,334,False,196,168,32928
00002131.jpg,684,1024,189,121,488,641,False,299,520,155480
00002125.jpg,1000,666,245,1,682,325,False,437,324,141588
00002643.jpg,681,1024,295,211,434,454,False,139,243,33777
00003213.jpg,626,417,299,47,439,155,False,140,108,15120
00001404.jpg,600,900,213,88,284,212,False,71,124,8804
00001410.jpg,1000,1250,385,437,589,734,False,204,297,60588
00002119.jpg,1500,1120,530,1,1001,402,False,471,401,188871
00000068.jpg,1177,1175,521,67,668,233,False,147,166,24402
00000068.jpg,1177,1175,964,46,1104,206,False,140,160,22400
00000068.jpg,1177,1175,491,494,669,700,False,178,206,36668
00001376.jpg,400,620,107,126,191,276,False,84,150,12600
00002858.jpg,525,315,168,31,423,209,False,255,178,45390
00002680.jpg,2500,1831,409,519,919,954,False,510,435,221850
00001389.jpg,736,863,242,41,600,530,False,358,489,175062
00000097.jpg,4256,2832,2214,752,2962,1331,False,748,579,433092
00000901.jpg,866,1390,553,251,638,409,False,85,158,13430
00000524.jpg,970,714,553,108,774,297,False,221,189,41769
00000524.jpg,970,714,210,274,381,420,False,171,146,24966
00000524.jpg,970,714,403,270,573,416,False,170,146,24820
00002441.jpg,4256,2832,779,484,1769,1235,False,990,751,743490
00001148.jpg,1331,2000,476,613,754,1099,False,278,486,135108
00000256.jpg,1300,956,342,160,538,328,False,196,168,32928
00000256.jpg,1300,956,708,84,936,279,False,228,195,44460
00000530.jpg,1300,866,534,342,752,512,False,218,170,37060
00000530.jpg,1300,866,332,313,556,486,False,224,173,38752
00000530.jpg,1300,866,777,130,1037,327,False,260,197,51220
00000530.jpg,1300,866,655,283,899,468,False,244,185,45140
00003039.jpg,509,339,302,28,497,183,False,195,155,30225
00003039.jpg,509,339,257,43,427,175,False,170,132,22440
00000518.jpg,400,211,87,93,198,159,False,111,66,7326
00001606.jpg,867,1300,379,155,478,327,False,99,172,17028
00001821.jpg,1024,683,238,18,707,383,False,469,365,171185
00002496.jpg,956,1280,423,374,521,527,False,98,153,14994
00000281.jpg,2832,4256,1236,1109,1867,2213,False,631,1104,696624
00002482.jpg,1000,774,577,258,704,372,False,127,114,14478
00002482.jpg,1000,774,791,353,900,452,False,109,99,10791
00001835.jpg,590,393,33,84,196,211,False,163,127,20701
00001809.jpg,800,533,107,41,593,418,False,486,377,183222
00001808.jpg,590,393,255,4,590,342,False,335,338,113230
00002483.jpg,750,500,174,55,315,162,False,141,107,15087
00001834.jpg,683,1024,228,95,310,236,False,82,141,11562
00001820.jpg,1300,950,481,24,899,378,False,418,354,147972
00000280.jpg,1000,667,132,155,390,351,False,258,196,50568
00000280.jpg,1000,667,655,144,950,372,False,295,228,67260
00000280.jpg,1000,667,88,416,396,654,False,308,238,73304
00000280.jpg,1000,667,443,116,725,335,False,282,219,61758
00000280.jpg,1000,667,1,198,227,437,False,226,239,54014
00002497.jpg,400,264,205,34,358,152,False,153,118,18054
00001175.jpg,600,420,225,34,391,169,False,166,135,22410
00001613.jpg,736,736,259,123,434,327,False,175,204,35700
00003004.jpg,800,800,214,261,430,512,False,216,251,54216
00003010.jpg,382,287,16,1,381,286,False,365,285,104025
00001607.jpg,2410,3679,1142,1140,1393,1587,False,251,447,112197
00000519.jpg,1000,667,220,57,579,336,False,359,279,100161
00000519.jpg,1000,667,357,112,724,397,False,367,285,104595
00000519.jpg,1000,667,750,109,1000,377,False,250,268,67000
00000519.jpg,1000,667,4,71,318,408,False,314,337,105818
00001161.jpg,332,519,61,3,242,325,False,181,322,58282
00002468.jpg,980,654,75,23,645,457,False,570,434,247380
00001149.jpg,1257,1300,524,171,731,421,False,207,250,51750
00002440.jpg,338,450,240,107,277,165,False,37,58,2146
00002440.jpg,338,450,159,130,193,181,False,34,51,1734
00003038.jpg,612,407,324,72,470,187,False,146,115,16790
00003038.jpg,612,407,33,86,182,201,False,149,115,17135
00002326.jpg,474,640,133,99,289,343,False,156,244,38064
00000525.jpg,612,416,33,122,175,233,False,142,111,15762
00000525.jpg,612,416,417,126,545,227,False,128,101,12928
00000525.jpg,612,416,264,93,374,179,False,110,86,9460
00002454.jpg,500,750,186,63,316,288,False,130,225,29250
00000243.jpg,870,580,384,62,624,249,False,240,187,44880
00002871.jpg,858,1390,226,247,325,435,False,99,188,18612
00002871.jpg,858,1390,475,612,582,813,False,107,201,21507
00000900.jpg,590,393,247,47,365,138,False,118,91,10738
00000928.jpg,333,519,131,76,193,189,False,62,113,7006
00001388.jpg,800,630,167,72,459,334,False,292,262,76504
00002681.jpg,236,354,139,76,174,137,False,35,61,2135
00000082.jpg,1150,1680,454,516,758,1033,False,304,517,157168
00002118.jpg,1200,799,134,128,817,658,False,683,530,361990
00003206.jpg,600,400,212,94,299,162,False,87,68,5916
00003206.jpg,600,400,310,87,401,156,False,91,69,6279
00003206.jpg,600,400,408,104,497,172,False,89,68,6052
00001411.jpg,612,329,267,79,483,213,False,216,134,28944
00001377.jpg,683,1024,253,27,405,293,False,152,266,40432
00000069.jpg,1000,1500,399,909,515,1112,False,116,203,23548
00001363.jpg,1024,768,427,58,607,215,False,180,157,28260
00001363.jpg,1024,768,730,182,854,290,False,124,108,13392
00001363.jpg,1024,768,221,193,332,290,False,111,97,10767
00001405.jpg,318,450,122,134,170,213,False,48,79,3792
00003212.jpg,800,800,259,278,518,579,False,259,301,77959
00002124.jpg,1300,956,563,69,1228,638,False,665,569,378385
00000055.jpg,750,1050,343,1,451,160,False,108,159,17172
00000041.jpg,1024,683,244,20,768,426,False,524,406,212744
00002130.jpg,2000,1334,774,195,1350,642,False,576,447,257472
00001439.jpg,333,519,129,103,185,204,False,56,101,5656
00000860.jpg,1500,1120,644,54,880,259,False,236,205,48380
00002911.jpg,1600,1167,183,90,1069,842,False,886,752,666272
00000874.jpg,866,1300,294,1,467,284,False,173,283,48959
00000684.jpg,1030,580,312,20,622,228,False,310,208,64480
00002939.jpg,566,850,262,153,330,271,False,68,118,8024
00000848.jpg,1500,1000,509,122,897,423,False,388,301,116788
00002087.jpg,1300,956,225,32,1106,770,False,881,738,650178
00003399.jpg,390,280,142,61,243,145,False,101,84,8484
00003372.jpg,408,612,151,266,203,356,False,52,90,4680
00001203.jpg,333,519,158,68,223,187,False,65,119,7735
00001571.jpg,2693,3914,880,606,1507,1666,False,627,1060,664620
00002736.jpg,640,467,154,61,288,175,False,134,114,15276
00002736.jpg,640,467,355,150,463,243,False,108,93,10044
00002736.jpg,640,467,168,174,296,283,False,128,109,13952
00002736.jpg,640,467,233,37,332,121,False,99,84,8316
00002736.jpg,640,467,402,110,478,176,False,76,66,5016
00002736.jpg,640,467,269,114,374,203,False,105,89,9345
00002736.jpg,640,467,495,143,576,212,False,81,69,5589
00003428.jpg,1000,1000,295,288,475,497,False,180,209,37620
00000135.jpg,3689,5515,1669,1285,2226,2254,False,557,969,539733
00000135.jpg,3689,5515,1022,1365,1533,2253,False,511,888,453768
00002722.jpg,1024,682,298,1,881,428,False,583,427,248941
00002044.jpg,1300,957,846,98,1015,242,False,169,144,24336
00000653.jpg,1040,694,451,113,678,289,False,227,176,39952
00000653.jpg,1040,694,147,41,467,289,False,320,248,79360
00000653.jpg,1040,694,661,167,865,325,False,204,158,32232
00001968.jpg,2000,1333,854,259,1183,514,False,329,255,83895
00001798.jpg,860,1300,315,132,424,324,False,109,192,20928
00000486.jpg,402,604,157,67,209,159,False,52,92,4784
00001940.jpg,626,417,220,39,421,194,False,201,155,31155
00000492.jpg,1001,1500,383,124,606,513,False,223,389,86747
00001954.jpg,1473,980,729,107,1348,586,False,619,479,296501
00002508.jpg,236,346,59,25,124,136,False,65,111,7215
00001001.jpg,800,582,301,57,487,215,False,186,158,29388
00000479.jpg,565,321,485,164,565,223,False,80,59,4720
00001767.jpg,612,408,124,12,480,289,False,356,277,98612
00001773.jpg,683,1024,216,213,472,661,False,256,448,114688
00001015.jpg,333,519,142,36,204,151,False,62,115,7130
00000323.jpg,866,1390,367,225,507,485,False,140,260,36400
00000445.jpg,973,648,123,199,317,350,False,194,151,29294
00000445.jpg,973,648,564,278,821,478,False,257,200,51400
00000445.jpg,973,648,615,93,866,288,False,251,195,48945
00000445.jpg,973,648,261,119,507,314,False,246,195,47970
00001983.jpg,1000,667,496,90,803,328,False,307,238,73066
00001997.jpg,400,309,158,1,357,171,False,199,170,33830
00002246.jpg,590,394,143,1,430,216,False,287,215,61705
00000337.jpg,600,420,431,104,493,155,False,62,51,3162
00001981.jpg,1068,1700,381,177,676,711,False,295,534,157530
00000447.jpg,390,280,159,58,230,118,False,71,60,4260
00000447.jpg,390,280,302,66,352,109,False,50,43,2150
00002536.jpg,612,459,204,18,496,273,False,292,255,74460
00000321.jpg,640,800,223,122,302,235,False,79,113,8927
00000321.jpg,640,800,390,139,462,243,False,72,104,7488
00000321.jpg,640,800,142,212,208,307,False,66,95,6270
00000321.jpg,640,800,323,230,388,323,False,65,93,6045
00002244.jpg,400,600,152,67,316,352,False,164,285,46740
00000453.jpg,1000,667,481,133,592,217,False,111,84,9324
00000453.jpg,1000,667,214,9,378,135,False,164,126,20664
00000453.jpg,1000,667,309,140,467,262,False,158,122,19276
00000453.jpg,1000,667,618,158,750,261,False,132,103,13596
00003172.jpg,262,280,75,197,119,250,False,44,53,2332
00003172.jpg,262,280,209,199,251,251,False,42,52,2184
00003172.jpg,262,280,15,5,52,50,False,37,45,1665
00003172.jpg,262,280,143,3,184,54,False,41,51,2091
00003172.jpg,262,280,140,136,180,186,False,40,50,2000
00003172.jpg,262,280,15,200,51,245,False,36,45,1620
00003172.jpg,262,280,77,7,115,54,False,38,47,1786
00003172.jpg,262,280,12,134,49,180,False,37,46,1702
00003172.jpg,262,280,16,74,51,118,False,35,44,1540
00003172.jpg,262,280,213,71,246,113,False,33,42,1386
00003172.jpg,262,280,82,135,116,177,False,34,42,1428
00001003.jpg,500,333,148,63,327,202,False,179,139,24881
00000309.jpg,1000,667,293,18,770,387,False,477,369,176013
00001017.jpg,800,533,399,54,559,178,False,160,124,19840
00001771.jpg,1000,667,133,63,755,545,False,622,482,299804
00003166.jpg,1300,956,531,79,1087,555,False,556,476,264656
00002293.jpg,1335,2000,638,413,843,772,False,205,359,73595
00001942.jpg,400,280,204,34,324,130,False,120,96,11520
00001956.jpg,1300,956,394,109,1000,628,False,606,519,314514
00002287.jpg,433,650,120,36,336,412,False,216,376,81216
00000123.jpg,681,1024,268,139,350,281,False,82,142,11644
00002052.jpg,1300,956,480,125,871,453,False,391,328,128248
00000645.jpg,590,393,299,109,422,202,False,123,93,11439
00000645.jpg,590,393,400,118,508,200,False,108,82,8856
00000645.jpg,590,393,349,65,442,137,False,93,72,6696
00000645.jpg,590,393,200,82,329,182,False,129,100,12900
00000645.jpg,590,393,466,76,559,148,False,93,72,6696
00000889.jpg,612,408,215,66,435,237,False,220,171,37620
00002046.jpg,1500,1120,490,96,904,455,False,414,359,148626
00003358.jpg,800,533,235,173,406,305,False,171,132,22572
00003358.jpg,800,533,517,262,632,352,False,115,90,10350
00003358.jpg,800,533,410,190,519,275,False,109,85,9265
00000137.jpg,600,900,217,23,325,207,False,108,184,19872
00003416.jpg,236,346,83,11,118,70,False,35,59,2065
00003416.jpg,236,346,100,102,130,152,False,30,50,1500
00002708.jpg,2000,1228,60,115,469,407,False,409,292,119428
00002708.jpg,2000,1228,441,94,958,463,False,517,369,190773
00002708.jpg,2000,1228,798,202,1295,550,False,497,348,172956
00002708.jpg,2000,1228,1422,220,1998,669,False,576,449,258624
00000679.jpg,1024,683,652,223,817,351,False,165,128,21120
00000679.jpg,1024,683,342,189,543,345,False,201,156,31356
00000679.jpg,1024,683,200,135,362,260,False,162,125,20250
00000679.jpg,1024,683,256,200,418,325,False,162,125,20250
00000679.jpg,1024,683,756,156,904,273,False,148,117,17316
00000679.jpg,1024,683,460,128,590,227,False,130,99,12870
00001567.jpg,406,608,167,36,266,207,False,99,171,16929
00003370.jpg,500,700,196,85,273,211,False,77,126,9702
00003364.jpg,736,917,378,92,501,267,False,123,175,21525
00001215.jpg,1001,1600,437,143,548,350,False,111,207,22977
00003402.jpg,236,354,81,45,149,163,False,68,118,8024
00002085.jpg,600,900,271,61,344,186,False,73,125,9125
00000876.jpg,1500,1178,639,97,1018,444,False,379,347,131513
00002640.jpg,612,408,264,68,531,276,False,267,208,55536
00002898.jpg,600,401,1,3,501,393,False,500,390,195000
00003238.jpg,612,413,72,89,322,282,False,250,193,48250
00002132.jpg,1600,1167,553,46,942,383,False,389,337,131093
00002654.jpg,900,600,339,105,898,539,False,559,434,242606
00001413.jpg,1300,1021,498,90,842,404,False,344,314,108016
00001407.jpg,1023,759,255,31,569,302,False,314,271,85094
00000719.jpg,626,417,153,20,272,113,False,119,93,11067
00000719.jpg,626,417,65,89,208,197,False,143,108,15444
00000719.jpg,626,417,304,32,460,150,False,156,118,18408
00000719.jpg,626,417,408,32,554,142,False,146,110,16060
00000719.jpg,626,417,205,72,374,203,False,169,131,22139
00000719.jpg,626,417,135,118,297,244,False,162,126,20412
00002683.jpg,792,1024,484,194,599,366,False,115,172,19780
00002683.jpg,792,1024,330,192,450,368,False,120,176,21120
00000094.jpg,1024,682,402,26,685,245,False,283,219,61977
00002867.jpg,1920,1080,816,171,1146,387,False,330,216,71280
00000916.jpg,681,1024,323,20,404,159,False,81,139,11259
00000902.jpg,600,400,329,144,477,259,False,148,115,17020
00000533.jpg,1500,1101,880,271,1312,640,False,432,369,159408
00000533.jpg,1500,1101,1170,73,1417,284,False,247,211,52117
00000533.jpg,1500,1101,487,291,750,511,False,263,220,57860
00000533.jpg,1500,1101,331,63,583,279,False,252,216,54432
00000533.jpg,1500,1101,544,383,893,682,False,349,299,104351
00000533.jpg,1500,1101,92,198,471,530,False,379,332,125828
00000533.jpg,1500,1101,691,226,933,432,False,242,206,49852
00000255.jpg,401,343,239,67,392,219,False,153,152,23256
00000255.jpg,401,343,112,77,279,243,False,167,166,27722
00002456.jpg,629,472,104,229,174,288,False,70,59,4130
00000527.jpg,1300,1002,252,202,470,398,False,218,196,42728
00000527.jpg,1300,1002,646,331,860,523,False,214,192,41088
00000527.jpg,1300,1002,465,367,670,551,False,205,184,37720
00000527.jpg,1300,1002,156,388,384,593,False,228,205,46740
00000527.jpg,1300,1002,800,312,1010,500,False,210,188,39480
00001639.jpg,682,1024,338,73,501,356,False,163,283,46129
00002318.jpg,1728,1075,519,81,681,198,False,162,117,18954
00002318.jpg,1728,1075,1134,234,1311,361,False,177,127,22479
00003006.jpg,800,800,193,103,350,285,False,157,182,28574
00003006.jpg,800,800,173,529,336,720,False,163,191,31133
00001611.jpg,1024,683,433,33,682,226,False,249,193,48057
00001177.jpg,667,1000,400,66,512,262,False,112,196,21952
00001163.jpg,1600,1167,428,29,1142,649,False,714,620,442680
00001605.jpg,2940,1960,1030,144,1672,641,False,642,497,319074
00003012.jpg,510,340,56,50,409,318,False,353,268,94604
00001836.jpg,1500,1120,448,66,861,425,False,413,359,148267
00000296.jpg,682,1023,285,186,407,395,False,122,209,25498
00001188.jpg,333,519,117,24,189,156,False,72,132,9504
00002481.jpg,700,467,157,90,359,247,False,202,157,31714
00002495.jpg,1024,682,126,80,478,353,False,352,273,96096
00000282.jpg,434,650,196,133,303,321,False,107,188,20116
00001822.jpg,318,450,115,25,176,123,False,61,98,5978
00000283.jpg,1272,1960,485,280,607,498,False,122,218,26596
00001823.jpg,683,1023,243,117,382,361,False,139,244,33916
00001837.jpg,867,1390,316,189,517,566,False,201,377,75777
00001162.jpg,1000,569,381,77,614,231,False,233,154,35882
00001176.jpg,1800,1800,940,292,1200,594,False,260,302,78520
00000240.jpg,400,267,37,2,228,150,False,191,148,28268
00000240.jpg,400,267,177,56,356,195,False,179,139,24881
00000240.jpg,400,267,125,99,259,201,False,134,102,13668
00002325.jpg,1500,1101,617,108,1049,477,False,432,369,159408
00000532.jpg,1000,667,97,169,320,342,False,223,173,38579
00000532.jpg,1000,667,547,50,739,195,False,192,145,27840
00000532.jpg,1000,667,301,130,469,260,False,168,130,21840
00000532.jpg,1000,667,355,171,619,371,False,264,200,52800
00000254.jpg,864,1296,330,233,461,460,False,131,227,29737
00000903.jpg,2936,1960,1061,464,1803,1041,False,742,577,428134
00002872.jpg,510,340,31,65,382,331,False,351,266,93366
00002866.jpg,800,600,427,71,630,251,False,203,180,36540
00002866.jpg,800,600,559,12,800,231,False,241,219,52779
00002866.jpg,800,600,510,427,603,508,False,93,81,7533
00002866.jpg,800,600,615,467,695,537,False,80,70,5600
00000917.jpg,2000,1375,820,306,1171,587,False,351,281,98631
00002696.jpg,866,1300,279,156,539,621,False,260,465,120900
00000095.jpg,612,408,159,1,457,220,False,298,219,65262
00002682.jpg,600,401,47,56,271,230,False,224,174,38976
00002682.jpg,600,401,313,139,501,285,False,188,146,27448
00000718.jpg,1280,1280,951,459,1152,699,False,201,240,48240
00000718.jpg,1280,1280,316,367,522,607,False,206,240,49440
00000718.jpg,1280,1280,8,444,218,690,False,210,246,51660
00000718.jpg,1280,1280,521,394,756,667,False,235,273,64155
00000718.jpg,1280,1280,9,764,271,1068,False,262,304,79648
00000718.jpg,1280,1280,1097,627,1280,952,False,183,325,59475
00000718.jpg,1280,1280,737,297,939,532,False,202,235,47470
00001406.jpg,768,768,126,120,603,675,False,477,555,264735
00002669.jpg,612,408,263,68,482,238,False,219,170,37230
00002669.jpg,612,408,158,136,350,282,False,192,146,28032
00002669.jpg,612,408,2,3,186,180,False,184,177,32568
00002669.jpg,612,408,473,47,606,224,False,133,177,23541
00002669.jpg,612,408,27,121,215,267,False,188,146,27448
00001360.jpg,2000,1333,756,102,1262,503,False,506,401,202906
00001374.jpg,863,1300,248,208,436,538,False,188,330,62040
00002133.jpg,800,533,334,57,512,195,False,178,138,24564
00000724.jpg,696,440,333,64,445,146,False,112,82,9184
00000724.jpg,696,440,225,71,340,155,False,115,84,9660
00002655.jpg,1600,1155,382,162,657,393,False,275,231,63525
00002655.jpg,1600,1155,736,230,1011,461,False,275,231,63525
00002655.jpg,1600,1155,1079,120,1360,361,False,281,241,67721
00002655.jpg,1600,1155,934,135,1191,346,False,257,211,54227
00002655.jpg,1600,1155,176,226,457,457,False,281,231,64911
00002899.jpg,800,800,159,137,357,367,False,198,230,45540
00002641.jpg,736,1104,246,201,482,613,False,236,412,97232
00001348.jpg,1600,1167,961,67,1132,212,False,171,145,24795
00002127.jpg,2048,1367,826,114,1254,439,False,428,325,139100
00002127.jpg,2048,1367,1230,445,1559,696,False,329,251,82579
00000877.jpg,400,245,108,18,304,157,False,196,139,27244
00002912.jpg,894,894,158,264,357,501,False,199,237,47163
00002084.jpg,600,420,232,11,368,122,False,136,111,15096
00002090.jpg,867,1300,368,65,475,253,False,107,188,20116
00001599.jpg,333,519,109,46,203,216,False,94,170,15980
00003365.jpg,800,800,311,27,440,177,False,129,150,19350
00003365.jpg,800,800,407,544,525,679,False,118,135,15930
00001566.jpg,1024,1024,525,114,883,532,False,358,418,149644
00000678.jpg,960,539,234,124,462,273,False,228,149,33972
00000136.jpg,1600,1168,603,81,1272,650,False,669,569,380661
00001228.jpg,390,280,208,12,339,121,False,131,109,14279
00002735.jpg,400,600,154,65,229,196,False,75,131,9825
00000644.jpg,612,408,209,114,455,301,False,246,187,46002
00000644.jpg,612,408,43,137,253,296,False,210,159,33390
00000644.jpg,612,408,384,161,599,328,False,215,167,35905
00002053.jpg,1024,683,680,132,885,291,False,205,159,32595
00003198.jpg,626,418,303,172,420,263,False,117,91,10647
00003198.jpg,626,418,75,149,190,236,False,115,87,10005
00003198.jpg,626,418,232,26,339,108,False,107,82,8774
00003198.jpg,626,418,118,60,228,145,False,110,85,9350
00003198.jpg,626,418,443,149,558,236,False,115,87,10005
00002286.jpg,800,600,216,40,672,438,False,456,398,181488
00001957.jpg,1600,1167,321,72,1139,766,False,818,694,567692
00000485.jpg,576,768,333,156,393,249,False,60,93,5580
00001943.jpg,1200,773,77,65,317,244,False,240,179,42960
00001943.jpg,1200,773,260,137,505,321,False,245,184,45080
00001943.jpg,1200,773,510,59,749,239,False,239,180,43020
00001943.jpg,1200,773,670,150,926,338,False,256,188,48128
00001943.jpg,1200,773,813,158,1098,372,False,285,214,60990
00001016.jpg,683,1023,288,34,376,188,False,88,154,13552
00000308.jpg,620,348,262,29,381,107,False,119,78,9282
00002279.jpg,1200,1800,334,335,687,938,False,353,603,212859
00003167.jpg,2000,1333,1487,244,1776,469,False,289,225,65025
00003167.jpg,2000,1333,1115,313,1353,498,False,238,185,44030
00003167.jpg,2000,1333,514,453,791,668,False,277,215,59555
00001770.jpg,800,533,190,30,769,489,False,579,459,265761
00001764.jpg,1300,1142,367,61,1124,835,False,757,774,585918
00003173.jpg,612,408,313,45,509,198,False,196,153,29988
00000452.jpg,2939,1960,632,90,1535,791,False,903,701,633003
00001994.jpg,300,470,36,7,266,408,False,230,401,92230
00002245.jpg,512,512,155,1,382,164,False,227,163,37001
00001980.jpg,1024,769,506,329,702,501,False,196,172,33712
00001980.jpg,1024,769,132,413,312,570,False,180,157,28260
00001758.jpg,718,1024,308,46,390,182,False,82,136,11152
00001703.jpg,2770,1960,984,80,1562,557,False,578,477,275706
00001065.jpg,590,393,177,67,268,138,False,91,71,6461
00001065.jpg,590,393,284,59,390,141,False,106,82,8692
00001071.jpg,450,382,237,43,392,196,False,155,153,23715
00002578.jpg,960,641,482,138,662,278,False,180,140,25200
00003100.jpg,1080,814,36,67,939,809,False,903,742,670026
00001717.jpg,2000,1281,571,84,1449,739,False,878,655,575090
00000409.jpg,4000,6000,1339,1376,2121,2743,False,782,1367,1068994
00003128.jpg,1000,1000,321,239,609,574,False,288,335,96480
00002236.jpg,1280,853,363,79,902,496,False,539,417,224763
00002236.jpg,1280,853,598,261,1142,683,False,544,422,229568
00001059.jpg,857,1024,248,84,383,272,False,135,188,25380
00002550.jpg,445,600,120,136,166,209,False,46,73,3358
00002544.jpg,660,424,206,1,437,174,False,231,173,39963
00000353.jpg,700,466,263,81,376,168,False,113,87,9831
00001918.jpg,800,533,282,41,534,236,False,252,195,49140
00001924.jpg,360,254,89,14,273,165,False,184,151,27784
00002593.jpg,467,700,161,266,255,428,False,94,162,15228
00002587.jpg,210,280,85,26,132,99,False,47,73,3431
00001930.jpg,682,1023,195,1,384,123,False,189,122,23058
00001267.jpg,500,749,198,174,298,344,False,100,170,17000
00000179.jpg,1500,2250,704,409,854,671,False,150,262,39300
00003470.jpg,236,157,54,46,140,112,False,86,66,5676
00002008.jpg,2936,1960,1168,278,1755,735,False,587,457,268259
00001501.jpg,1200,1800,473,208,616,457,False,143,249,35607
00001515.jpg,1300,867,389,171,780,468,False,391,297,116127
00003302.jpg,1600,1600,567,278,947,712,False,380,434,164920
00003464.jpg,236,330,76,108,128,194,False,52,86,4472
00001273.jpg,417,626,104,70,241,309,False,137,239,32743
00000145.jpg,866,1390,353,101,526,418,False,173,317,54841
00000623.jpg,2000,1333,1121,416,1697,863,False,576,447,257472
00000623.jpg,2000,1333,1015,213,1441,544,False,426,331,141006
00000623.jpg,2000,1333,202,409,887,941,False,685,532,364420
00000623.jpg,2000,1333,748,467,1300,904,False,552,437,241224
00000623.jpg,2000,1333,1496,111,1905,428,False,409,317,129653
00002034.jpg,510,340,115,124,214,202,False,99,78,7722
00002034.jpg,510,340,242,14,393,131,False,151,117,17667
00002034.jpg,510,340,164,63,317,182,False,153,119,18207
00002020.jpg,800,533,556,103,685,203,False,129,100,12900
00002020.jpg,800,533,336,51,483,164,False,147,113,16611
00002020.jpg,800,533,103,109,226,206,False,123,97,11931
00000637.jpg,1300,956,691,106,1027,393,False,336,287,96432
00000637.jpg,1300,956,440,303,907,712,False,467,409,191003
00000637.jpg,1300,956,563,79,829,301,False,266,222,59052
00000637.jpg,1300,956,348,141,602,359,False,254,218,55372
00000637.jpg,1300,956,908,12,1157,220,False,249,208,51792
00000637.jpg,1300,956,5,125,364,482,False,359,357,128163
00001529.jpg,683,1024,214,103,410,439,False,196,336,65856
00000151.jpg,1024,681,328,215,678,487,False,350,272,95200
00003458.jpg,236,268,109,14,158,79,False,49,65,3185
00003458.jpg,236,268,74,54,115,108,False,41,54,2214
00003458.jpg,236,268,104,100,142,150,False,38,50,1900
00002975.jpg,612,408,240,60,538,291,False,298,231,68838
00002949.jpg,288,360,109,74,176,170,False,67,96,6432
00000838.jpg,799,1024,123,45,588,723,False,465,678,315270
00001313.jpg,682,1024,230,69,475,488,False,245,419,102655
00003504.jpg,236,354,52,96,99,179,False,47,83,3901
00003262.jpg,681,1024,284,81,439,347,False,155,266,41230
00001475.jpg,800,532,305,43,556,238,False,251,195,48945
00001461.jpg,512,512,345,20,459,152,False,114,132,15048
00001461.jpg,512,512,266,72,371,196,False,105,124,13020
00001461.jpg,512,512,107,247,193,347,False,86,100,8600
00003276.jpg,681,1024,284,81,439,347,False,155,266,41230
00002168.jpg,1000,792,271,18,439,173,False,168,155,26040
00002168.jpg,1000,792,627,39,788,187,False,161,148,23828
00002168.jpg,1000,792,493,250,617,362,False,124,112,13888
00003510.jpg,236,318,85,13,133,89,False,48,76,3648
00003510.jpg,236,318,77,91,116,150,False,39,59,2301
00001307.jpg,1000,667,403,47,691,266,False,288,219,63072
00002626.jpg,612,408,203,103,421,273,False,218,170,37060
00000031.jpg,434,650,170,328,222,418,False,52,90,4680
00000757.jpg,800,582,258,148,479,335,False,221,187,41327
00002140.jpg,1001,1600,363,235,521,523,False,158,288,45504
00002154.jpg,1300,861,699,186,840,296,False,141,110,15510
00002801.jpg,819,1024,367,186,608,537,False,241,351,84591
00002801.jpg,819,1024,1,1,149,139,False,148,138,20424
00002801.jpg,819,1024,280,3,517,222,False,237,219,51903
00000970.jpg,1024,688,415,1,924,399,False,509,398,202582
00002815.jpg,900,600,369,155,527,278,False,158,123,19434
00002183.jpg,900,642,374,61,705,335,False,331,274,90694
00002183.jpg,900,642,615,233,820,403,False,205,170,34850
00000794.jpg,512,512,97,1,500,430,False,403,429,172887
00000958.jpg,600,400,248,90,337,159,False,89,69,6141
00002197.jpg,800,534,296,78,390,150,False,94,72,6768
00003289.jpg,461,713,127,200,186,306,False,59,106,6254
00002829.jpg,960,642,396,130,773,429,False,377,299,112723
00000569.jpg,590,394,78,79,252,211,False,174,132,22968
00000569.jpg,590,394,440,62,512,118,False,72,56,4032
00000569.jpg,590,394,381,125,452,181,False,71,56,3976
00000569.jpg,590,394,246,77,330,143,False,84,66,5544
00002418.jpg,1023,682,243,64,557,307,False,314,243,76302
00001105.jpg,1024,682,433,64,956,470,False,523,406,212338
00003074.jpg,1600,1154,350,280,540,436,False,190,156,29640
00001663.jpg,866,1300,339,230,509,532,False,170,302,51340
00001893.jpg,875,1390,385,99,712,690,False,327,591,193257
00000233.jpg,1300,1300,549,628,787,906,False,238,278,66164
00002430.jpg,728,546,145,41,443,301,False,298,260,77480
00001139.jpg,700,1050,305,58,507,410,False,202,352,71104
00002356.jpg,359,320,66,41,104,80,False,38,39,1482
00003048.jpg,2000,1333,242,318,1065,956,False,823,638,525074
00003048.jpg,2000,1333,1093,339,1778,870,False,685,531,363735
00001878.jpg,600,332,105,15,208,83,False,103,68,7004
00001688.jpg,408,612,222,25,286,135,False,64,110,7040
00001850.jpg,596,900,272,182,334,291,False,62,109,6758
00001844.jpg,1600,1165,519,78,806,321,False,287,243,69741
00001844.jpg,1600,1165,898,103,1140,308,False,242,205,49610
00000582.jpg,1200,675,314,366,599,553,False,285,187,53295
00000583.jpg,2716,1810,1877,511,2365,889,False,488,378,184464
00000583.jpg,2716,1810,774,120,1379,590,False,605,470,284350
00001845.jpg,1500,1120,608,64,943,354,False,335,290,97150
00002380.jpg,746,431,76,31,222,129,False,146,98,14308
00002380.jpg,746,431,256,47,393,139,False,137,92,12604
00002380.jpg,746,431,473,101,585,177,False,112,76,8512
00000597.jpg,1440,810,607,241,778,353,False,171,112,19152
00001851.jpg,1300,867,241,68,785,490,False,544,422,229568
00001689.jpg,1500,1000,529,160,810,383,False,281,223,62663
00001689.jpg,1500,1000,946,97,1246,325,False,300,228,68400
00001879.jpg,509,339,141,28,395,225,False,254,197,50038
00000226.jpg,1000,1500,336,559,458,771,False,122,212,25864
00001138.jpg,332,519,61,3,242,325,False,181,322,58282
00003049.jpg,600,901,221,187,355,420,False,134,233,31222
00003049.jpg,600,901,374,103,529,374,False,155,271,42005
00002357.jpg,536,600,178,148,336,353,False,158,205,32390
00000540.jpg,612,408,245,138,378,241,False,133,103,13699
00000540.jpg,612,408,9,61,174,186,False,165,125,20625
00000540.jpg,612,408,317,46,424,128,False,107,82,8774
00000540.jpg,612,408,215,46,352,154,False,137,108,14796
00000540.jpg,612,408,355,90,489,194,False,134,104,13936
00000540.jpg,612,408,466,1,612,91,False,146,90,13140
00000540.jpg,612,408,146,43,245,118,False,99,75,7425
00001886.jpg,612,612,204,22,392,241,False,188,219,41172
00001892.jpg,866,1300,494,32,679,348,False,185,316,58460
00002343.jpg,1000,1001,451,666,563,796,False,112,130,14560
00002343.jpg,1000,1001,775,41,889,174,False,114,133,15162
00002343.jpg,1000,1001,432,121,556,265,False,124,144,17856
00001104.jpg,700,1050,86,1,604,738,False,518,737,381766
00003061.jpg,1651,2190,616,416,826,740,False,210,324,68040
00001676.jpg,736,1492,125,132,406,794,False,281,662,186022
00002419.jpg,660,440,283,206,421,313,False,138,107,14766
00003288.jpg,272,340,137,85,167,129,False,30,44,1320
00000959.jpg,1125,1500,248,174,904,1169,False,656,995,652720
00002828.jpg,600,338,139,57,453,263,False,314,206,64684
00000965.jpg,1334,2000,520,325,977,1105,False,457,780,356460
00002814.jpg,1024,682,418,152,628,311,False,210,159,33390
00002814.jpg,1024,682,585,190,809,363,False,224,173,38752
00002814.jpg,1024,682,256,164,465,326,False,209,162,33858
00002800.jpg,1500,1000,106,38,609,428,False,503,390,196170
00002800.jpg,1500,1000,896,22,1435,441,False,539,419,225841
00002800.jpg,1500,1000,414,276,794,570,False,380,294,111720
00002800.jpg,1500,1000,3,335,435,685,False,432,350,151200
00002633.jpg,750,501,189,106,268,167,False,79,61,4819
00002633.jpg,750,501,274,81,372,155,False,98,74,7252
00002633.jpg,750,501,376,76,473,151,False,97,75,7275
00002633.jpg,750,501,402,170,489,238,False,87,68,5916
00000024.jpg,829,580,167,36,257,109,False,90,73,6570
00000024.jpg,829,580,573,38,664,111,False,91,73,6643
00002141.jpg,174,238,82,44,117,101,False,35,57,1995
00001448.jpg,1600,1168,661,228,1074,580,False,413,352,145376
00002169.jpg,721,900,253,266,439,536,False,186,270,50220
00003277.jpg,626,417,98,90,425,344,False,327,254,83058
00001460.jpg,670,450,218,10,475,210,False,257,200,51400
00001306.jpg,600,419,153,36,382,226,False,229,190,43510
00000018.jpg,800,534,131,30,628,408,False,497,378,187866
00003505.jpg,235,157,110,5,172,53,False,62,48,2976
00003505.jpg,235,157,30,49,75,84,False,45,35,1575
00003505.jpg,235,157,75,14,131,57,False,56,43,2408
00001312.jpg,1001,1600,424,366,683,837,False,259,471,121989
00001474.jpg,1098,732,23,350,237,517,False,214,167,35738
00001474.jpg,1098,732,834,371,1044,534,False,210,163,34230
00001474.jpg,1098,732,728,336,901,467,False,173,131,22663
00001474.jpg,1098,732,198,134,368,266,False,170,132,22440
00001474.jpg,1098,732,126,33,284,156,False,158,123,19434
00001474.jpg,1098,732,831,77,990,200,False,159,123,19557
00001474.jpg,1098,732,934,171,1089,294,False,155,123,19065
00001474.jpg,1098,732,157,509,407,703,False,250,194,48500
00003263.jpg,800,533,388,71,526,178,False,138,107,14766
00000193.jpg,1000,667,477,76,715,260,False,238,184,43792
00002784.jpg,2000,1000,609,164,1372,618,False,763,454,346402
00002784.jpg,2000,1000,25,179,740,595,False,715,416,297440
00002784.jpg,2000,1000,1260,153,2000,619,False,740,466,344840
00001299.jpg,500,750,211,76,368,350,False,157,274,43018
00000839.jpg,1600,1122,966,127,1247,356,False,281,229,64349
00000811.jpg,1500,1600,726,130,1139,633,False,413,503,207739
00002960.jpg,1200,900,734,202,940,382,False,206,180,37080
00002974.jpg,1024,683,169,104,361,253,False,192,149,28608
00002974.jpg,1024,683,313,60,513,216,False,200,156,31200
00002974.jpg,1024,683,421,131,654,312,False,233,181,42173
00002974.jpg,1024,683,649,211,872,385,False,223,174,38802
00002974.jpg,1024,683,558,30,781,200,False,223,170,37910
00002974.jpg,1024,683,106,289,335,466,False,229,177,40533
00002974.jpg,1024,683,763,277,1016,478,False,253,201,50853
00002974.jpg,1024,683,399,374,664,580,False,265,206,54590
00000805.jpg,450,319,196,40,299,125,False,103,85,8755
00001528.jpg,450,318,206,93,298,168,False,92,75,6900
00002021.jpg,493,280,243,21,335,82,False,92,61,5612
00003459.jpg,236,322,89,27,119,73,False,30,46,1380
00000150.jpg,1600,1127,512,82,1060,531,False,548,449,246052
00002753.jpg,550,366,107,59,252,169,False,145,110,15950
00002753.jpg,550,366,268,105,417,220,False,149,115,17135
00002753.jpg,550,366,180,77,308,176,False,128,99,12672
00002035.jpg,1500,1120,519,79,971,471,False,452,392,177184
00003303.jpg,626,352,462,41,572,113,False,110,72,7920
00003303.jpg,626,352,300,84,446,177,False,146,93,13578
00003303.jpg,626,352,427,106,563,195,False,136,89,12104
00003303.jpg,626,352,220,60,340,137,False,120,77,9240
00001514.jpg,626,417,142,36,491,306,False,349,270,94230
00001272.jpg,380,280,127,37,304,189,False,177,152,26904
00003465.jpg,235,385,87,146,150,267,False,63,121,7623
00003471.jpg,236,352,60,191,111,279,False,51,88,4488
00003471.jpg,236,352,51,69,119,187,False,68,118,8024
00000178.jpg,650,434,266,106,434,233,False,168,127,21336
00001266.jpg,612,419,146,39,465,293,False,319,254,81026
00003317.jpg,390,280,290,30,348,79,False,58,49,2842
00003317.jpg,390,280,195,12,251,59,False,56,47,2632
00003317.jpg,390,280,150,48,197,86,False,47,38,1786
00003317.jpg,390,280,59,146,113,191,False,54,45,2430
00002009.jpg,512,512,190,1,331,117,False,141,116,16356
00001931.jpg,1334,2000,560,174,709,434,False,149,260,38740
00001925.jpg,1335,2000,559,153,826,619,False,267,466,124422
00002592.jpg,467,700,201,94,290,246,False,89,152,13528
00002545.jpg,400,600,171,46,214,122,False,43,76,3268
00002223.jpg,744,1116,217,205,566,801,False,349,596,208004
00002237.jpg,768,1122,342,100,517,397,False,175,297,51975
00002579.jpg,600,285,253,48,411,135,False,158,87,13746
00002579.jpg,600,285,223,21,372,103,False,149,82,12218
00000408.jpg,1000,1500,297,2,784,815,False,487,813,395931
00003115.jpg,681,1024,289,157,465,465,False,176,308,54208
00001702.jpg,866,1390,304,76,409,273,False,105,197,20685
00003103.jpg,1200,628,80,46,538,324,False,458,278,127324
00003103.jpg,1200,628,829,222,1026,342,False,197,120,23640
00001072.jpg,1000,667,265,82,566,316,False,301,234,70434
00001066.jpg,1068,1700,382,203,574,551,False,192,348,66816
00003117.jpg,800,534,330,153,456,249,False,126,96,12096
00002209.jpg,698,1050,200,93,548,688,False,348,595,207060
00000436.jpg,4461,6680,1810,2047,2340,2991,False,530,944,500320
00002547.jpg,1300,1051,651,324,1198,838,False,547,514,281158
00002553.jpg,2560,1440,199,1,2203,1280,False,2004,1279,2563116
00000422.jpg,900,601,393,241,562,369,False,169,128,21632
00001933.jpg,1500,1101,595,67,974,399,False,379,332,125828
00002584.jpg,1280,720,561,96,885,312,False,324,216,69984
00002584.jpg,1280,720,655,112,979,324,False,324,212,68688
00001099.jpg,612,408,1,1,511,404,False,510,403,205530
00000387.jpg,1280,720,295,1,1280,718,False,985,717,706245
00003467.jpg,236,157,44,29,112,83,False,68,54,3672
00003467.jpg,236,157,117,29,187,84,False,70,55,3850
00001270.jpg,1300,956,506,25,994,434,False,488,409,199592
00003301.jpg,800,800,213,32,357,196,False,144,164,23616
00001264.jpg,866,1300,322,628,528,988,False,206,360,74160
00003473.jpg,236,354,61,99,111,187,False,50,88,4400
00003473.jpg,236,354,126,15,163,79,False,37,64,2368
00002745.jpg,1024,683,142,223,431,447,False,289,224,64736
00002745.jpg,1024,683,588,152,877,376,False,289,224,64736
00002745.jpg,1024,683,379,187,674,411,False,295,224,66080
00002023.jpg,1600,2000,927,554,1247,1030,False,320,476,152320
00002037.jpg,612,408,81,25,265,168,False,184,143,26312
00002989.jpg,1707,2560,669,652,1130,1457,False,461,805,371105
00002751.jpg,1000,666,479,175,598,267,False,119,92,10948
00000146.jpg,870,580,488,44,704,208,False,216,164,35424
00002962.jpg,2048,1365,718,567,1295,1006,False,577,439,253303
00000813.jpg,2613,1960,6,1,1528,1547,False,1522,1546,2353012
00000807.jpg,1800,1202,816,199,1192,491,False,376,292,109792
00002976.jpg,2048,2048,324,687,691,1115,False,367,428,157076
00002976.jpg,2048,2048,1595,7,1963,399,False,368,392,144256
00002786.jpg,768,512,188,63,607,388,False,419,325,136175
00003498.jpg,235,353,56,84,154,255,False,98,171,16758
00000191.jpg,400,259,162,27,280,115,False,118,88,10384
00000191.jpg,400,259,43,46,158,133,False,115,87,10005
00000191.jpg,400,259,268,40,367,114,False,99,74,7326
00003513.jpg,236,157,59,31,145,97,False,86,66,5676
00003275.jpg,236,353,83,82,126,155,False,43,73,3139
00003261.jpg,612,408,286,57,495,220,False,209,163,34067
00001476.jpg,408,612,159,101,245,250,False,86,149,12814
00000768.jpg,866,1390,261,56,371,261,False,110,205,22550
00002619.jpg,1024,683,780,114,980,269,False,200,155,31000
00002619.jpg,1024,683,567,44,781,210,False,214,166,35524
00002619.jpg,1024,683,464,96,629,227,False,165,131,21615
00003507.jpg,236,236,38,58,108,137,False,70,79,5530
00000026.jpg,1600,1158,258,300,783,742,False,525,442,232050
00000026.jpg,1600,1158,693,241,1256,715,False,563,474,266862
00002631.jpg,2000,1333,874,252,1274,562,False,400,310,124000
00003249.jpg,426,640,126,189,194,307,False,68,118,8024
00003249.jpg,426,640,259,116,331,239,False,72,123,8856
00002157.jpg,400,453,52,19,223,244,False,171,225,38475
00000754.jpg,768,1024,307,174,514,495,False,207,321,66447
00002143.jpg,612,408,255,38,495,224,False,240,186,44640
00002625.jpg,384,640,153,91,211,204,False,58,113,6554
00002625.jpg,384,640,175,33,217,115,False,42,82,3444
00000032.jpg,1600,1157,555,63,1447,830,False,892,767,684164
00002816.jpg,700,467,356,53,590,236,False,234,183,42822
00000973.jpg,1600,1168,530,99,1066,555,False,536,456,244416
00002802.jpg,1024,576,223,129,432,266,False,209,137,28633
00002802.jpg,1024,576,586,19,814,168,False,228,149,33972
00002802.jpg,1024,576,828,1,1024,125,False,196,124,24304
00002802.jpg,1024,576,412,57,631,197,False,219,140,30660
00002802.jpg,1024,576,12,210,199,333,False,187,123,23001
00000783.jpg,957,1300,380,199,499,387,False,119,188,22372
00002180.jpg,1300,971,586,225,782,392,False,196,167,32732
00003077.jpg,332,519,53,121,88,184,False,35,63,2205
00003077.jpg,332,519,220,101,254,163,False,34,62,2108
00003077.jpg,332,519,93,171,130,238,False,37,67,2479
00001660.jpg,400,600,164,42,246,185,False,82,143,11726
00001106.jpg,1800,1202,553,396,856,632,False,303,236,71508
00001112.jpg,590,394,280,30,421,139,False,141,109,15369
00001674.jpg,1300,956,486,81,764,319,False,278,238,66164
00001884.jpg,434,600,98,3,335,375,False,237,372,88164
00000542.jpg,1067,1700,249,688,492,1138,False,243,450,109350
00002433.jpg,2000,2000,1138,294,1392,583,False,254,289,73406
00000230.jpg,600,400,258,90,456,244,False,198,154,30492
00002341.jpg,1000,624,387,316,571,446,False,184,130,23920
00001890.jpg,800,597,311,39,455,164,False,144,125,18000
00000556.jpg,2937,1960,796,302,1899,1158,False,1103,856,944168
00000556.jpg,2937,1960,2154,245,2937,1068,False,783,823,644409
00000556.jpg,2937,1960,1470,17,2392,733,False,922,716,660152
00000556.jpg,2937,1960,9,627,855,1619,False,846,992,839232
00000556.jpg,2937,1960,1161,371,2363,1285,False,1202,914,1098628
00001648.jpg,1500,1101,739,240,1081,538,False,342,298,101916
00001847.jpg,683,1024,299,179,417,384,False,118,205,24190
00001853.jpg,318,420,159,65,221,160,False,62,95,5890
00001853.jpg,318,420,81,128,130,204,False,49,76,3724
00001852.jpg,1000,563,7,1,1000,561,False,993,560,556080
00000580.jpg,2937,1960,1438,67,2401,832,False,963,765,736695
00000580.jpg,2937,1960,720,499,2003,1496,False,1283,997,1279151
00000580.jpg,2937,1960,628,45,1404,661,False,776,616,478016
00000580.jpg,2937,1960,4,253,1010,1162,False,1006,909,914454
00000580.jpg,2937,1960,2046,9,2937,1096,False,891,1087,968517
00001846.jpg,600,439,191,39,306,137,False,115,98,11270
00000231.jpg,1024,683,194,7,791,460,False,597,453,270441
00002354.jpg,640,467,220,85,317,167,False,97,82,7954
00000543.jpg,1620,1080,588,184,1193,653,False,605,469,283745
00000543.jpg,1620,1080,105,304,552,659,False,447,355,158685
00001885.jpg,1300,904,621,108,1038,446,False,417,338,140946
00001113.jpg,626,418,236,2,626,152,False,390,150,58500
00003062.jpg,1400,1050,575,281,805,478,False,230,197,45310
00001675.jpg,1600,1168,883,93,1247,410,False,364,317,115388
00001661.jpg,600,387,213,153,423,307,False,210,154,32340
00003076.jpg,1916,2405,300,65,1544,1882,False,1244,1817,2260348
00000219.jpg,681,1023,253,107,324,228,False,71,121,8591
00001107.jpg,533,849,231,68,297,191,False,66,123,8118
00001488.jpg,1300,866,147,1,1300,856,False,1153,855,985815
00000796.jpg,1068,1700,548,114,740,469,False,192,355,68160
00002181.jpg,470,627,197,55,289,198,False,92,143,13156
00002195.jpg,584,860,269,131,361,292,False,92,161,14812
00000972.jpg,612,408,92,82,231,190,False,139,108,15012
00002803.jpg,868,1300,358,128,528,424,False,170,296,50320
00002817.jpg,1500,1000,598,45,835,228,False,237,183,43371
00002817.jpg,1500,1000,750,32,992,215,False,242,183,44286
00002817.jpg,1500,1000,474,180,691,348,False,217,168,36456
00002817.jpg,1500,1000,892,243,1083,391,False,191,148,28268
00000966.jpg,1300,986,294,217,1085,914,False,791,697,551327
00002142.jpg,1200,675,705,100,911,235,False,206,135,27810
00002142.jpg,1200,675,149,4,459,207,False,310,203,62930
00002142.jpg,1200,675,433,26,695,197,False,262,171,44802
00000755.jpg,800,533,253,42,539,264,False,286,222,63492
00002624.jpg,612,408,151,98,263,183,False,112,85,9520
00001339.jpg,600,419,218,21,331,111,False,113,90,10170
00000741.jpg,1600,1157,304,107,579,339,False,275,232,63800
00000741.jpg,1600,1157,998,39,1267,270,False,269,231,62139
00000741.jpg,1600,1157,871,137,1118,345,False,247,208,51376
00000741.jpg,1600,1157,534,202,781,410,False,247,208,51376
00000741.jpg,1600,1157,720,228,978,450,False,258,222,57276
00000999.jpg,590,884,266,84,337,209,False,71,125,8875
00002156.jpg,692,1050,162,164,478,722,False,316,558,176328
00003248.jpg,1300,956,574,119,798,310,False,224,191,42784
00003248.jpg,1300,956,388,201,606,388,False,218,187,40766
00001477.jpg,4000,6000,1247,517,2503,2710,False,1256,2193,2754408
00003260.jpg,480,720,259,216,330,340,False,71,124,8804
00002618.jpg,510,340,218,44,389,177,False,171,133,22743
00001311.jpg,736,942,143,80,544,678,False,401,598,239798
00001305.jpg,1300,866,273,146,501,324,False,228,178,40584
00001305.jpg,1300,866,475,223,699,397,False,224,174,38976
00001305.jpg,1300,866,574,84,802,265,False,228,181,41268
00001463.jpg,2000,1334,678,47,1363,579,False,685,532,364420
00002787.jpg,720,810,232,159,411,392,False,179,233,41707
00002787.jpg,720,810,360,60,586,350,False,226,290,65540
00002963.jpg,1800,900,1430,54,1800,315,False,370,261,96570
00002963.jpg,1800,900,1060,77,1507,327,False,447,250,111750
00002963.jpg,1800,900,13,61,458,320,False,445,259,115255
00002963.jpg,1800,900,714,498,1169,763,False,455,265,120575
00002963.jpg,1800,900,705,78,1151,337,False,446,259,115514
00002963.jpg,1800,900,1106,507,1552,767,False,446,260,115960
00000812.jpg,1156,1600,394,218,606,560,False,212,342,72504
00000621.jpg,1600,1156,790,259,1083,506,False,293,247,72371
00000621.jpg,1600,1156,832,62,979,186,False,147,124,18228
00000621.jpg,1600,1156,511,193,681,336,False,170,143,24310
00000621.jpg,1600,1156,611,303,786,450,False,175,147,25725
00001259.jpg,1500,1101,811,99,1359,567,False,548,468,256464
00002988.jpg,321,254,126,75,209,151,False,83,76,6308
00002744.jpg,681,1024,308,131,435,354,False,127,223,28321
00000153.jpg,1500,844,1034,77,1327,269,False,293,192,56256
00000153.jpg,1500,844,155,56,442,248,False,287,192,55104
00002022.jpg,1440,810,463,48,978,393,False,515,345,177675
00003314.jpg,1335,2000,769,297,1197,1044,False,428,747,319716
00003472.jpg,236,140,27,1,169,99,False,142,98,13916
00003472.jpg,236,140,91,1,235,105,False,144,104,14976
00001271.jpg,667,1000,305,170,373,289,False,68,119,8092
00003300.jpg,236,280,109,17,141,62,False,32,45,1440
00001517.jpg,462,280,80,1,445,183,False,365,182,66430
00000609.jpg,390,280,246,28,328,96,False,82,68,5576
00000609.jpg,390,280,188,73,266,138,False,78,65,5070
00000609.jpg,390,280,128,122,219,196,False,91,74,6734
00000609.jpg,390,280,213,159,293,225,False,80,66,5280
00000609.jpg,390,280,108,21,187,88,False,79,67,5293
00000609.jpg,390,280,53,104,131,169,False,78,65,5070
00000609.jpg,390,280,267,132,366,214,False,99,82,8118
00000609.jpg,390,280,195,12,265,71,False,70,59,4130
00000609.jpg,390,280,82,144,160,209,False,78,65,5070
00000386.jpg,650,434,151,103,290,210,False,139,107,14873
00001926.jpg,1600,1156,180,7,1241,919,False,1061,912,967632
00000423.jpg,1001,1620,284,50,643,728,False,359,678,243402
00002220.jpg,364,480,53,38,316,442,False,263,404,106252
00000351.jpg,1300,956,529,104,929,446,False,400,342,136800
00001067.jpg,500,333,160,27,389,208,False,229,181,41449
00000379.jpg,467,700,238,18,297,121,False,59,103,6077
00003116.jpg,1280,854,433,277,673,459,False,240,182,43680
00001701.jpg,433,650,172,116,267,281,False,95,165,15675
00003102.jpg,612,408,299,240,413,329,False,114,89,10146
00003102.jpg,612,408,147,206,252,287,False,105,81,8505
00003102.jpg,612,408,282,130,378,205,False,96,75,7200
00003102.jpg,612,408,221,52,311,122,False,90,70,6300
00003102.jpg,612,408,111,65,202,135,False,91,70,6370
00003102.jpg,612,408,190,140,298,223,False,108,83,8964
00001073.jpg,333,519,135,12,227,178,False,92,166,15272
00002542.jpg,1500,1000,123,5,1016,668,False,893,663,592059
00002224.jpg,1000,777,647,150,733,227,False,86,77,6622
00002230.jpg,640,881,130,135,292,400,False,162,265,42930
00002230.jpg,640,881,326,204,438,384,False,112,180,20160
00001739.jpg,1000,667,337,66,689,339,False,352,273,96096
00000427.jpg,2316,2557,1620,834,2316,1853,False,696,1019,709224
00000427.jpg,2316,2557,159,346,840,1222,False,681,876,596556
00002556.jpg,5472,3648,1585,1720,3886,3505,False,2301,1785,4107285
00002218.jpg,3734,4800,2096,478,2795,1525,False,699,1047,731853
00001705.jpg,1280,720,831,89,1056,237,False,225,148,33300
00001705.jpg,1280,720,159,63,490,280,False,331,217,71827
00003112.jpg,390,280,160,1,338,104,False,178,103,18334
00001063.jpg,1500,1389,15,1,1032,883,False,1017,882,896994
00001088.jpg,1800,1202,699,331,983,552,False,284,221,62764
00000396.jpg,600,400,148,61,377,242,False,229,181,41449
00002581.jpg,1365,2048,552,134,897,750,False,345,616,212520
00001922.jpg,1000,667,383,39,587,198,False,204,159,32436
00002595.jpg,858,572,396,140,618,312,False,222,172,38184
00002026.jpg,683,1023,291,117,380,271,False,89,154,13706
00001249.jpg,236,297,50,5,151,153,False,101,148,14948
00002740.jpg,1024,683,340,192,449,277,False,109,85,9265
00000143.jpg,736,919,218,121,444,449,False,226,328,74128
00000625.jpg,450,321,209,86,265,132,False,56,46,2576
00000625.jpg,450,321,255,104,308,149,False,53,45,2385
00002032.jpg,700,1050,282,76,405,291,False,123,215,26445
00003304.jpg,1023,683,58,123,271,285,False,213,162,34506
00003304.jpg,1023,683,759,58,987,231,False,228,173,39444
00001275.jpg,1242,1530,349,192,567,505,False,218,313,68234
00003476.jpg,236,157,85,25,138,67,False,53,42,2226
00002768.jpg,920,460,1,56,501,403,False,500,347,173500
00003310.jpg,612,408,256,65,453,217,False,197,152,29944
00000619.jpg,1024,683,157,257,416,458,False,259,201,52059
00000619.jpg,1024,683,255,122,435,261,False,180,139,25020
00000619.jpg,1024,683,363,230,559,383,False,196,153,29988
00001507.jpg,640,963,229,35,421,372,False,192,337,64704
00002783.jpg,454,340,49,54,243,223,False,194,169,32786
00000194.jpg,866,1390,366,265,518,549,False,152,284,43168
00000180.jpg,1000,624,340,35,750,332,False,410,297,121770
00002797.jpg,1000,667,206,43,306,121,False,100,78,7800
00003489.jpg,222,288,117,46,152,99,False,35,53,1855
00000816.jpg,299,450,1,5,112,327,False,111,322,35742
00000802.jpg,682,1024,253,85,329,218,False,76,133,10108
00002152.jpg,1280,861,589,300,766,439,False,177,139,24603
00000023.jpg,1000,1500,375,285,562,612,False,187,327,61149
00002634.jpg,333,519,52,117,116,232,False,64,115,7360
00002634.jpg,333,519,126,163,191,281,False,65,118,7670
00002634.jpg,333,519,194,121,255,232,False,61,111,6771
00002620.jpg,1600,1167,771,117,1369,624,False,598,507,303186
00002620.jpg,1600,1167,262,6,900,502,False,638,496,316448
00001329.jpg,600,420,139,1,276,56,False,137,55,7535
00000989.jpg,1000,667,422,102,868,448,False,446,346,154316
00000751.jpg,733,1023,294,76,431,299,False,137,223,30551
00003258.jpg,626,417,143,48,257,137,False,114,89,10146
00003258.jpg,626,417,385,60,513,157,False,128,97,12416
00003258.jpg,626,417,241,179,372,281,False,131,102,13362
00002146.jpg,397,600,159,70,233,199,False,74,129,9546
00000779.jpg,1600,1168,315,155,672,465,False,357,310,110670
00002608.jpg,2000,1333,1121,404,1548,728,False,427,324,138348
00002608.jpg,2000,1333,752,223,1111,501,False,359,278,99802
00002608.jpg,2000,1333,914,590,1258,857,False,344,267,91848
00001301.jpg,385,280,55,38,168,134,False,113,96,10848
00001315.jpg,689,900,156,6,470,484,False,314,478,150092
00003502.jpg,200,150,1,1,200,149,False,199,148,29452
00003264.jpg,1001,1001,373,17,626,305,False,253,288,72864
00001473.jpg,736,736,181,91,547,517,False,366,426,155916
00000786.jpg,1024,683,27,1,650,452,False,623,451,280973
00002191.jpg,400,285,74,24,158,92,False,84,68,5712
00002191.jpg,400,285,316,62,390,124,False,74,62,4588
00000792.jpg,1000,1000,262,33,728,575,False,466,542,252572
00000962.jpg,700,525,82,10,557,424,False,475,414,196650
00002807.jpg,600,369,275,45,452,172,False,177,127,22479
00002807.jpg,600,369,399,40,579,166,False,180,126,22680
00000976.jpg,1202,1800,332,499,572,927,False,240,428,102720
00002436.jpg,925,1200,231,70,683,753,False,452,683,308716
00000547.jpg,1001,1600,30,327,222,692,False,192,365,70080
00000547.jpg,1001,1600,233,416,380,691,False,147,275,40425
00000547.jpg,1001,1600,449,494,653,875,False,204,381,77724
00001881.jpg,900,556,192,27,740,429,False,548,402,220296
00001659.jpg,1280,720,1,1,1280,712,False,1279,711,909369
00002350.jpg,750,440,333,50,454,133,False,121,83,10043
00000553.jpg,800,582,202,40,418,223,False,216,183,39528
00000553.jpg,800,582,350,80,571,263,False,221,183,40443
00000553.jpg,800,582,442,71,658,254,False,216,183,39528
00000235.jpg,4000,6000,1521,1867,1939,2580,False,418,713,298034
00002422.jpg,500,500,177,294,291,427,False,114,133,15162
00002422.jpg,500,500,174,49,349,253,False,175,204,35700
00003072.jpg,612,408,220,78,351,179,False,131,101,13231
00003072.jpg,612,408,94,151,182,220,False,88,69,6072
00001665.jpg,1000,667,413,90,645,267,False,232,177,41064
00003066.jpg,1157,887,296,70,487,240,False,191,170,32470
00003066.jpg,1157,887,509,124,708,301,False,199,177,35223
00003066.jpg,1157,887,101,172,328,374,False,227,202,45854
00001117.jpg,1500,1201,454,130,1045,681,False,591,551,325641
00002393.jpg,1400,1120,532,346,944,729,False,412,383,157796
00000584.jpg,6000,3887,2014,1076,2654,1559,False,640,483,309120
00001842.jpg,700,1050,313,100,419,284,False,106,184,19504
00000590.jpg,1000,571,521,281,721,414,False,200,133,26600
00000590.jpg,1000,571,277,294,481,430,False,204,136,27744
00001856.jpg,364,280,1,1,276,138,False,275,137,37675
00002387.jpg,388,480,162,76,287,255,False,125,179,22375
00003098.jpg,1023,682,827,413,934,496,False,107,83,8881
00001843.jpg,682,1024,254,75,438,397,False,184,322,59248
00000585.jpg,1500,1000,1037,113,1259,285,False,222,172,38184
00000585.jpg,1500,1000,244,121,476,301,False,232,180,41760
00003067.jpg,1600,1066,781,431,1033,626,False,252,195,49140
00003067.jpg,1600,1066,910,180,1259,451,False,349,271,94579
00002379.jpg,550,350,183,15,414,186,False,231,171,39501
00001670.jpg,1024,768,248,66,569,346,False,321,280,89880
00000208.jpg,773,580,162,79,252,158,False,90,79,7110
00003073.jpg,1300,866,700,233,1127,571,False,427,338,144326
00001894.jpg,1600,1167,621,94,947,371,False,326,277,90302
00002423.jpg,612,459,138,4,526,344,False,388,340,131920
00000220.jpg,450,328,207,83,262,128,False,55,45,2475
00000220.jpg,450,328,139,66,194,113,False,55,47,2585
00000220.jpg,450,328,267,68,320,114,False,53,46,2438
00002437.jpg,866,1300,326,332,586,778,False,260,446,115960
00002351.jpg,800,534,387,128,510,224,False,123,96,11808
00001658.jpg,1300,956,443,131,834,458,False,391,327,127857
00000963.jpg,800,582,230,73,707,477,False,477,404,192708
00000793.jpg,1111,980,301,6,893,602,False,592,596,352832
00002190.jpg,735,489,39,93,457,417,False,418,324,135432
00002190.jpg,735,489,267,1,734,392,False,467,391,182597
00001499.jpg,800,527,224,22,465,207,False,241,185,44585
00000787.jpg,650,434,281,68,429,180,False,148,112,16576
00001472.jpg,1000,1500,383,1,1000,1054,False,617,1053,649701
00000778.jpg,1200,1800,267,289,636,919,False,369,630,232470
00003517.jpg,236,236,81,40,160,132,False,79,92,7268
00003517.jpg,236,236,162,71,215,134,False,53,63,3339
00003517.jpg,236,236,36,14,104,92,False,68,78,5304
00003517.jpg,236,236,88,122,127,169,False,39,47,1833
00002621.jpg,1050,700,237,151,425,297,False,188,146,27448
00002621.jpg,1050,700,423,170,624,326,False,201,156,31356
00002147.jpg,667,1000,295,13,566,486,False,271,473,128183
00000988.jpg,1300,866,269,86,497,263,False,228,177,40356
00002153.jpg,688,1050,231,111,313,253,False,82,142,11644
00000022.jpg,767,512,475,129,558,194,False,83,65,5395
00002972.jpg,2000,1333,479,205,996,606,False,517,401,207317
00002972.jpg,2000,1333,857,303,1433,750,False,576,447,257472
00000803.jpg,1500,2250,613,575,1105,1415,False,492,840,413280
00000817.jpg,667,1000,268,32,410,280,False,142,248,35216
00002966.jpg,660,367,214,102,287,150,False,73,48,3504
00002966.jpg,660,367,332,24,414,77,False,82,53,4346
00002796.jpg,800,800,370,194,596,456,False,226,262,59212
00000181.jpg,1600,1158,451,30,1306,750,False,855,720,615600
00002782.jpg,608,406,169,30,231,79,False,62,49,3038
00002769.jpg,960,640,114,7,650,423,False,536,416,222976
00003477.jpg,235,176,132,52,182,95,False,50,43,2150
00003477.jpg,235,176,47,50,96,93,False,49,43,2107
00003477.jpg,235,176,78,45,131,90,False,53,45,2385
00001260.jpg,867,1390,282,83,543,559,False,261,476,124236
00001506.jpg,653,1024,321,190,433,391,False,112,201,22512
00000618.jpg,800,582,62,11,313,224,False,251,213,53463
00000618.jpg,800,582,241,71,509,298,False,268,227,60836
00003311.jpg,1280,853,424,116,853,448,False,429,332,142428
00003305.jpg,200,300,78,44,137,147,False,59,103,6077
00003463.jpg,550,366,104,24,366,231,False,262,207,54234
00000142.jpg,600,750,260,1,546,370,False,286,369,105534
00002755.jpg,994,663,603,222,816,387,False,213,165,35145
00002033.jpg,864,1390,272,61,427,345,False,155,284,44020
00003339.jpg,626,352,222,139,383,245,False,161,106,17066
00001248.jpg,891,1000,421,170,562,353,False,141,183,25803
00001923.jpg,1500,1029,590,121,890,360,False,300,239,71700
00002594.jpg,650,975,286,154,382,325,False,96,171,16416
00002580.jpg,1400,1000,412,150,1400,993,False,988,843,832884
00001089.jpg,1000,667,207,39,477,248,False,270,209,56430
00001937.jpg,800,533,258,32,474,196,False,216,164,35424
00003113.jpg,1000,667,79,157,438,430,False,359,273,98007
00003113.jpg,1000,667,302,200,590,419,False,288,219,63072
00001704.jpg,683,1023,370,39,516,293,False,146,254,37084
00001710.jpg,626,417,203,36,330,135,False,127,99,12573
00002219.jpg,306,423,99,49,219,242,False,120,193,23160
00000426.jpg,686,1029,303,119,450,375,False,147,256,37632
00001738.jpg,974,1390,412,392,514,561,False,102,169,17238
00002231.jpg,900,680,688,23,821,140,False,133,117,15561
00002231.jpg,900,680,67,206,172,298,False,105,92,9660
00002231.jpg,900,680,540,24,657,127,False,117,103,12051
00002231.jpg,900,680,204,104,313,201,False,109,97,10573
00002231.jpg,900,680,354,55,469,155,False,115,100,11500
00002557.jpg,1500,1120,218,45,735,494,False,517,449,232133
00000340.jpg,800,583,469,99,629,235,False,160,136,21760
00002225.jpg,700,933,281,132,407,327,False,126,195,24570
00000432.jpg,700,467,367,52,569,209,False,202,157,31714
00002555.jpg,1024,656,750,143,964,302,False,214,159,34026
00002555.jpg,1024,656,10,54,233,217,False,223,163,36349
00002555.jpg,1024,656,398,64,631,238,False,233,174,40542
00002555.jpg,1024,656,631,54,859,224,False,228,170,38760
00002555.jpg,1024,656,685,278,923,456,False,238,178,42364
00002555.jpg,1024,656,95,179,328,349,False,233,170,39610
00002555.jpg,1024,656,321,269,554,447,False,233,178,41474
00002233.jpg,700,933,342,100,498,342,False,156,242,37752
00000430.jpg,800,800,278,165,380,283,False,102,118,12036
00002227.jpg,1000,667,95,5,895,574,False,800,569,455200
00001048.jpg,1000,1250,458,390,634,646,False,176,256,45056
00001060.jpg,1300,956,735,81,959,272,False,224,191,42784
00001706.jpg,1300,867,444,177,843,488,False,399,311,124089
00003111.jpg,500,333,186,112,321,217,False,135,105,14175
00003111.jpg,500,333,73,18,244,148,False,171,130,22230
00001074.jpg,1600,1156,655,75,913,291,False,258,216,55728
00002596.jpg,960,641,248,143,658,462,False,410,319,130790
00000381.jpg,829,580,291,49,530,240,False,239,191,45649
00001921.jpg,1300,956,372,57,847,464,False,475,407,193325
00001935.jpg,1300,956,394,109,1000,628,False,606,519,314514
00000626.jpg,500,334,299,31,443,143,False,144,112,16128
00000626.jpg,500,334,93,49,225,151,False,132,102,13464
00000626.jpg,500,334,340,38,490,155,False,150,117,17550
00000626.jpg,500,334,1,86,191,244,False,190,158,30020
00000626.jpg,500,334,151,71,394,252,False,243,181,43983
00002031.jpg,2000,1333,645,66,1500,744,False,855,678,579690
00003449.jpg,236,354,69,37,155,188,False,86,151,12986
00000154.jpg,626,398,345,91,465,179,False,120,88,10560
00002743.jpg,900,596,289,79,508,248,False,219,169,37011
00003475.jpg,236,115,78,1,234,104,False,156,103,16068
00001276.jpg,800,533,191,1,677,346,False,486,345,167670
00000168.jpg,1000,667,228,12,906,527,False,678,515,349170
00001510.jpg,1600,1168,559,113,1360,795,False,801,682,546282
00002019.jpg,600,419,191,29,306,122,False,115,93,10695
00002019.jpg,600,419,338,40,433,116,False,95,76,7220
00001289.jpg,1005,1300,234,156,694,834,False,460,678,311880
00000829.jpg,2000,3000,802,380,1248,1158,False,446,778,346988
00000801.jpg,406,612,151,38,273,253,False,122,215,26230
00002970.jpg,1000,1000,599,608,760,796,False,161,188,30268
00002964.jpg,640,360,14,20,215,151,False,201,131,26331
00000752.jpg,967,1300,424,74,635,412,False,211,338,71318
00002145.jpg,866,1300,378,456,506,680,False,128,224,28672
00000020.jpg,1000,667,288,20,516,193,False,228,173,39444
00002151.jpg,320,405,115,116,182,212,False,67,96,6432
00001458.jpg,650,433,366,113,554,256,False,188,143,26884
00003267.jpg,509,340,300,87,406,169,False,106,82,8692
00002179.jpg,1600,900,434,25,1179,513,False,745,488,363560
00001470.jpg,1365,2048,483,495,1067,1514,False,584,1019,595096
00000008.jpg,1300,867,820,234,1016,387,False,196,153,29988
00001316.jpg,626,418,105,3,539,154,False,434,151,65534
00003501.jpg,236,365,94,104,138,184,False,44,80,3520
00001302.jpg,800,532,101,91,458,367,False,357,276,98532
00003273.jpg,612,408,184,75,299,164,False,115,89,10235
00003273.jpg,612,408,111,66,210,142,False,99,76,7524
00002186.jpg,1082,1689,418,169,608,514,False,190,345,65550
00003298.jpg,750,500,333,113,515,252,False,182,139,25298
00003298.jpg,750,500,94,166,272,305,False,178,139,24742
00000785.jpg,866,1390,351,209,439,374,False,88,165,14520
00002192.jpg,800,470,6,73,237,231,False,231,158,36498
00002192.jpg,800,470,167,270,342,387,False,175,117,20475
00002192.jpg,800,470,238,46,512,234,False,274,188,51512
00002804.jpg,509,339,25,81,134,166,False,109,85,9265
00002804.jpg,509,339,128,67,222,140,False,94,73,6862
00002804.jpg,509,339,412,81,507,173,False,95,92,8740
00002804.jpg,509,339,314,76,401,143,False,87,67,5829
00002810.jpg,346,280,133,84,260,203,False,127,119,15113
00002421.jpg,1210,988,111,256,227,366,False,116,110,12760
00002421.jpg,1210,988,259,108,372,216,False,113,108,12204
00002421.jpg,1210,988,614,314,727,420,False,113,106,11978
00002421.jpg,1210,988,881,324,1004,442,False,123,118,14514
00002421.jpg,1210,988,253,368,362,469,False,109,101,11009
00002421.jpg,1210,988,661,88,763,186,False,102,98,9996
00003059.jpg,1140,854,837,532,1009,682,False,172,150,25800
00000550.jpg,612,408,149,123,334,262,False,185,139,25715
00000550.jpg,612,408,280,98,514,280,False,234,182,42588
00000550.jpg,612,408,50,187,238,330,False,188,143,26884
00000550.jpg,612,408,398,8,546,121,False,148,113,16724
00000550.jpg,612,408,436,108,609,262,False,173,154,26642
00000550.jpg,612,408,268,6,385,97,False,117,91,10647
00000550.jpg,612,408,1,27,143,156,False,142,129,18318
00001882.jpg,1024,869,673,214,797,335,False,124,121,15004
00001882.jpg,1024,869,564,128,709,271,False,145,143,20735
00001882.jpg,1024,869,717,418,824,524,False,107,106,11342
00002353.jpg,335,500,126,60,229,239,False,103,179,18437
00000222.jpg,1300,956,466,151,776,415,False,310,264,81840
00001114.jpg,865,1390,269,321,349,466,False,80,145,11600
00001672.jpg,600,420,44,52,302,262,False,258,210,54180
00003065.jpg,1300,851,272,160,1013,736,False,741,576,426816
00003071.jpg,550,309,59,136,198,227,False,139,91,12649
00003071.jpg,550,309,55,1,228,110,False,173,109,18857
00003071.jpg,550,309,175,109,348,222,False,173,113,19549
00003071.jpg,550,309,258,175,417,276,False,159,101,16059
00000578.jpg,1024,682,102,139,378,353,False,276,214,59064
00000578.jpg,1024,682,592,137,780,279,False,188,142,26696
00000578.jpg,1024,682,717,161,950,341,False,233,180,41940
00000578.jpg,1024,682,405,163,658,355,False,253,192,48576
00000578.jpg,1024,682,130,213,549,530,False,419,317,132823
00000578.jpg,1024,682,225,1,409,126,False,184,125,23000
00000578.jpg,1024,682,371,65,529,185,False,158,120,18960
00000578.jpg,1024,682,482,53,657,189,False,175,136,23800
00000578.jpg,1024,682,719,374,1021,664,False,302,290,87580
00000593.jpg,612,408,444,112,605,238,False,161,126,20286
00000593.jpg,612,408,244,143,405,266,False,161,123,19803
00000593.jpg,612,408,440,23,573,124,False,133,101,13433
00000593.jpg,612,408,83,62,210,159,False,127,97,12319
00000593.jpg,612,408,365,66,507,177,False,142,111,15762
00000593.jpg,612,408,268,9,413,122,False,145,113,16385
00000593.jpg,612,408,110,1,225,77,False,115,76,8740
00000593.jpg,612,408,1,102,144,215,False,143,113,16159
00000593.jpg,612,408,322,2,459,104,False,137,102,13974
00001855.jpg,683,1024,320,100,395,230,False,75,130,9750
00002384.jpg,539,752,169,127,244,248,False,75,121,9075
00002390.jpg,550,350,137,15,400,210,False,263,195,51285
00001699.jpg,798,1024,246,172,532,598,False,286,426,121836
00001841.jpg,735,490,266,57,541,274,False,275,217,59675
00001869.jpg,600,400,185,36,336,154,False,151,118,17818
00001868.jpg,590,393,356,91,505,204,False,149,113,16837
00001840.jpg,356,200,204,14,316,87,False,112,73,8176
00001698.jpg,2000,1335,190,92,944,679,False,754,587,442598
00002391.jpg,408,612,82,273,202,482,False,120,209,25080
00002391.jpg,408,612,187,43,310,257,False,123,214,26322
00002385.jpg,512,463,401,59,480,142,False,79,83,6557
00002385.jpg,512,463,252,68,328,147,False,76,79,6004
00001854.jpg,612,367,278,23,507,182,False,229,159,36411
00000592.jpg,1500,1031,273,274,444,411,False,171,137,23427
00000579.jpg,3840,2560,1264,921,2394,1797,False,1130,876,989880
00000579.jpg,3840,2560,2370,531,3044,1054,False,674,523,352502
00000579.jpg,3840,2560,1704,345,2456,916,False,752,571,429392
00000579.jpg,3840,2560,868,267,1839,1021,False,971,754,732134
00000579.jpg,3840,2560,2912,273,3840,1189,False,928,916,850048
00000579.jpg,3840,2560,10,1018,1141,1914,False,1131,896,1013376
00003070.jpg,681,1024,299,155,495,491,False,196,336,65856
00001673.jpg,500,750,186,41,321,276,False,135,235,31725
00001883.jpg,390,280,153,14,281,120,False,128,106,13568
00000545.jpg,1200,800,743,26,1047,261,False,304,235,71440
00000545.jpg,1200,800,315,90,577,293,False,262,203,53186
00002420.jpg,690,1000,185,33,578,696,False,393,663,260559
00001129.jpg,626,417,277,56,458,196,False,181,140,25340
00001897.jpg,390,280,133,26,264,132,False,131,106,13886
00000551.jpg,900,599,337,120,673,380,False,336,260,87360
00000551.jpg,900,599,145,100,476,367,False,331,267,88377
00000551.jpg,900,599,313,1,584,171,False,271,170,46070
00000551.jpg,900,599,580,1,862,167,False,282,166,46812
00000551.jpg,900,599,56,53,409,327,False,353,274,96722
00003058.jpg,350,350,265,193,315,249,False,50,56,2800
00003058.jpg,350,350,43,211,85,261,False,42,50,2100
00002811.jpg,626,418,149,47,476,307,False,327,260,85020
00002811.jpg,626,418,1,1,327,291,False,326,290,94540
00002811.jpg,626,418,298,1,625,277,False,327,276,90252
00000974.jpg,462,280,77,34,183,108,False,106,74,7844
00002805.jpg,900,675,199,243,289,322,False,90,79,7110
00002805.jpg,900,675,675,16,754,84,False,79,68,5372
00000784.jpg,1300,866,284,103,935,608,False,651,505,328755
00000948.jpg,800,582,170,82,327,215,False,157,133,20881
00000948.jpg,800,582,329,72,469,189,False,140,117,16380
00000948.jpg,800,582,523,121,670,245,False,147,124,18228
00000790.jpg,1058,1600,437,86,710,567,False,273,481,131313
00003299.jpg,500,367,206,113,294,186,False,88,73,6424
00002839.jpg,994,663,524,106,810,324,False,286,218,62348
00003514.jpg,236,354,93,37,133,106,False,40,69,2760
00001465.jpg,2048,1365,864,159,1480,637,False,616,478,294448
00002178.jpg,612,407,354,113,512,233,False,158,120,18960
00002178.jpg,612,407,227,152,450,329,False,223,177,39471
00003266.jpg,1300,1035,814,170,1038,377,False,224,207,46368
00003500.jpg,236,236,31,29,120,133,False,89,104,9256
00001317.jpg,1300,956,781,89,1009,280,False,228,191,43548
00002636.jpg,1024,683,281,199,395,287,False,114,88,10032
00001459.jpg,612,485,257,116,377,226,False,120,110,13200
00002150.jpg,1300,918,797,190,981,342,False,184,152,27968
00002144.jpg,2000,1333,657,52,1233,509,False,576,457,263232
00000753.jpg,467,700,99,10,299,358,False,200,348,69600
00002622.jpg,800,533,447,310,591,421,False,144,111,15984
00002622.jpg,800,533,361,162,498,269,False,137,107,14659
00002622.jpg,800,533,157,106,297,215,False,140,109,15260
00002965.jpg,500,334,136,60,359,237,False,223,177,39471
00000814.jpg,900,600,468,64,769,298,False,301,234,70434
00000800.jpg,352,500,116,137,224,316,False,108,179,19332
00002971.jpg,390,280,131,38,228,118,False,97,80,7760
00001288.jpg,500,750,182,54,292,244,False,110,190,20900
00000196.jpg,1600,1168,895,170,1467,656,False,572,486,277992
00002959.jpg,1200,630,564,106,1032,392,False,468,286,133848
00002781.jpg,1000,1500,401,331,551,594,False,150,263,39450
00000828.jpg,300,470,95,40,154,147,False,59,107,6313
00002795.jpg,1000,760,680,170,848,319,False,168,149,25032
00000182.jpg,1024,681,583,128,859,342,False,276,214,59064
00000169.jpg,480,720,209,299,260,389,False,51,90,4590
00001277.jpg,500,749,203,173,282,307,False,79,134,10586
00003460.jpg,235,353,72,78,123,168,False,51,90,4590
00003306.jpg,779,900,155,187,671,867,False,516,680,350880
00002018.jpg,1080,1080,204,81,861,846,False,657,765,502605
00003312.jpg,800,800,268,228,538,542,False,270,314,84780
00000155.jpg,1000,684,483,276,585,357,False,102,81,8262
00002024.jpg,612,436,189,17,423,214,False,234,197,46098
00002030.jpg,640,640,470,68,536,144,False,66,76,5016
00002030.jpg,640,640,554,85,618,161,False,64,76,4864
00002030.jpg,640,640,207,100,272,175,False,65,75,4875
00002030.jpg,640,640,20,120,84,193,False,64,73,4672
00002030.jpg,640,640,283,94,353,174,False,70,80,5600
00002030.jpg,640,640,383,134,445,207,False,62,73,4526
00002030.jpg,640,640,581,147,640,217,False,59,70,4130
00002030.jpg,640,640,117,121,177,191,False,60,70,4200
00001539.jpg,864,1300,206,391,450,808,False,244,417,101748
00000141.jpg,334,519,162,106,261,280,False,99,174,17226
00000141.jpg,334,519,44,88,147,270,False,103,182,18746
00002756.jpg,1600,1157,68,15,409,302,False,341,287,97867
00002756.jpg,1600,1157,338,354,672,635,False,334,281,93854
00002756.jpg,1600,1157,826,215,1153,484,False,327,269,87963
00002756.jpg,1600,1157,1105,92,1462,392,False,357,300,107100
00002756.jpg,1600,1157,606,483,986,804,False,380,321,121980
00001908.jpg,626,938,289,78,359,200,False,70,122,8540
00001934.jpg,1500,1120,662,91,1067,443,False,405,352,142560
00002583.jpg,900,600,235,105,462,282,False,227,177,40179
00000380.jpg,1500,1000,452,100,1265,717,False,813,617,501621
00002597.jpg,681,1024,277,190,425,450,False,148,260,38480
00001920.jpg,865,1300,370,138,469,310,False,99,172,17028
00001713.jpg,334,518,148,53,191,131,False,43,78,3354
00003104.jpg,511,340,64,1,423,260,False,359,259,92981
00001075.jpg,570,537,203,20,361,197,False,158,177,27966
00001061.jpg,2000,3000,582,222,1111,1164,False,529,942,498318
00003110.jpg,600,400,95,100,272,237,False,177,137,24249
00000419.jpg,489,500,238,105,326,209,False,88,104,9152
00001707.jpg,800,534,381,13,575,160,False,194,147,28518
00003138.jpg,508,339,207,72,444,260,False,237,188,44556
00001049.jpg,1024,683,345,83,736,387,False,391,304,118864
00002540.jpg,276,340,71,62,172,206,False,101,144,14544
00002554.jpg,1200,900,451,107,707,330,False,256,223,57088
00002232.jpg,620,349,4,36,186,158,False,182,122,22204
00002232.jpg,620,349,122,103,344,248,False,222,145,32190
00002232.jpg,620,349,258,118,541,303,False,283,185,52355
00002232.jpg,620,349,215,11,362,108,False,147,97,14259
00002232.jpg,620,349,330,1,487,81,False,157,80,12560
