image_name,width,height,x0,y0,x1,y1,out_of_bounds,bbox_width,bbox_height,bbox_area,image_aspect_ratio,face_width,face_height,face_area,face_aspect_ratio,face_size_category,face_center_x,face_center_y,face_center_x_norm,face_center_y_norm,position_category,image_area,face_to_image_ratio,face_ratio_category
00001722.jpg,1333,2000,490,320,687,664,False,197,344,67768,0.6665,197,344,67768,0.5726744186046512,Very Large,588.5,492.0,0.4414853713428357,0.246,top-center,2666000,0.025419354838709676,Small (1-5%)
00001044.jpg,2000,1333,791,119,1200,436,False,409,317,129653,1.5003750937734435,409,317,129653,1.2902208201892744,Very Large,995.5,277.5,0.49775,0.20817704426106526,top-center,2666000,0.048632033008252064,Small (1-5%)
00001050.jpg,667,1000,304,155,407,331,False,103,176,18128,0.667,103,176,18128,0.5852272727272727,Medium,355.5,243.0,0.532983508245877,0.243,top-center,667000,0.0271784107946027,Small (1-5%)
00001736.jpg,626,417,147,14,519,303,False,372,289,107508,1.501199040767386,372,289,107508,1.28719723183391,Very Large,333.0,158.5,0.5319488817891374,0.3800959232613909,middle-center,261042,0.4118417725883191,Very Large (>30%)
00003121.jpg,626,418,462,60,599,166,False,137,106,14522,1.4976076555023923,137,106,14522,1.2924528301886793,Medium,530.5,113.0,0.847444089456869,0.2703349282296651,top-right,261668,0.05549780638060443,Medium (5-15%)
00003121.jpg,626,418,316,157,441,254,False,125,97,12125,1.4976076555023923,125,97,12125,1.288659793814433,Medium,378.5,205.5,0.604632587859425,0.4916267942583732,middle-center,261668,0.046337343503982144,Small (1-5%)
00003121.jpg,626,418,35,71,160,168,False,125,97,12125,1.4976076555023923,125,97,12125,1.288659793814433,Medium,97.5,119.5,0.15575079872204473,0.28588516746411485,top-left,261668,0.046337343503982144,Small (1-5%)
00003121.jpg,626,418,254,94,376,187,False,122,93,11346,1.4976076555023923,122,93,11346,1.3118279569892473,Medium,315.0,140.5,0.5031948881789138,0.3361244019138756,middle-center,261668,0.043360288609994344,Small (1-5%)
00003121.jpg,626,418,166,118,306,226,False,140,108,15120,1.4976076555023923,140,108,15120,1.2962962962962963,Medium,236.0,172.0,0.3769968051118211,0.41148325358851673,middle-center,261668,0.05778314505403794,Medium (5-15%)
00000400.jpg,600,400,148,61,377,242,False,229,181,41449,1.5,229,181,41449,1.2651933701657458,Large,262.5,151.5,0.4375,0.37875,middle-center,240000,0.17270416666666666,Large (15-30%)
00002571.jpg,960,720,117,159,317,334,False,200,175,35000,1.3333333333333333,200,175,35000,1.1428571428571428,Large,217.0,246.5,0.22604166666666667,0.3423611111111111,middle-left,691200,0.05063657407407408,Medium (5-15%)
00002571.jpg,960,720,596,203,772,354,False,176,151,26576,1.3333333333333333,176,151,26576,1.1655629139072847,Large,684.0,278.5,0.7125,0.38680555555555557,middle-right,691200,0.03844907407407407,Small (1-5%)
00000366.jpg,900,601,170,88,506,350,False,336,262,88032,1.497504159733777,336,262,88032,1.282442748091603,Very Large,338.0,219.0,0.37555555555555553,0.3643926788685524,middle-center,540900,0.16275097060454796,Large (15-30%)
00000366.jpg,900,601,303,2,639,144,False,336,142,47712,1.497504159733777,336,142,47712,2.3661971830985915,Large,471.0,73.0,0.5233333333333333,0.12146422628951747,top-center,540900,0.08820854132002219,Medium (5-15%)
00002565.jpg,1267,712,241,40,963,513,False,722,473,341506,1.779494382022472,722,473,341506,1.5264270613107822,Very Large,602.0,276.5,0.47513812154696133,0.3883426966292135,middle-center,902104,0.3785661076771636,Very Large (>30%)
00001939.jpg,612,424,195,57,383,209,False,188,152,28576,1.4433962264150944,188,152,28576,1.236842105263158,Large,289.0,133.0,0.4722222222222222,0.3136792452830189,top-center,259488,0.11012455296584042,Medium (5-15%)
00001087.jpg,1024,683,405,27,614,189,False,209,162,33858,1.499267935578331,209,162,33858,1.2901234567901234,Large,509.5,108.0,0.49755859375,0.1581259150805271,top-center,699392,0.04841061950951684,Small (1-5%)
00001093.jpg,821,1300,290,28,392,211,False,102,183,18666,0.6315384615384615,102,183,18666,0.5573770491803278,Medium,341.0,119.5,0.415347137637028,0.09192307692307693,top-center,1067300,0.01748899091164621,Small (1-5%)
00001905.jpg,612,408,137,20,394,224,False,257,204,52428,1.5,257,204,52428,1.2598039215686274,Very Large,265.5,122.0,0.4338235294117647,0.29901960784313725,top-center,249696,0.2099673202614379,Large (15-30%)
00001911.jpg,792,463,317,187,442,272,False,125,85,10625,1.7105831533477323,125,85,10625,1.4705882352941178,Medium,379.5,229.5,0.4791666666666667,0.4956803455723542,middle-center,366696,0.028974954730894256,Small (1-5%)
00001911.jpg,792,463,386,110,570,236,False,184,126,23184,1.7105831533477323,184,126,23184,1.4603174603174602,Large,478.0,173.0,0.6035353535353535,0.37365010799136067,middle-center,366696,0.06322403298645199,Medium (5-15%)
00001911.jpg,792,463,231,42,411,165,False,180,123,22140,1.7105831533477323,180,123,22140,1.4634146341463414,Large,321.0,103.5,0.4053030303030303,0.22354211663066956,top-center,366696,0.06037698802277636,Medium (5-15%)
00002997.jpg,882,588,269,245,363,318,False,94,73,6862,1.5,94,73,6862,1.2876712328767124,Medium,316.0,281.5,0.35827664399092973,0.47874149659863946,middle-center,518616,0.013231369645363814,Small (1-5%)
00002997.jpg,882,588,372,23,484,109,False,112,86,9632,1.5,112,86,9632,1.302325581395349,Medium,428.0,66.0,0.4852607709750567,0.11224489795918367,top-center,518616,0.018572508368426735,Small (1-5%)
00002997.jpg,882,588,567,113,682,202,False,115,89,10235,1.5,115,89,10235,1.2921348314606742,Medium,624.5,157.5,0.7080498866213152,0.26785714285714285,top-right,518616,0.0197352183503787,Small (1-5%)
00003451.jpg,236,354,87,46,131,121,False,44,75,3300,0.6666666666666666,44,75,3300,0.5866666666666667,Small,109.0,83.5,0.461864406779661,0.23587570621468926,top-center,83544,0.039500143636885955,Small (1-5%)
00001246.jpg,600,419,210,32,361,158,False,151,126,19026,1.431980906921241,151,126,19026,1.1984126984126984,Medium,285.5,95.0,0.47583333333333333,0.22673031026252982,top-center,251400,0.0756801909307876,Medium (5-15%)
00001520.jpg,1098,732,684,251,987,486,False,303,235,71205,1.5,303,235,71205,1.2893617021276595,Very Large,835.5,368.5,0.7609289617486339,0.5034153005464481,middle-right,803736,0.08859252291797307,Medium (5-15%)
00001520.jpg,1098,732,34,195,344,435,False,310,240,74400,1.5,310,240,74400,1.2916666666666667,Very Large,189.0,315.0,0.1721311475409836,0.430327868852459,middle-left,803736,0.09256770879990445,Medium (5-15%)
00001520.jpg,1098,732,375,279,678,509,False,303,230,69690,1.5,303,230,69690,1.317391304347826,Very Large,526.5,394.0,0.47950819672131145,0.5382513661202186,middle-center,803736,0.08670757562184597,Medium (5-15%)
00001520.jpg,1098,732,486,239,796,474,False,310,235,72850,1.5,310,235,72850,1.3191489361702127,Very Large,641.0,356.5,0.5837887067395264,0.4870218579234973,middle-center,803736,0.0906392148665731,Medium (5-15%)
00001520.jpg,1098,732,913,215,1097,446,False,184,231,42504,1.5,184,231,42504,0.7965367965367965,Large,1005.0,330.5,0.9153005464480874,0.45150273224043713,middle-right,803736,0.05288303622084864,Medium (5-15%)
00002029.jpg,345,520,149,66,207,167,False,58,101,5858,0.6634615384615384,58,101,5858,0.5742574257425742,Medium,178.0,116.5,0.5159420289855072,0.22403846153846155,top-center,179400,0.03265328874024526,Small (1-5%)
00003337.jpg,500,500,173,8,252,100,False,79,92,7268,1.0,79,92,7268,0.8586956521739131,Medium,212.5,54.0,0.425,0.108,top-center,250000,0.029072,Small (1-5%)
00003337.jpg,500,500,176,219,248,304,False,72,85,6120,1.0,72,85,6120,0.8470588235294118,Medium,212.0,261.5,0.424,0.523,middle-center,250000,0.02448,Small (1-5%)
00003337.jpg,500,500,24,298,82,365,False,58,67,3886,1.0,58,67,3886,0.8656716417910447,Small,53.0,331.5,0.106,0.663,middle-left,250000,0.015544,Small (1-5%)
00003323.jpg,408,612,170,77,247,208,False,77,131,10087,0.6666666666666666,77,131,10087,0.5877862595419847,Medium,208.5,142.5,0.5110294117647058,0.23284313725490197,top-center,249696,0.04039712290144816,Small (1-5%)
00001252.jpg,343,280,144,31,211,94,False,67,63,4221,1.225,67,63,4221,1.0634920634920635,Small,177.5,62.5,0.5174927113702624,0.22321428571428573,top-center,96040,0.04395043731778426,Small (1-5%)
00002983.jpg,1200,939,435,149,553,254,False,118,105,12390,1.2779552715654952,118,105,12390,1.1238095238095238,Medium,494.0,201.5,0.4116666666666667,0.21458998935037274,top-center,1126800,0.010995740149094782,Small (1-5%)
00002983.jpg,1200,939,315,146,418,237,False,103,91,9373,1.2779552715654952,103,91,9373,1.1318681318681318,Medium,366.5,191.5,0.30541666666666667,0.20394036208732694,top-left,1126800,0.008318246361377351,Tiny (<1%)
00003445.jpg,236,314,44,21,95,97,False,51,76,3876,0.7515923566878981,51,76,3876,0.6710526315789473,Small,69.5,59.0,0.2944915254237288,0.18789808917197454,top-left,74104,0.05230486883299147,Medium (5-15%)
00002015.jpg,684,1024,147,71,528,720,False,381,649,247269,0.66796875,381,649,247269,0.5870570107858244,Very Large,337.5,395.5,0.4934210526315789,0.38623046875,middle-center,700416,0.35303162691885964,Very Large (>30%)
00000602.jpg,1300,956,368,184,622,402,False,254,218,55372,1.3598326359832635,254,218,55372,1.165137614678899,Very Large,495.0,293.0,0.38076923076923075,0.3064853556485356,top-center,1242800,0.04455423237850016,Small (1-5%)
00000602.jpg,1300,956,696,360,980,608,False,284,248,70432,1.3598326359832635,284,248,70432,1.1451612903225807,Very Large,838.0,484.0,0.6446153846153846,0.5062761506276151,middle-center,1242800,0.05667203089797232,Medium (5-15%)
00000602.jpg,1300,956,900,461,1154,684,False,254,223,56642,1.3598326359832635,254,223,56642,1.1390134529147982,Very Large,1027.0,572.5,0.79,0.5988493723849372,middle-right,1242800,0.045576118442227226,Small (1-5%)
00000602.jpg,1300,956,52,329,435,656,False,383,327,125241,1.3598326359832635,383,327,125241,1.1712538226299694,Very Large,243.5,492.5,0.18730769230769231,0.5151673640167364,middle-left,1242800,0.10077325394271001,Medium (5-15%)
00000602.jpg,1300,956,726,149,954,345,False,228,196,44688,1.3598326359832635,228,196,44688,1.163265306122449,Large,840.0,247.0,0.6461538461538462,0.2583682008368201,top-center,1242800,0.03595751528805922,Small (1-5%)
00000616.jpg,910,607,458,373,644,514,False,186,141,26226,1.4991762767710048,186,141,26226,1.3191489361702127,Large,551.0,443.5,0.6054945054945055,0.7306425041186162,bottom-center,552370,0.04747904484313051,Small (1-5%)
00002001.jpg,1500,1120,564,1,960,328,False,396,327,129492,1.3392857142857142,396,327,129492,1.2110091743119267,Very Large,762.0,164.5,0.508,0.146875,top-center,1680000,0.07707857142857143,Medium (5-15%)
00002767.jpg,900,600,240,36,864,531,False,624,495,308880,1.5,624,495,308880,1.2606060606060605,Very Large,552.0,283.5,0.6133333333333333,0.4725,middle-center,540000,0.572,Very Large (>30%)
00000170.jpg,626,418,299,72,368,127,False,69,55,3795,1.4976076555023923,69,55,3795,1.2545454545454546,Small,333.5,99.5,0.5327476038338658,0.23803827751196172,top-center,261668,0.014503110812174206,Small (1-5%)
00000170.jpg,626,418,363,155,442,217,False,79,62,4898,1.4976076555023923,79,62,4898,1.2741935483870968,Small,402.5,186.0,0.6429712460063898,0.4449760765550239,middle-center,261668,0.018718375957319962,Small (1-5%)
00000170.jpg,626,418,421,38,499,98,False,78,60,4680,1.4976076555023923,78,60,4680,1.3,Small,460.0,68.0,0.7348242811501597,0.16267942583732056,top-right,261668,0.017885259183392697,Small (1-5%)
00000170.jpg,626,418,294,134,369,192,False,75,58,4350,1.4976076555023923,75,58,4350,1.293103448275862,Small,331.5,163.0,0.5295527156549521,0.38995215311004783,middle-center,261668,0.016624119112768853,Small (1-5%)
00002954.jpg,866,1300,166,448,355,778,False,189,330,62370,0.6661538461538462,189,330,62370,0.5727272727272728,Very Large,260.5,613.0,0.3008083140877598,0.4715384615384615,middle-left,1125800,0.05540060401492272,Medium (5-15%)
00002954.jpg,866,1300,339,62,528,384,False,189,322,60858,0.6661538461538462,189,322,60858,0.5869565217391305,Very Large,433.5,223.0,0.5005773672055427,0.17153846153846153,top-center,1125800,0.05405755906910641,Medium (5-15%)
00002954.jpg,866,1300,553,505,726,801,False,173,296,51208,0.6661538461538462,173,296,51208,0.5844594594594594,Very Large,639.5,653.0,0.7384526558891455,0.5023076923076923,middle-right,1125800,0.045485876709895186,Small (1-5%)
00003492.jpg,236,354,101,26,145,103,False,44,77,3388,0.6666666666666666,44,77,3388,0.5714285714285714,Small,123.0,64.5,0.5211864406779662,0.18220338983050846,top-center,83544,0.040553480800536244,Small (1-5%)
00000825.jpg,367,550,161,32,236,163,False,75,131,9825,0.6672727272727272,75,131,9825,0.5725190839694656,Medium,198.5,97.5,0.5408719346049047,0.17727272727272728,top-center,201850,0.04867475848402279,Small (1-5%)
00000831.jpg,800,450,154,7,685,362,False,531,355,188505,1.7777777777777777,531,355,188505,1.495774647887324,Very Large,419.5,184.5,0.524375,0.41,middle-center,360000,0.523625,Very Large (>30%)
00002798.jpg,1000,667,106,332,264,454,False,158,122,19276,1.4992503748125936,158,122,19276,1.2950819672131149,Medium,185.0,393.0,0.185,0.5892053973013494,middle-left,667000,0.028899550224887556,Small (1-5%)
00002798.jpg,1000,667,577,288,735,410,False,158,122,19276,1.4992503748125936,158,122,19276,1.2950819672131149,Medium,656.0,349.0,0.656,0.5232383808095952,middle-center,667000,0.028899550224887556,Small (1-5%)
00002798.jpg,1000,667,405,316,550,428,False,145,112,16240,1.4992503748125936,145,112,16240,1.2946428571428572,Medium,477.5,372.0,0.4775,0.5577211394302849,middle-center,667000,0.02434782608695652,Small (1-5%)
00002798.jpg,1000,667,263,334,390,435,False,127,101,12827,1.4992503748125936,127,101,12827,1.2574257425742574,Medium,326.5,384.5,0.3265,0.5764617691154422,middle-left,667000,0.01923088455772114,Small (1-5%)
00002798.jpg,1000,667,764,322,918,442,False,154,120,18480,1.4992503748125936,154,120,18480,1.2833333333333334,Medium,841.0,382.0,0.841,0.5727136431784108,middle-right,667000,0.02770614692653673,Small (1-5%)
00002940.jpg,1062,1092,386,360,481,474,False,95,114,10830,0.9725274725274725,95,114,10830,0.8333333333333334,Medium,433.5,417.0,0.4081920903954802,0.38186813186813184,middle-center,1159704,0.009338589847064423,Tiny (<1%)
00002940.jpg,1062,1092,574,361,678,488,False,104,127,13208,0.9725274725274725,104,127,13208,0.8188976377952756,Medium,626.0,424.5,0.5894538606403014,0.38873626373626374,middle-center,1159704,0.011389113084028337,Small (1-5%)
00003486.jpg,236,157,64,24,169,106,False,105,82,8610,1.5031847133757963,105,82,8610,1.2804878048780488,Medium,116.5,65.0,0.4936440677966102,0.4140127388535032,middle-center,37052,0.2323761200475008,Large (15-30%)
00000819.jpg,1024,683,289,20,640,292,False,351,272,95472,1.499267935578331,351,272,95472,1.2904411764705883,Very Large,464.5,156.0,0.45361328125,0.22840409956076135,top-center,699392,0.13650713762811129,Medium (5-15%)
00001332.jpg,600,620,237,2,376,167,False,139,165,22935,0.967741935483871,139,165,22935,0.8424242424242424,Large,306.5,84.5,0.5108333333333334,0.13629032258064516,top-center,372000,0.06165322580645161,Medium (5-15%)
00000992.jpg,1125,750,479,194,694,357,False,215,163,35045,1.5,215,163,35045,1.3190184049079754,Large,586.5,275.5,0.5213333333333333,0.36733333333333335,middle-center,843750,0.041534814814814816,Small (1-5%)
00003243.jpg,500,488,157,284,215,350,False,58,66,3828,1.0245901639344261,58,66,3828,0.8787878787878788,Small,186.0,317.0,0.372,0.6495901639344263,middle-center,244000,0.015688524590163934,Small (1-5%)
00000986.jpg,1600,900,832,488,1380,854,False,548,366,200568,1.7777777777777777,548,366,200568,1.4972677595628416,Very Large,1106.0,671.0,0.69125,0.7455555555555555,bottom-right,1440000,0.13928333333333334,Medium (5-15%)
00000986.jpg,1600,900,158,347,786,748,False,628,401,251828,1.7777777777777777,628,401,251828,1.5660847880299251,Very Large,472.0,547.5,0.295,0.6083333333333333,middle-left,1440000,0.17488055555555557,Large (15-30%)
00001440.jpg,3850,2567,1204,564,2289,1406,False,1085,842,913570,1.4998052201012855,1085,842,913570,1.2885985748218527,Very Large,1746.5,985.0,0.4536363636363636,0.38371640046747174,middle-center,9882950,0.09243899847717534,Medium (5-15%)
00001326.jpg,626,417,130,35,303,172,False,173,137,23701,1.501199040767386,173,137,23701,1.2627737226277371,Large,216.5,103.5,0.34584664536741216,0.24820143884892087,top-center,261042,0.09079381861922603,Medium (5-15%)
00002607.jpg,626,417,279,48,456,185,False,177,137,24249,1.501199040767386,177,137,24249,1.2919708029197081,Large,367.5,116.5,0.5870607028753994,0.2793764988009592,top-center,261042,0.09289309766244512,Medium (5-15%)
00002607.jpg,626,417,93,109,281,255,False,188,146,27448,1.501199040767386,188,146,27448,1.2876712328767124,Large,187.0,182.0,0.2987220447284345,0.4364508393285372,middle-left,261042,0.1051478306172953,Medium (5-15%)
00002607.jpg,626,417,368,144,560,293,False,192,149,28608,1.501199040767386,192,149,28608,1.2885906040268456,Large,464.0,218.5,0.7412140575079872,0.5239808153477218,middle-right,261042,0.10959155997885398,Medium (5-15%)
00002607.jpg,626,417,208,177,397,323,False,189,146,27594,1.501199040767386,189,146,27594,1.2945205479452055,Large,302.5,250.0,0.48322683706070285,0.5995203836930456,middle-center,261042,0.1057071275886639,Medium (5-15%)
00002161.jpg,1000,730,70,140,172,227,False,102,87,8874,1.36986301369863,102,87,8874,1.1724137931034482,Medium,121.0,183.5,0.121,0.2513698630136986,top-left,730000,0.012156164383561643,Small (1-5%)
00002161.jpg,1000,730,407,101,505,182,False,98,81,7938,1.36986301369863,98,81,7938,1.2098765432098766,Medium,456.0,141.5,0.456,0.19383561643835617,top-center,730000,0.010873972602739725,Small (1-5%)
00002161.jpg,1000,730,273,283,371,364,False,98,81,7938,1.36986301369863,98,81,7938,1.2098765432098766,Medium,322.0,323.5,0.322,0.44315068493150683,middle-left,730000,0.010873972602739725,Small (1-5%)
00001468.jpg,600,419,276,55,589,309,False,313,254,79502,1.431980906921241,313,254,79502,1.2322834645669292,Very Large,432.5,182.0,0.7208333333333333,0.4343675417661098,middle-right,251400,0.3162370723945903,Very Large (>30%)
00000762.jpg,800,583,482,22,622,141,False,140,119,16660,1.3722126929674099,140,119,16660,1.1764705882352942,Medium,552.0,81.5,0.69,0.13979416809605488,top-right,466400,0.03572041166380789,Small (1-5%)
00002613.jpg,2000,1333,369,324,984,800,False,615,476,292740,1.5003750937734435,615,476,292740,1.2920168067226891,Very Large,676.5,562.0,0.33825,0.4216054013503376,middle-center,2666000,0.10980495123780945,Medium (5-15%)
00002613.jpg,2000,1333,876,381,1465,838,False,589,457,269173,1.5003750937734435,589,457,269173,1.288840262582057,Very Large,1170.5,609.5,0.58525,0.45723930982745686,middle-center,2666000,0.10096511627906976,Medium (5-15%)
00000004.jpg,1000,1241,476,177,588,335,False,112,158,17696,0.8058017727639001,112,158,17696,0.7088607594936709,Medium,532.0,256.0,0.532,0.2062852538275584,top-center,1241000,0.014259468170829976,Small (1-5%)
00000789.jpg,2000,3019,735,296,1171,1062,False,436,766,333976,0.6624710168930109,436,766,333976,0.5691906005221932,Very Large,953.0,679.0,0.4765,0.2249089102351772,top-center,6038000,0.055312355084465054,Medium (5-15%)
00000951.jpg,1356,1681,376,164,619,516,False,243,352,85536,0.8066627007733492,243,352,85536,0.6903409090909091,Very Large,497.5,340.0,0.3668879056047198,0.20226055919095776,top-center,2279436,0.03752507199149263,Small (1-5%)
00001497.jpg,600,336,125,26,344,172,False,219,146,31974,1.7857142857142858,219,146,31974,1.5,Large,234.5,99.0,0.3908333333333333,0.29464285714285715,top-center,201600,0.15860119047619048,Large (15-30%)
00001483.jpg,960,580,156,4,860,489,False,704,485,341440,1.6551724137931034,704,485,341440,1.4515463917525773,Very Large,508.0,246.5,0.5291666666666667,0.425,middle-center,556800,0.6132183908045977,Very Large (>30%)
00002808.jpg,500,333,179,59,336,183,False,157,124,19468,1.5015015015015014,157,124,19468,1.2661290322580645,Medium,257.5,121.0,0.515,0.3633633633633634,middle-center,166500,0.11692492492492493,Medium (5-15%)
00003041.jpg,800,533,312,64,639,323,False,327,259,84693,1.5009380863039399,327,259,84693,1.2625482625482625,Very Large,475.5,193.5,0.594375,0.3630393996247655,middle-center,426400,0.1986233583489681,Large (15-30%)
00003041.jpg,800,533,145,149,444,376,False,299,227,67873,1.5009380863039399,299,227,67873,1.3171806167400881,Very Large,294.5,262.5,0.368125,0.4924953095684803,middle-center,426400,0.15917682926829269,Large (15-30%)
00000548.jpg,508,339,395,100,506,188,False,111,88,9768,1.4985250737463127,111,88,9768,1.2613636363636365,Medium,450.5,144.0,0.8868110236220472,0.4247787610619469,middle-right,172212,0.056720786007943697,Medium (5-15%)
00000548.jpg,508,339,78,1,179,76,False,101,75,7575,1.4985250737463127,101,75,7575,1.3466666666666667,Medium,128.5,38.5,0.2529527559055118,0.11356932153392331,top-left,172212,0.043986481778273294,Small (1-5%)
00000548.jpg,508,339,389,16,499,102,False,110,86,9460,1.4985250737463127,110,86,9460,1.2790697674418605,Medium,444.0,59.0,0.8740157480314961,0.17404129793510326,top-right,172212,0.05493229275544097,Medium (5-15%)
00000548.jpg,508,339,141,67,267,164,False,126,97,12222,1.4985250737463127,126,97,12222,1.2989690721649485,Medium,204.0,115.5,0.4015748031496063,0.3407079646017699,middle-center,172212,0.07097066406522194,Medium (5-15%)
00000548.jpg,508,339,268,2,381,86,False,113,84,9492,1.4985250737463127,113,84,9492,1.3452380952380953,Medium,324.5,44.0,0.6387795275590551,0.12979351032448377,top-center,172212,0.05511811023622047,Medium (5-15%)
00000548.jpg,508,339,239,90,347,174,False,108,84,9072,1.4985250737463127,108,84,9072,1.2857142857142858,Medium,293.0,132.0,0.5767716535433071,0.3893805309734513,middle-center,172212,0.05267925580098948,Medium (5-15%)
00000548.jpg,508,339,2,35,130,159,False,128,124,15872,1.4985250737463127,128,124,15872,1.032258064516129,Medium,66.0,97.0,0.12992125984251968,0.2861356932153392,top-left,172212,0.09216547046663415,Medium (5-15%)
00000548.jpg,508,339,199,1,305,69,False,106,68,7208,1.4985250737463127,106,68,7208,1.5588235294117647,Medium,252.0,35.0,0.49606299212598426,0.10324483775811209,top-center,172212,0.04185538754558335,Small (1-5%)
00001656.jpg,650,433,329,16,443,105,False,114,89,10146,1.5011547344110854,114,89,10146,1.2808988764044944,Medium,386.0,60.5,0.5938461538461538,0.1397228637413395,top-center,281450,0.036049031799609166,Small (1-5%)
00001130.jpg,867,1300,131,1,442,422,False,311,421,130931,0.666923076923077,311,421,130931,0.7387173396674585,Very Large,286.5,211.5,0.3304498269896194,0.1626923076923077,top-center,1127100,0.11616626741194215,Medium (5-15%)
00001124.jpg,500,333,81,1,412,183,False,331,182,60242,1.5015015015015014,331,182,60242,1.8186813186813187,Very Large,246.5,92.0,0.493,0.27627627627627627,top-center,166500,0.36181381381381383,Very Large (>30%)
00001642.jpg,1125,750,452,219,677,393,False,225,174,39150,1.5,225,174,39150,1.293103448275862,Large,564.5,306.0,0.5017777777777778,0.408,middle-center,843750,0.0464,Small (1-5%)
00003055.jpg,1300,957,191,187,527,475,False,336,288,96768,1.3584117032392895,336,288,96768,1.1666666666666667,Very Large,359.0,331.0,0.27615384615384614,0.3458725182863114,middle-left,1244100,0.07778152881601158,Medium (5-15%)
00003055.jpg,1300,957,689,162,979,416,False,290,254,73660,1.3584117032392895,290,254,73660,1.141732283464567,Very Large,834.0,289.0,0.6415384615384615,0.3019853709508882,top-center,1244100,0.05920745920745921,Medium (5-15%)
00002405.jpg,2048,1365,1266,105,1634,397,False,368,292,107456,1.5003663003663004,368,292,107456,1.2602739726027397,Very Large,1450.0,251.0,0.7080078125,0.1838827838827839,top-right,2795520,0.03843864468864469,Small (1-5%)
00000206.jpg,1000,667,527,87,803,296,False,276,209,57684,1.4992503748125936,276,209,57684,1.3205741626794258,Very Large,665.0,191.5,0.665,0.2871064467766117,top-center,667000,0.08648275862068966,Medium (5-15%)
00002411.jpg,840,560,470,76,678,237,False,208,161,33488,1.5,208,161,33488,1.2919254658385093,Large,574.0,156.5,0.6833333333333333,0.2794642857142857,top-right,470400,0.07119047619047619,Medium (5-15%)
00003069.jpg,1023,713,224,319,483,529,False,259,210,54390,1.434782608695652,259,210,54390,1.2333333333333334,Very Large,353.5,424.0,0.3455522971652004,0.5946704067321178,middle-center,729399,0.07456824042807846,Medium (5-15%)
00003069.jpg,1023,713,62,302,276,472,False,214,170,36380,1.434782608695652,214,170,36380,1.2588235294117647,Large,169.0,387.0,0.1652003910068426,0.5427769985974754,middle-left,729399,0.049876679293500537,Small (1-5%)
00003069.jpg,1023,713,415,294,633,467,False,218,173,37714,1.434782608695652,218,173,37714,1.260115606936416,Large,524.0,380.5,0.512218963831867,0.5336605890603086,middle-center,729399,0.05170558226704451,Medium (5-15%)
00003069.jpg,1023,713,566,314,749,460,False,183,146,26718,1.434782608695652,183,146,26718,1.2534246575342465,Large,657.5,387.0,0.6427174975562072,0.5427769985974754,middle-center,729399,0.0366301571567825,Small (1-5%)
00003069.jpg,1023,713,664,428,844,573,False,180,145,26100,1.434782608695652,180,145,26100,1.2413793103448276,Large,754.0,500.5,0.7370478983382209,0.7019635343618513,bottom-right,729399,0.035782884264990766,Small (1-5%)
00003069.jpg,1023,713,722,315,993,539,False,271,224,60704,1.434782608695652,271,224,60704,1.2098214285714286,Very Large,857.5,427.0,0.8382209188660802,0.5988779803646563,middle-right,729399,0.08322468223839079,Medium (5-15%)
00003069.jpg,1023,713,1,364,139,513,False,138,149,20562,1.434782608695652,138,149,20562,0.9261744966442953,Large,70.0,438.5,0.06842619745845552,0.615007012622721,middle-left,729399,0.02819033204048813,Small (1-5%)
00003069.jpg,1023,713,859,328,1017,505,False,158,177,27966,1.434782608695652,158,177,27966,0.8926553672316384,Large,938.0,416.5,0.916911045943304,0.5841514726507714,middle-right,729399,0.03834115484117746,Small (1-5%)
00000560.jpg,1500,1001,769,81,1271,464,False,502,383,192266,1.4985014985014986,502,383,192266,1.3107049608355092,Very Large,1020.0,272.5,0.68,0.2722277722277722,top-right,1501500,0.12804928404928406,Medium (5-15%)
00000560.jpg,1500,1001,335,244,1082,810,False,747,566,422802,1.4985014985014986,747,566,422802,1.3197879858657244,Very Large,708.5,527.0,0.4723333333333333,0.5264735264735265,middle-center,1501500,0.28158641358641356,Large (15-30%)
00000560.jpg,1500,1001,417,50,814,351,False,397,301,119497,1.4985014985014986,397,301,119497,1.318936877076412,Very Large,615.5,200.5,0.4103333333333333,0.2002997002997003,top-center,1501500,0.07958508158508158,Medium (5-15%)
00000560.jpg,1500,1001,1,22,477,497,False,476,475,226100,1.4985014985014986,476,475,226100,1.0021052631578948,Very Large,239.0,259.5,0.15933333333333333,0.25924075924075923,top-left,1501500,0.15058275058275059,Large (15-30%)
00000560.jpg,1500,1001,1038,61,1499,590,False,461,529,243869,1.4985014985014986,461,529,243869,0.8714555765595463,Very Large,1268.5,325.5,0.8456666666666667,0.32517482517482516,top-right,1501500,0.1624169164169164,Large (15-30%)
00001695.jpg,323,254,98,62,211,166,False,113,104,11752,1.2716535433070866,113,104,11752,1.0865384615384615,Medium,154.5,114.0,0.47832817337461303,0.44881889763779526,middle-center,82042,0.14324370444406523,Medium (5-15%)
00001681.jpg,626,417,250,48,386,156,False,136,108,14688,1.501199040767386,136,108,14688,1.2592592592592593,Medium,318.0,102.0,0.5079872204472844,0.2446043165467626,top-center,261042,0.05626680764014986,Medium (5-15%)
00001859.jpg,678,1024,313,126,397,274,False,84,148,12432,0.662109375,84,148,12432,0.5675675675675675,Medium,355.0,200.0,0.523598820058997,0.1953125,top-center,694272,0.017906526548672565,Small (1-5%)
00001871.jpg,390,280,127,33,273,152,False,146,119,17374,1.3928571428571428,146,119,17374,1.226890756302521,Medium,200.0,92.5,0.5128205128205128,0.33035714285714285,middle-center,109200,0.1591025641025641,Large (15-30%)
00001865.jpg,1050,700,335,26,827,408,False,492,382,187944,1.5,492,382,187944,1.287958115183246,Very Large,581.0,217.0,0.5533333333333333,0.31,top-center,735000,0.2557061224489796,Large (15-30%)
00001864.jpg,1300,866,476,81,606,182,False,130,101,13130,1.5011547344110854,130,101,13130,1.2871287128712872,Medium,541.0,131.5,0.41615384615384615,0.15184757505773672,top-center,1125800,0.011662817551963049,Small (1-5%)
00001870.jpg,676,1023,103,44,434,614,False,331,570,188670,0.6608015640273704,331,570,188670,0.5807017543859649,Very Large,268.5,329.0,0.39718934911242604,0.32160312805474095,top-center,691548,0.2728227107879713,Large (15-30%)
00001858.jpg,1600,1156,890,74,1286,407,False,396,333,131868,1.3840830449826989,396,333,131868,1.1891891891891893,Very Large,1088.0,240.5,0.68,0.20804498269896193,top-right,1849600,0.07129541522491349,Medium (5-15%)
00001680.jpg,600,419,245,43,358,134,False,113,91,10283,1.431980906921241,113,91,10283,1.2417582417582418,Medium,301.5,88.5,0.5025,0.21121718377088305,top-center,251400,0.040902943516308674,Small (1-5%)
00003097.jpg,612,408,420,149,522,229,False,102,80,8160,1.5,102,80,8160,1.275,Medium,471.0,189.0,0.7696078431372549,0.4632352941176471,middle-right,249696,0.032679738562091505,Small (1-5%)
00003097.jpg,612,408,295,66,434,175,False,139,109,15151,1.5,139,109,15151,1.275229357798165,Medium,364.5,120.5,0.5955882352941176,0.29534313725490197,top-center,249696,0.060677784185569655,Medium (5-15%)
00003097.jpg,612,408,403,87,508,167,False,105,80,8400,1.5,105,80,8400,1.3125,Medium,455.5,127.0,0.744281045751634,0.3112745098039216,top-right,249696,0.03364090734332949,Small (1-5%)
00003083.jpg,1000,1500,379,207,490,402,False,111,195,21645,0.6666666666666666,111,195,21645,0.5692307692307692,Large,434.5,304.5,0.4345,0.203,top-center,1500000,0.01443,Small (1-5%)
00001694.jpg,319,450,109,27,182,146,False,73,119,8687,0.7088888888888889,73,119,8687,0.6134453781512605,Medium,145.5,86.5,0.4561128526645768,0.1922222222222222,top-center,143550,0.06051549982584465,Medium (5-15%)
00000207.jpg,1024,682,639,136,758,228,False,119,92,10948,1.501466275659824,119,92,10948,1.2934782608695652,Medium,698.5,182.0,0.68212890625,0.2668621700879765,top-right,698368,0.01567654875366569,Small (1-5%)
00001119.jpg,400,600,133,1,238,176,False,105,175,18375,0.6666666666666666,105,175,18375,0.6,Medium,185.5,88.5,0.46375,0.1475,top-center,240000,0.0765625,Medium (5-15%)
00000561.jpg,8192,5461,3976,2375,5544,3592,False,1568,1217,1908256,1.5000915583226515,1568,1217,1908256,1.2884141331142154,Very Large,4760.0,2983.5,0.5810546875,0.5463285112616737,middle-center,44736512,0.0426554488646768,Small (1-5%)
00000561.jpg,8192,5461,5212,2211,6815,3455,False,1603,1244,1994132,1.5000915583226515,1603,1244,1994132,1.2885852090032155,Very Large,6013.5,2833.0,0.73406982421875,0.5187694561435634,middle-right,44736512,0.04457504420550266,Small (1-5%)
00000561.jpg,8192,5461,3189,1596,4567,2665,False,1378,1069,1473082,1.5000915583226515,1378,1069,1473082,1.2890551917680075,Very Large,3878.0,2130.5,0.473388671875,0.3901300128181652,middle-center,44736512,0.03292795826371086,Small (1-5%)
00000561.jpg,8192,5461,2145,1749,3748,2993,False,1603,1244,1994132,1.5000915583226515,1603,1244,1994132,1.2885852090032155,Very Large,2946.5,2371.0,0.35968017578125,0.4341695660135506,middle-center,44736512,0.04457504420550266,Small (1-5%)
00003068.jpg,960,640,307,176,658,448,False,351,272,95472,1.5,351,272,95472,1.2904411764705883,Very Large,482.5,312.0,0.5026041666666666,0.4875,middle-center,614400,0.155390625,Large (15-30%)
00002376.jpg,800,547,162,39,741,500,False,579,461,266919,1.4625228519195612,579,461,266919,1.2559652928416485,Very Large,451.5,269.5,0.564375,0.4926873857404022,middle-center,437600,0.6099611517367459,Very Large (>30%)
00000213.jpg,735,490,212,39,499,261,False,287,222,63714,1.5,287,222,63714,1.2927927927927927,Very Large,355.5,150.0,0.48367346938775513,0.30612244897959184,top-center,360150,0.17690962099125365,Large (15-30%)
00001125.jpg,1000,569,381,77,614,231,False,233,154,35882,1.757469244288225,233,154,35882,1.5129870129870129,Large,497.5,154.0,0.4975,0.27065026362038663,top-center,569000,0.06306151142355008,Medium (5-15%)
00003054.jpg,960,720,637,132,792,267,False,155,135,20925,1.3333333333333333,155,135,20925,1.1481481481481481,Large,714.5,199.5,0.7442708333333333,0.27708333333333335,top-right,691200,0.0302734375,Small (1-5%)
00003054.jpg,960,720,168,277,284,378,False,116,101,11716,1.3333333333333333,116,101,11716,1.1485148514851484,Medium,226.0,327.5,0.23541666666666666,0.4548611111111111,middle-left,691200,0.016950231481481483,Small (1-5%)
00001643.jpg,1300,970,761,224,1005,435,False,244,211,51484,1.3402061855670102,244,211,51484,1.1563981042654028,Very Large,883.0,329.5,0.6792307692307692,0.33969072164948455,middle-right,1261000,0.04082791435368755,Small (1-5%)
00001643.jpg,1300,970,238,274,456,464,False,218,190,41420,1.3402061855670102,218,190,41420,1.1473684210526316,Large,347.0,369.0,0.26692307692307693,0.3804123711340206,middle-left,1261000,0.032846946867565424,Small (1-5%)
00001643.jpg,1300,970,456,193,700,400,False,244,207,50508,1.3402061855670102,244,207,50508,1.178743961352657,Very Large,578.0,296.5,0.44461538461538463,0.30567010309278353,top-center,1261000,0.040053925455987315,Small (1-5%)
00001657.jpg,1500,1101,739,240,1081,538,False,342,298,101916,1.3623978201634876,342,298,101916,1.1476510067114094,Very Large,910.0,389.0,0.6066666666666667,0.3533151680290645,middle-center,1651500,0.06171117166212534,Medium (5-15%)
00000549.jpg,626,415,90,148,229,256,False,139,108,15012,1.508433734939759,139,108,15012,1.287037037037037,Medium,159.5,202.0,0.2547923322683706,0.4867469879518072,middle-left,259790,0.057785134146810885,Medium (5-15%)
00000549.jpg,626,415,348,169,517,299,False,169,130,21970,1.508433734939759,169,130,21970,1.3,Large,432.5,234.0,0.6908945686900958,0.563855421686747,middle-right,259790,0.08456830516956003,Medium (5-15%)
00000549.jpg,626,415,203,144,364,266,False,161,122,19642,1.508433734939759,161,122,19642,1.319672131147541,Medium,283.5,205.0,0.4528753993610224,0.4939759036144578,middle-center,259790,0.07560722121713692,Medium (5-15%)
00000549.jpg,626,415,432,120,624,289,False,192,169,32448,1.508433734939759,192,169,32448,1.136094674556213,Large,528.0,204.5,0.8434504792332268,0.4927710843373494,middle-right,259790,0.12490088148119635,Medium (5-15%)
00002438.jpg,1400,1750,642,320,776,519,False,134,199,26666,0.8,134,199,26666,0.6733668341708543,Large,709.0,419.5,0.5064285714285715,0.2397142857142857,top-center,2450000,0.01088408163265306,Small (1-5%)
00001131.jpg,366,540,99,34,258,301,False,159,267,42453,0.6777777777777778,159,267,42453,0.5955056179775281,Large,178.5,167.5,0.48770491803278687,0.3101851851851852,top-center,197640,0.21479963570127505,Large (15-30%)
00003295.jpg,612,361,356,65,575,219,False,219,154,33726,1.6952908587257618,219,154,33726,1.422077922077922,Large,465.5,142.0,0.7606209150326797,0.39335180055401664,middle-right,220932,0.15265330508934877,Large (15-30%)
00003295.jpg,612,361,15,35,240,190,False,225,155,34875,1.6952908587257618,225,155,34875,1.4516129032258065,Large,127.5,112.5,0.20833333333333334,0.31163434903047094,top-left,220932,0.15785400032589214,Large (15-30%)
00003295.jpg,612,361,119,46,368,213,False,249,167,41583,1.6952908587257618,249,167,41583,1.4910179640718564,Large,243.5,129.5,0.397875816993464,0.3587257617728532,middle-center,220932,0.18821628374341426,Large (15-30%)
00003295.jpg,612,361,253,142,433,266,False,180,124,22320,1.6952908587257618,180,124,22320,1.4516129032258065,Large,343.0,204.0,0.5604575163398693,0.5650969529085873,middle-center,220932,0.10102656020857097,Medium (5-15%)
00001482.jpg,770,513,254,21,467,190,False,213,169,35997,1.5009746588693957,213,169,35997,1.2603550295857988,Large,360.5,105.5,0.4681818181818182,0.20565302144249512,top-center,395010,0.09112933849775955,Medium (5-15%)
00001482.jpg,770,513,497,147,692,298,False,195,151,29445,1.5009746588693957,195,151,29445,1.2913907284768211,Large,594.5,222.5,0.772077922077922,0.4337231968810916,middle-right,395010,0.0745424166476798,Medium (5-15%)
00000944.jpg,866,1390,431,78,564,328,False,133,250,33250,0.6230215827338129,133,250,33250,0.532,Large,497.5,203.0,0.5744803695150116,0.1460431654676259,top-center,1203740,0.027622244006180737,Small (1-5%)
00002821.jpg,2500,1667,1266,393,1835,826,False,569,433,246377,1.4997000599880024,569,433,246377,1.3140877598152425,Very Large,1550.5,609.5,0.6202,0.365626874625075,middle-center,4167500,0.05911865626874625,Medium (5-15%)
00002821.jpg,2500,1667,610,266,1144,671,False,534,405,216270,1.4997000599880024,534,405,216270,1.3185185185185184,Very Large,877.0,468.5,0.3508,0.28104379124175166,top-center,4167500,0.05189442111577684,Medium (5-15%)
00000788.jpg,590,788,252,67,358,232,False,106,165,17490,0.748730964467005,106,165,17490,0.6424242424242425,Medium,305.0,149.5,0.5169491525423728,0.18972081218274112,top-center,464920,0.037619375376408845,Small (1-5%)
00002174.jpg,1067,1390,280,429,455,689,False,175,260,45500,0.7676258992805756,175,260,45500,0.6730769230769231,Large,367.5,559.0,0.3444236176194939,0.40215827338129495,middle-center,1483130,0.030678362651959033,Small (1-5%)
00000763.jpg,955,1300,234,170,492,578,False,258,408,105264,0.7346153846153847,258,408,105264,0.6323529411764706,Very Large,363.0,374.0,0.38010471204188484,0.2876923076923077,top-center,1241500,0.08478775674587193,Medium (5-15%)
00000005.jpg,1300,957,811,171,976,313,False,165,142,23430,1.3584117032392895,165,142,23430,1.1619718309859155,Large,893.5,242.0,0.6873076923076923,0.25287356321839083,top-right,1244100,0.01883289124668435,Small (1-5%)
00002606.jpg,640,480,334,75,410,142,False,76,67,5092,1.3333333333333333,76,67,5092,1.1343283582089552,Medium,372.0,108.5,0.58125,0.22604166666666667,top-center,307200,0.016575520833333333,Small (1-5%)
00002606.jpg,640,480,203,96,269,154,False,66,58,3828,1.3333333333333333,66,58,3828,1.1379310344827587,Small,236.0,125.0,0.36875,0.2604166666666667,top-center,307200,0.0124609375,Small (1-5%)
00002606.jpg,640,480,505,105,604,191,False,99,86,8514,1.3333333333333333,99,86,8514,1.1511627906976745,Medium,554.5,148.0,0.86640625,0.30833333333333335,top-right,307200,0.02771484375,Small (1-5%)
00000011.jpg,4256,2832,1481,830,2110,1317,False,629,487,306323,1.502824858757062,629,487,306323,1.2915811088295688,Very Large,1795.5,1073.5,0.421875,0.3790607344632768,middle-center,12052992,0.025414685415870185,Small (1-5%)
00000777.jpg,1024,683,312,98,678,389,False,366,291,106506,1.499267935578331,366,291,106506,1.2577319587628866,Very Large,495.0,243.5,0.4833984375,0.35651537335285505,middle-center,699392,0.15228369784040996,Large (15-30%)
00001469.jpg,700,1050,353,35,438,183,False,85,148,12580,0.6666666666666666,85,148,12580,0.5743243243243243,Medium,395.5,109.0,0.565,0.10380952380952381,top-center,735000,0.0171156462585034,Small (1-5%)
00002160.jpg,699,1050,192,331,442,768,False,250,437,109250,0.6657142857142857,250,437,109250,0.5720823798627003,Very Large,317.0,549.5,0.45350500715307585,0.5233333333333333,middle-center,733950,0.1488521016418012,Medium (5-15%)
00001441.jpg,1470,980,496,62,938,405,False,442,343,151606,1.5,442,343,151606,1.2886297376093294,Very Large,717.0,233.5,0.48775510204081635,0.23826530612244898,top-center,1440600,0.10523809523809524,Medium (5-15%)
00000987.jpg,683,1023,297,42,442,296,False,145,254,36830,0.667644183773216,145,254,36830,0.5708661417322834,Large,369.5,169.0,0.54099560761347,0.1652003910068426,top-center,698709,0.052711500782156806,Medium (5-15%)
00003256.jpg,1024,1024,324,382,674,782,False,350,400,140000,1.0,350,400,140000,0.875,Very Large,499.0,582.0,0.4873046875,0.568359375,middle-center,1048576,0.133514404296875,Medium (5-15%)
00001327.jpg,1300,1300,355,124,691,515,False,336,391,131376,1.0,336,391,131376,0.8593350383631714,Very Large,523.0,319.5,0.4023076923076923,0.24576923076923077,top-center,1690000,0.07773727810650888,Medium (5-15%)
00001333.jpg,1000,667,602,67,835,248,False,233,181,42173,1.4992503748125936,233,181,42173,1.287292817679558,Large,718.5,157.5,0.7185,0.23613193403298352,top-right,667000,0.06322788605697151,Medium (5-15%)
00001455.jpg,1001,1600,486,248,580,422,False,94,174,16356,0.625625,94,174,16356,0.5402298850574713,Medium,533.0,335.0,0.5324675324675324,0.209375,top-center,1601600,0.010212287712287712,Small (1-5%)
00000993.jpg,1024,682,501,86,844,347,False,343,261,89523,1.501466275659824,343,261,89523,1.314176245210728,Very Large,672.5,216.5,0.65673828125,0.31744868035190615,top-center,698368,0.12818886317815248,Medium (5-15%)
00000993.jpg,1024,682,146,110,489,376,False,343,266,91238,1.501466275659824,343,266,91238,1.2894736842105263,Very Large,317.5,243.0,0.31005859375,0.3563049853372434,middle-left,698368,0.13064458852639296,Medium (5-15%)
00000830.jpg,500,327,210,43,319,126,False,109,83,9047,1.529051987767584,109,83,9047,1.3132530120481927,Medium,264.5,84.5,0.529,0.25840978593272174,top-center,163500,0.05533333333333333,Medium (5-15%)
00003487.jpg,236,236,79,60,132,121,False,53,61,3233,1.0,53,61,3233,0.8688524590163934,Small,105.5,90.5,0.4470338983050847,0.3834745762711864,middle-center,55696,0.05804725653547831,Medium (5-15%)
00002941.jpg,464,700,141,261,224,407,False,83,146,12118,0.6628571428571428,83,146,12118,0.5684931506849316,Medium,182.5,334.0,0.3933189655172414,0.47714285714285715,middle-center,324800,0.03730911330049261,Small (1-5%)
00002799.jpg,800,532,398,255,690,481,False,292,226,65992,1.5037593984962405,292,226,65992,1.2920353982300885,Very Large,544.0,368.0,0.68,0.6917293233082706,bottom-right,425600,0.15505639097744361,Large (15-30%)
00002799.jpg,800,532,148,160,476,419,False,328,259,84952,1.5037593984962405,328,259,84952,1.2664092664092663,Very Large,312.0,289.5,0.39,0.5441729323308271,middle-center,425600,0.19960526315789473,Large (15-30%)
00001284.jpg,1300,863,302,39,646,304,False,344,265,91160,1.5063731170336037,344,265,91160,1.2981132075471697,Very Large,474.0,171.5,0.3646153846153846,0.19872537659327927,top-center,1121900,0.08125501381584811,Medium (5-15%)
00001284.jpg,1300,863,771,41,1100,295,False,329,254,83566,1.5063731170336037,329,254,83566,1.295275590551181,Very Large,935.5,168.0,0.7196153846153847,0.19466975666280417,top-right,1121900,0.07448613958463321,Medium (5-15%)
00000824.jpg,333,519,116,26,194,167,False,78,141,10998,0.6416184971098265,78,141,10998,0.5531914893617021,Medium,155.0,96.5,0.46546546546546547,0.1859344894026975,top-center,172827,0.0636358902254856,Medium (5-15%)
00002000.jpg,640,360,146,42,376,193,False,230,151,34730,1.7777777777777777,230,151,34730,1.5231788079470199,Large,261.0,117.5,0.4078125,0.3263888888888889,top-center,230400,0.15073784722222222,Large (15-30%)
00002000.jpg,640,360,386,80,563,198,False,177,118,20886,1.7777777777777777,177,118,20886,1.5,Large,474.5,139.0,0.74140625,0.3861111111111111,middle-right,230400,0.09065104166666667,Medium (5-15%)
00000617.jpg,1024,683,123,114,328,273,False,205,159,32595,1.499267935578331,205,159,32595,1.2893081761006289,Large,225.5,193.5,0.22021484375,0.28330893118594436,top-left,699392,0.046604765281844804,Small (1-5%)
00000617.jpg,1024,683,717,130,913,282,False,196,152,29792,1.499267935578331,196,152,29792,1.2894736842105263,Large,815.0,206.0,0.7958984375,0.30161054172767204,top-right,699392,0.04259699853587116,Small (1-5%)
00000617.jpg,1024,683,344,3,509,131,False,165,128,21120,1.499267935578331,165,128,21120,1.2890625,Large,426.5,67.0,0.41650390625,0.09809663250366032,top-center,699392,0.03019765739385066,Small (1-5%)
00000617.jpg,1024,683,371,190,666,419,False,295,229,67555,1.499267935578331,295,229,67555,1.2882096069868996,Very Large,518.5,304.5,0.50634765625,0.4458272327964861,middle-center,699392,0.09659103907393851,Medium (5-15%)
00000617.jpg,1024,683,239,51,407,179,False,168,128,21504,1.499267935578331,168,128,21504,1.3125,Large,323.0,115.0,0.3154296875,0.1683748169838946,top-left,699392,0.03074670571010249,Small (1-5%)
00000617.jpg,1024,683,561,30,740,173,False,179,143,25597,1.499267935578331,179,143,25597,1.2517482517482517,Large,650.5,101.5,0.63525390625,0.1486090775988287,top-center,699392,0.03659893164348463,Small (1-5%)
00002766.jpg,2048,1365,751,248,1516,841,False,765,593,453645,1.5003663003663004,765,593,453645,1.2900505902192243,Very Large,1133.5,544.5,0.553466796875,0.3989010989010989,middle-center,2795520,0.1622757125686813,Large (15-30%)
00003478.jpg,236,157,28,3,159,105,False,131,102,13362,1.5031847133757963,131,102,13362,1.2843137254901962,Medium,93.5,54.0,0.3961864406779661,0.34394904458598724,middle-center,37052,0.36062830616430963,Very Large (>30%)
00002772.jpg,866,1390,89,24,539,846,False,450,822,369900,0.6230215827338129,450,822,369900,0.5474452554744526,Very Large,314.0,435.0,0.3625866050808314,0.3129496402877698,top-center,1203740,0.30729227241763174,Very Large (>30%)
00000165.jpg,681,1024,260,202,483,584,False,223,382,85186,0.6650390625,223,382,85186,0.5837696335078534,Very Large,371.5,393.0,0.5455212922173275,0.3837890625,middle-center,697344,0.12215778726138032,Medium (5-15%)
00000603.jpg,1155,648,681,81,1077,340,False,396,259,102564,1.7824074074074074,396,259,102564,1.528957528957529,Very Large,879.0,210.5,0.7610389610389611,0.3248456790123457,top-right,748440,0.13703703703703704,Medium (5-15%)
00000603.jpg,1155,648,492,211,1019,548,False,527,337,177599,1.7824074074074074,527,337,177599,1.5637982195845697,Very Large,755.5,379.5,0.6541125541125541,0.5856481481481481,middle-center,748440,0.23729223451445675,Large (15-30%)
00001535.jpg,333,519,149,1,307,277,False,158,276,43608,0.6416184971098265,158,276,43608,0.572463768115942,Large,228.0,139.0,0.6846846846846847,0.2678227360308285,top-right,172827,0.25232168584769743,Large (15-30%)
00003444.jpg,800,800,400,203,590,425,False,190,222,42180,1.0,190,222,42180,0.8558558558558559,Large,495.0,314.0,0.61875,0.3925,middle-center,640000,0.06590625,Medium (5-15%)
00001253.jpg,626,626,162,151,381,406,False,219,255,55845,1.0,219,255,55845,0.8588235294117647,Very Large,271.5,278.5,0.43370607028753994,0.444888178913738,middle-center,391876,0.14250681337974258,Medium (5-15%)
00000159.jpg,1000,667,259,251,383,347,False,124,96,11904,1.4992503748125936,124,96,11904,1.2916666666666667,Medium,321.0,299.0,0.321,0.4482758620689655,middle-left,667000,0.017847076461769116,Small (1-5%)
00000159.jpg,1000,667,442,153,583,262,False,141,109,15369,1.4992503748125936,141,109,15369,1.2935779816513762,Medium,512.5,207.5,0.5125,0.3110944527736132,top-center,667000,0.02304197901049475,Small (1-5%)
00000159.jpg,1000,667,605,175,731,273,False,126,98,12348,1.4992503748125936,126,98,12348,1.2857142857142858,Medium,668.0,224.0,0.668,0.335832083958021,middle-center,667000,0.018512743628185908,Small (1-5%)
00000159.jpg,1000,667,385,254,533,369,False,148,115,17020,1.4992503748125936,148,115,17020,1.2869565217391303,Medium,459.0,311.5,0.459,0.46701649175412296,middle-center,667000,0.025517241379310347,Small (1-5%)
00001247.jpg,800,551,271,100,527,306,False,256,206,52736,1.4519056261343013,256,206,52736,1.2427184466019416,Very Large,399.0,203.0,0.49875,0.3684210526315789,middle-center,440800,0.11963702359346642,Medium (5-15%)
00003450.jpg,236,353,112,143,141,194,False,29,51,1479,0.6685552407932012,29,51,1479,0.5686274509803921,Small,126.5,168.5,0.5360169491525424,0.4773371104815864,middle-center,83308,0.01775339703269794,Small (1-5%)
00003450.jpg,236,353,182,162,211,213,False,29,51,1479,0.6685552407932012,29,51,1479,0.5686274509803921,Small,196.5,187.5,0.8326271186440678,0.5311614730878187,middle-right,83308,0.01775339703269794,Small (1-5%)
00003336.jpg,1186,750,459,184,729,382,False,270,198,53460,1.5813333333333333,270,198,53460,1.3636363636363635,Very Large,594.0,283.0,0.5008431703204047,0.37733333333333335,middle-center,889500,0.060101180438448566,Medium (5-15%)
00002028.jpg,1581,1054,637,87,1113,455,False,476,368,175168,1.5,476,368,175168,1.2934782608695652,Very Large,875.0,271.0,0.5534471853257432,0.2571157495256167,top-center,1666374,0.10511925894187019,Medium (5-15%)
00001910.jpg,598,900,171,70,426,518,False,255,448,114240,0.6644444444444444,255,448,114240,0.5691964285714286,Very Large,298.5,294.0,0.4991638795986622,0.32666666666666666,top-center,538200,0.21226309921962097,Large (15-30%)
00001904.jpg,866,1390,96,107,517,878,False,421,771,324591,0.6230215827338129,421,771,324591,0.5460440985732814,Very Large,306.5,492.5,0.3539260969976905,0.35431654676258995,middle-center,1203740,0.2696520843371492,Large (15-30%)
00001092.jpg,600,420,277,48,466,199,False,189,151,28539,1.4285714285714286,189,151,28539,1.2516556291390728,Large,371.5,123.5,0.6191666666666666,0.29404761904761906,top-center,252000,0.11325,Medium (5-15%)
00001938.jpg,360,254,61,17,241,162,False,180,145,26100,1.4173228346456692,180,145,26100,1.2413793103448276,Large,151.0,89.5,0.41944444444444445,0.35236220472440943,middle-center,91440,0.2854330708661417,Large (15-30%)
00001086.jpg,800,582,203,194,343,313,False,140,119,16660,1.3745704467353952,140,119,16660,1.1764705882352942,Medium,273.0,253.5,0.34125,0.43556701030927836,middle-center,465600,0.035781786941580754,Small (1-5%)
00002564.jpg,464,600,150,158,256,317,False,106,159,16854,0.7733333333333333,106,159,16854,0.6666666666666666,Medium,203.0,237.5,0.4375,0.3958333333333333,middle-center,278400,0.06053879310344828,Medium (5-15%)
00002202.jpg,800,475,425,112,522,181,False,97,69,6693,1.6842105263157894,97,69,6693,1.4057971014492754,Medium,473.5,146.5,0.591875,0.30842105263157893,top-center,380000,0.01761315789473684,Small (1-5%)
00003108.jpg,504,483,280,233,355,314,False,75,81,6075,1.0434782608695652,75,81,6075,0.9259259259259259,Medium,317.5,273.5,0.6299603174603174,0.5662525879917184,middle-center,243432,0.024955634427684118,Small (1-5%)
00003108.jpg,504,483,97,121,175,207,False,78,86,6708,1.0434782608695652,78,86,6708,0.9069767441860465,Medium,136.0,164.0,0.2698412698412698,0.33954451345755693,middle-left,243432,0.027555949916198363,Small (1-5%)
00003108.jpg,504,483,216,44,287,122,False,71,78,5538,1.0434782608695652,71,78,5538,0.9102564102564102,Medium,251.5,83.0,0.4990079365079365,0.17184265010351968,top-center,243432,0.022749679581977718,Small (1-5%)
00003108.jpg,504,483,351,113,420,190,False,69,77,5313,1.0434782608695652,69,77,5313,0.8961038961038961,Medium,385.5,151.5,0.7648809523809523,0.3136645962732919,top-right,243432,0.021825396825396824,Small (1-5%)
00001079.jpg,866,1390,243,280,445,657,False,202,377,76154,0.6230215827338129,202,377,76154,0.5358090185676393,Very Large,344.0,468.5,0.3972286374133949,0.33705035971223024,middle-center,1203740,0.0632644923322312,Medium (5-15%)
00001051.jpg,1068,1700,448,30,718,530,False,270,500,135000,0.6282352941176471,270,500,135000,0.54,Very Large,583.0,280.0,0.545880149812734,0.16470588235294117,top-center,1815600,0.07435558493060146,Medium (5-15%)
00000429.jpg,600,400,358,136,429,191,False,71,55,3905,1.5,71,55,3905,1.290909090909091,Small,393.5,163.5,0.6558333333333334,0.40875,middle-center,240000,0.016270833333333335,Small (1-5%)
00001737.jpg,1024,774,435,52,689,271,False,254,219,55626,1.322997416020672,254,219,55626,1.1598173515981736,Very Large,562.0,161.5,0.548828125,0.208656330749354,top-center,792576,0.07018380571705427,Medium (5-15%)
00001723.jpg,1024,682,316,22,690,312,False,374,290,108460,1.501466275659824,374,290,108460,1.289655172413793,Very Large,503.0,167.0,0.4912109375,0.24486803519061584,top-center,698368,0.15530493951612903,Large (15-30%)
00001045.jpg,450,315,159,26,355,190,False,196,164,32144,1.4285714285714286,196,164,32144,1.1951219512195121,Large,257.0,108.0,0.5711111111111111,0.34285714285714286,middle-center,141750,0.22676543209876543,Large (15-30%)
00001735.jpg,390,280,106,9,229,112,False,123,103,12669,1.3928571428571428,123,103,12669,1.1941747572815533,Medium,167.5,60.5,0.42948717948717946,0.21607142857142858,top-center,109200,0.11601648351648351,Medium (5-15%)
00001735.jpg,390,280,219,23,350,133,False,131,110,14410,1.3928571428571428,131,110,14410,1.190909090909091,Medium,284.5,78.0,0.7294871794871794,0.2785714285714286,top-right,109200,0.13195970695970696,Medium (5-15%)
00001047.jpg,1300,1298,488,103,809,477,False,321,374,120054,1.0015408320493067,321,374,120054,0.8582887700534759,Very Large,648.5,290.0,0.49884615384615383,0.22342064714946072,top-center,1687400,0.07114732724902216,Medium (5-15%)
00003136.jpg,894,610,329,294,433,377,False,104,83,8632,1.4655737704918033,104,83,8632,1.2530120481927711,Medium,381.0,335.5,0.4261744966442953,0.55,middle-center,545340,0.01582865735137712,Small (1-5%)
00002228.jpg,700,1050,244,67,354,259,False,110,192,21120,0.6666666666666666,110,192,21120,0.5729166666666666,Large,299.0,163.0,0.42714285714285716,0.15523809523809523,top-center,735000,0.02873469387755102,Small (1-5%)
00001721.jpg,600,421,344,156,408,209,False,64,53,3392,1.4251781472684086,64,53,3392,1.2075471698113207,Small,376.0,182.5,0.6266666666666667,0.4334916864608076,middle-center,252600,0.013428345209817893,Small (1-5%)
00001709.jpg,4016,6016,1812,745,2969,2718,False,1157,1973,2282761,0.6675531914893617,1157,1973,2282761,0.5864166244298024,Very Large,2390.5,1731.5,0.5952440239043825,0.2878158244680851,top-center,24160256,0.09448413957203103,Medium (5-15%)
00002566.jpg,680,1019,306,113,383,251,False,77,138,10626,0.6673209028459274,77,138,10626,0.5579710144927537,Medium,344.5,182.0,0.5066176470588235,0.1786064769381747,top-center,692920,0.01533510361946545,Small (1-5%)
00002572.jpg,800,1200,332,39,514,350,False,182,311,56602,0.6666666666666666,182,311,56602,0.5852090032154341,Very Large,423.0,194.5,0.52875,0.16208333333333333,top-center,960000,0.05896041666666667,Medium (5-15%)
00000365.jpg,1000,667,503,65,804,293,False,301,228,68628,1.4992503748125936,301,228,68628,1.3201754385964912,Very Large,653.5,179.0,0.6535,0.2683658170914543,top-center,667000,0.10289055472263868,Medium (5-15%)
00001090.jpg,1039,1300,570,97,685,269,False,115,172,19780,0.7992307692307692,115,172,19780,0.6686046511627907,Medium,627.5,183.0,0.6039461020211742,0.14076923076923076,top-center,1350700,0.01464425853261272,Small (1-5%)
00001084.jpg,390,280,164,16,233,73,False,69,57,3933,1.3928571428571428,69,57,3933,1.2105263157894737,Small,198.5,44.5,0.5089743589743589,0.15892857142857142,top-center,109200,0.03601648351648352,Small (1-5%)
00001912.jpg,1500,1120,434,86,1065,634,False,631,548,345788,1.3392857142857142,631,548,345788,1.1514598540145986,Very Large,749.5,360.0,0.49966666666666665,0.32142857142857145,top-center,1680000,0.20582619047619047,Large (15-30%)
00001906.jpg,683,1024,364,109,510,363,False,146,254,37084,0.6669921875,146,254,37084,0.5748031496062992,Large,437.0,236.0,0.6398243045387995,0.23046875,top-center,699392,0.05302319729136164,Medium (5-15%)
00001251.jpg,779,1000,407,81,492,207,False,85,126,10710,0.779,85,126,10710,0.6746031746031746,Medium,449.5,144.0,0.5770218228498074,0.144,top-center,779000,0.01374839537869063,Small (1-5%)
00002758.jpg,488,488,104,31,242,188,False,138,157,21666,1.0,138,157,21666,0.8789808917197452,Large,173.0,109.5,0.35450819672131145,0.22438524590163936,top-center,238144,0.0909785675893577,Medium (5-15%)
00003320.jpg,640,960,264,312,453,634,False,189,322,60858,0.6666666666666666,189,322,60858,0.5869565217391305,Very Large,358.5,473.0,0.56015625,0.49270833333333336,middle-center,614400,0.099052734375,Medium (5-15%)
00001537.jpg,392,600,146,46,275,275,False,129,229,29541,0.6533333333333333,129,229,29541,0.5633187772925764,Large,210.5,160.5,0.5369897959183674,0.2675,top-center,235200,0.12559948979591837,Medium (5-15%)
00001523.jpg,2000,1333,495,282,1374,963,False,879,681,598599,1.5003750937734435,879,681,598599,1.2907488986784141,Very Large,934.5,622.5,0.46725,0.4669917479369842,middle-center,2666000,0.22453075768942235,Large (15-30%)
00003334.jpg,612,408,90,126,336,317,False,246,191,46986,1.5,246,191,46986,1.287958115183246,Large,213.0,221.5,0.3480392156862745,0.5428921568627451,middle-center,249696,0.1881728181468666,Large (15-30%)
00003452.jpg,236,354,86,87,116,140,False,30,53,1590,0.6666666666666666,30,53,1590,0.5660377358490566,Small,101.0,113.5,0.4279661016949153,0.3206214689265537,top-center,83544,0.019031887388681414,Small (1-5%)
00000615.jpg,1232,821,981,229,1193,394,False,212,165,34980,1.5006090133982948,212,165,34980,1.284848484848485,Large,1087.0,311.5,0.8823051948051948,0.379415347137637,middle-right,1011472,0.0345832608317383,Small (1-5%)
00000615.jpg,1232,821,607,225,809,383,False,202,158,31916,1.5006090133982948,202,158,31916,1.2784810126582278,Large,708.0,304.0,0.5746753246753247,0.3702801461632156,middle-center,1011472,0.031554012370090326,Small (1-5%)
00000615.jpg,1232,821,752,263,930,402,False,178,139,24742,1.5006090133982948,178,139,24742,1.2805755395683454,Large,841.0,332.5,0.6826298701298701,0.4049939098660171,middle-right,1011472,0.024461379059430216,Small (1-5%)
00002002.jpg,1300,956,152,2,996,535,False,844,533,449852,1.3598326359832635,844,533,449852,1.5834896810506567,Very Large,574.0,268.5,0.44153846153846155,0.28085774058577406,top-center,1242800,0.36196652719665273,Very Large (>30%)
00002016.jpg,855,1390,249,193,675,980,False,426,787,335262,0.6151079136690647,426,787,335262,0.5412960609911055,Very Large,462.0,586.5,0.5403508771929825,0.42194244604316544,middle-center,1188450,0.28210021456518997,Large (15-30%)
00003308.jpg,720,1076,387,87,581,425,False,194,338,65572,0.6691449814126395,194,338,65572,0.5739644970414202,Very Large,484.0,256.0,0.6722222222222223,0.2379182156133829,top-right,774720,0.0846396117306898,Medium (5-15%)
00000601.jpg,640,427,254,97,377,192,False,123,95,11685,1.4988290398126465,123,95,11685,1.2947368421052632,Medium,315.5,144.5,0.49296875,0.33840749414519905,middle-center,273280,0.042758343091334895,Small (1-5%)
00000601.jpg,640,427,136,181,273,285,False,137,104,14248,1.4988290398126465,137,104,14248,1.3173076923076923,Medium,204.5,233.0,0.31953125,0.5456674473067916,middle-left,273280,0.052137002341920376,Medium (5-15%)
00000601.jpg,640,427,426,145,559,247,False,133,102,13566,1.4988290398126465,133,102,13566,1.303921568627451,Medium,492.5,196.0,0.76953125,0.45901639344262296,middle-right,273280,0.04964139344262295,Small (1-5%)
00000601.jpg,640,427,194,124,295,201,False,101,77,7777,1.4988290398126465,101,77,7777,1.3116883116883118,Medium,244.5,162.5,0.38203125,0.3805620608899297,middle-center,273280,0.02845799180327869,Small (1-5%)
00000601.jpg,640,427,378,130,479,208,False,101,78,7878,1.4988290398126465,101,78,7878,1.294871794871795,Medium,428.5,169.0,0.66953125,0.3957845433255269,middle-center,273280,0.028827576112412177,Small (1-5%)
00001279.jpg,209,140,75,32,148,90,False,73,58,4234,1.4928571428571429,73,58,4234,1.2586206896551724,Small,111.5,61.0,0.5334928229665071,0.4357142857142857,middle-center,29260,0.14470266575529733,Medium (5-15%)
00002943.jpg,600,419,16,17,348,338,False,332,321,106572,1.431980906921241,332,321,106572,1.0342679127725856,Very Large,182.0,177.5,0.30333333333333334,0.4236276849642005,middle-left,251400,0.4239140811455847,Very Large (>30%)
00002943.jpg,600,419,390,1,600,217,False,210,216,45360,1.431980906921241,210,216,45360,0.9722222222222222,Large,495.0,109.0,0.825,0.26014319809069214,top-right,251400,0.18042959427207636,Large (15-30%)
00002943.jpg,600,419,156,63,476,323,False,320,260,83200,1.431980906921241,320,260,83200,1.2307692307692308,Very Large,316.0,193.0,0.5266666666666666,0.4606205250596659,middle-center,251400,0.3309466984884646,Very Large (>30%)
00000832.jpg,590,887,253,34,371,236,False,118,202,23836,0.6651634723788049,118,202,23836,0.5841584158415841,Large,312.0,135.0,0.5288135593220339,0.15219842164599776,top-center,523330,0.045546786922209696,Small (1-5%)
00000826.jpg,1024,682,368,50,617,243,False,249,193,48057,1.501466275659824,249,193,48057,1.2901554404145077,Large,492.5,146.5,0.48095703125,0.21480938416422288,top-center,698368,0.06881329041422288,Medium (5-15%)
00001286.jpg,1000,668,502,135,690,281,False,188,146,27448,1.4970059880239521,188,146,27448,1.2876712328767124,Large,596.0,208.0,0.596,0.31137724550898205,top-center,668000,0.04108982035928144,Small (1-5%)
00001325.jpg,1300,956,88,1,1198,885,False,1110,884,981240,1.3598326359832635,1110,884,981240,1.255656108597285,Very Large,643.0,443.0,0.4946153846153846,0.46338912133891214,middle-center,1242800,0.7895397489539749,Very Large (>30%)
00003254.jpg,612,408,380,85,456,142,False,76,57,4332,1.5,76,57,4332,1.3333333333333333,Small,418.0,113.5,0.6830065359477124,0.27818627450980393,top-right,249696,0.017349096501345636,Small (1-5%)
00003254.jpg,612,408,460,99,529,152,False,69,53,3657,1.5,69,53,3657,1.3018867924528301,Small,494.5,125.5,0.8080065359477124,0.3075980392156863,top-right,249696,0.014645809304113803,Small (1-5%)
00000985.jpg,2000,3000,938,338,1540,1388,False,602,1050,632100,0.6666666666666666,602,1050,632100,0.5733333333333334,Very Large,1239.0,863.0,0.6195,0.2876666666666667,top-center,6000000,0.10535,Medium (5-15%)
00001443.jpg,1600,1155,866,59,1147,295,False,281,236,66316,1.3852813852813852,281,236,66316,1.1906779661016949,Very Large,1006.5,177.0,0.6290625,0.15324675324675324,top-center,1848000,0.03588528138528139,Small (1-5%)
00001457.jpg,866,1300,283,216,384,388,False,101,172,17372,0.6661538461538462,101,172,17372,0.5872093023255814,Medium,333.5,302.0,0.3851039260969977,0.2323076923076923,top-center,1125800,0.015430804761058802,Small (1-5%)
00003240.jpg,390,280,117,62,251,174,False,134,112,15008,1.3928571428571428,134,112,15008,1.1964285714285714,Medium,184.0,118.0,0.4717948717948718,0.42142857142857143,middle-center,109200,0.13743589743589743,Medium (5-15%)
00003240.jpg,390,280,19,101,127,191,False,108,90,9720,1.3928571428571428,108,90,9720,1.2,Medium,73.0,146.0,0.18717948717948718,0.5214285714285715,middle-left,109200,0.08901098901098901,Medium (5-15%)
00003240.jpg,390,280,207,33,314,123,False,107,90,9630,1.3928571428571428,107,90,9630,1.1888888888888889,Medium,260.5,78.0,0.6679487179487179,0.2785714285714286,top-center,109200,0.08818681318681319,Medium (5-15%)
00002638.jpg,1023,682,560,245,740,385,False,180,140,25200,1.5,180,140,25200,1.2857142857142858,Large,650.0,315.0,0.635386119257087,0.46187683284457476,middle-center,697686,0.036119400417953064,Small (1-5%)
00002610.jpg,1024,682,569,168,699,269,False,130,101,13130,1.501466275659824,130,101,13130,1.2871287128712872,Medium,634.0,218.5,0.619140625,0.32038123167155425,top-center,698368,0.018800975989736072,Small (1-5%)
00002610.jpg,1024,682,198,73,333,176,False,135,103,13905,1.501466275659824,135,103,13905,1.3106796116504855,Medium,265.5,124.5,0.25927734375,0.18255131964809385,top-left,698368,0.019910706103372432,Small (1-5%)
00001319.jpg,333,519,145,46,220,180,False,75,134,10050,0.6416184971098265,75,134,10050,0.5597014925373134,Medium,182.5,113.0,0.5480480480480481,0.21772639691714837,top-center,172827,0.058150636185318266,Medium (5-15%)
00000761.jpg,236,354,101,7,131,59,False,30,52,1560,0.6666666666666666,30,52,1560,0.5769230769230769,Small,116.0,33.0,0.4915254237288136,0.09322033898305085,top-center,83544,0.018672795173800633,Small (1-5%)
00003268.jpg,509,340,300,87,406,169,False,106,82,8692,1.4970588235294118,106,82,8692,1.2926829268292683,Medium,353.0,128.0,0.693516699410609,0.3764705882352941,middle-right,173060,0.050225355368080433,Medium (5-15%)
00002162.jpg,640,480,153,56,569,411,False,416,355,147680,1.3333333333333333,416,355,147680,1.171830985915493,Very Large,361.0,233.5,0.5640625,0.4864583333333333,middle-center,307200,0.48072916666666665,Very Large (>30%)
00000775.jpg,1000,1498,356,570,539,889,False,183,319,58377,0.6675567423230975,183,319,58377,0.5736677115987461,Very Large,447.5,729.5,0.4475,0.4869826435246996,middle-center,1498000,0.03896995994659546,Small (1-5%)
00002604.jpg,1300,956,496,89,923,454,False,427,365,155855,1.3598326359832635,427,365,155855,1.16986301369863,Very Large,709.5,271.5,0.5457692307692308,0.2839958158995816,top-center,1242800,0.1254063405214033,Medium (5-15%)
00002837.jpg,829,580,460,290,583,390,False,123,100,12300,1.4293103448275861,123,100,12300,1.23,Medium,521.5,340.0,0.6290711700844391,0.5862068965517241,middle-center,480820,0.02558129861486627,Small (1-5%)
00002837.jpg,829,580,333,185,476,304,False,143,119,17017,1.4293103448275861,143,119,17017,1.2016806722689075,Medium,404.5,244.5,0.4879372738238842,0.421551724137931,middle-center,480820,0.03539162264464873,Small (1-5%)
00002837.jpg,829,580,605,236,757,360,False,152,124,18848,1.4293103448275861,152,124,18848,1.2258064516129032,Medium,681.0,298.0,0.8214716525934861,0.5137931034482759,middle-right,480820,0.039199700511625975,Small (1-5%)
00001480.jpg,1000,667,342,99,839,494,False,497,395,196315,1.4992503748125936,497,395,196315,1.2582278481012659,Very Large,590.5,296.5,0.5905,0.444527736131934,middle-center,667000,0.2943253373313343,Large (15-30%)
00003297.jpg,735,490,199,81,356,203,False,157,122,19154,1.5,157,122,19154,1.2868852459016393,Medium,277.5,142.0,0.37755102040816324,0.2897959183673469,top-center,360150,0.05318339580730251,Medium (5-15%)
00003297.jpg,735,490,331,115,471,224,False,140,109,15260,1.5,140,109,15260,1.2844036697247707,Medium,401.0,169.5,0.545578231292517,0.34591836734693876,middle-center,360150,0.0423712342079689,Small (1-5%)
00003297.jpg,735,490,421,89,604,231,False,183,142,25986,1.5,183,142,25986,1.2887323943661972,Large,512.5,160.0,0.6972789115646258,0.32653061224489793,top-right,360150,0.07215326947105373,Medium (5-15%)
00003297.jpg,735,490,199,259,340,368,False,141,109,15369,1.5,141,109,15369,1.2935779816513762,Medium,269.5,313.5,0.36666666666666664,0.639795918367347,middle-center,360150,0.042673885880882965,Small (1-5%)
00003297.jpg,735,490,127,85,262,190,False,135,105,14175,1.5,135,105,14175,1.2857142857142858,Medium,194.5,137.5,0.2646258503401361,0.28061224489795916,top-left,360150,0.03935860058309038,Small (1-5%)
00003297.jpg,735,490,486,336,610,432,False,124,96,11904,1.5,124,96,11904,1.2916666666666667,Medium,548.0,384.0,0.745578231292517,0.7836734693877551,bottom-right,360150,0.03305289462723865,Small (1-5%)
00003283.jpg,800,533,388,71,526,178,False,138,107,14766,1.5009380863039399,138,107,14766,1.2897196261682242,Medium,457.0,124.5,0.57125,0.23358348968105067,top-center,426400,0.034629455909943714,Small (1-5%)
00000952.jpg,590,367,180,37,350,160,False,170,123,20910,1.6076294277929155,170,123,20910,1.3821138211382114,Large,265.0,98.5,0.4491525423728814,0.2683923705722071,top-center,216530,0.0965686048122662,Medium (5-15%)
00001494.jpg,450,320,306,21,389,90,False,83,69,5727,1.40625,83,69,5727,1.2028985507246377,Medium,347.5,55.5,0.7722222222222223,0.1734375,top-right,144000,0.03977083333333333,Small (1-5%)
00002823.jpg,504,358,213,154,267,198,False,54,44,2376,1.4078212290502794,54,44,2376,1.2272727272727273,Small,240.0,176.0,0.47619047619047616,0.49162011173184356,middle-center,180432,0.013168395849960097,Small (1-5%)
00002823.jpg,504,358,173,74,235,126,False,62,52,3224,1.4078212290502794,62,52,3224,1.1923076923076923,Small,204.0,100.0,0.40476190476190477,0.27932960893854747,top-center,180432,0.01786822736543407,Small (1-5%)
00002823.jpg,504,358,269,72,330,123,False,61,51,3111,1.4078212290502794,61,51,3111,1.196078431372549,Small,299.5,97.5,0.5942460317460317,0.2723463687150838,top-center,180432,0.01724195264698058,Small (1-5%)
00002823.jpg,504,358,332,160,383,203,False,51,43,2193,1.4078212290502794,51,43,2193,1.186046511627907,Small,357.5,181.5,0.7093253968253969,0.5069832402234636,middle-right,180432,0.012154163341314179,Small (1-5%)
00001899.jpg,1300,957,525,125,933,475,False,408,350,142800,1.3584117032392895,408,350,142800,1.1657142857142857,Very Large,729.0,300.0,0.5607692307692308,0.31347962382445144,top-center,1244100,0.11478176995418375,Medium (5-15%)
00001641.jpg,600,420,238,52,371,160,False,133,108,14364,1.4285714285714286,133,108,14364,1.2314814814814814,Medium,304.5,106.0,0.5075,0.2523809523809524,top-center,252000,0.057,Medium (5-15%)
00002348.jpg,2946,1960,1744,237,2473,801,False,729,564,411156,1.5030612244897958,729,564,411156,1.2925531914893618,Very Large,2108.5,519.0,0.7157162253903598,0.26479591836734695,top-right,5774160,0.07120620142150547,Medium (5-15%)
00003056.jpg,633,1234,194,683,402,1144,False,208,461,95888,0.5129659643435981,208,461,95888,0.4511930585683297,Very Large,298.0,913.5,0.4707740916271722,0.7402755267423015,bottom-center,781122,0.12275675246632409,Medium (5-15%)
00000239.jpg,500,486,117,181,174,245,False,57,64,3648,1.02880658436214,57,64,3648,0.890625,Small,145.5,213.0,0.291,0.4382716049382716,middle-left,243000,0.015012345679012346,Small (1-5%)
00000239.jpg,500,486,217,121,271,181,False,54,60,3240,1.02880658436214,54,60,3240,0.9,Small,244.0,151.0,0.488,0.31069958847736623,top-center,243000,0.013333333333333334,Small (1-5%)
00000239.jpg,500,486,401,129,452,186,False,51,57,2907,1.02880658436214,51,57,2907,0.8947368421052632,Small,426.5,157.5,0.853,0.32407407407407407,top-right,243000,0.011962962962962963,Small (1-5%)
00000239.jpg,500,486,48,126,108,191,False,60,65,3900,1.02880658436214,60,65,3900,0.9230769230769231,Small,78.0,158.5,0.156,0.32613168724279834,top-left,243000,0.016049382716049384,Small (1-5%)
00000239.jpg,500,486,326,141,375,195,False,49,54,2646,1.02880658436214,49,54,2646,0.9074074074074074,Small,350.5,168.0,0.701,0.345679012345679,middle-right,243000,0.010888888888888889,Small (1-5%)
00001133.jpg,533,849,199,1,370,304,False,171,303,51813,0.6277974087161367,171,303,51813,0.5643564356435643,Very Large,284.5,152.5,0.5337711069418386,0.17962308598351,top-center,452517,0.11449956576217026,Medium (5-15%)
00003042.jpg,3072,2304,1294,1,2025,480,False,731,479,350149,1.3333333333333333,731,479,350149,1.5260960334029228,Very Large,1659.5,240.5,0.5402018229166666,0.10438368055555555,top-center,7077888,0.04947083084671586,Small (1-5%)
00001655.jpg,800,533,317,101,568,291,False,251,190,47690,1.5009380863039399,251,190,47690,1.3210526315789475,Large,442.5,196.0,0.553125,0.3677298311444653,middle-center,426400,0.11184333958724203,Medium (5-15%)
00002374.jpg,789,900,579,148,700,306,False,121,158,19118,0.8766666666666667,121,158,19118,0.7658227848101266,Medium,639.5,227.0,0.8105196451204055,0.25222222222222224,top-right,710100,0.0269229685959724,Small (1-5%)
00002374.jpg,789,900,247,163,363,318,False,116,155,17980,0.8766666666666667,116,155,17980,0.7483870967741936,Medium,305.0,240.5,0.3865652724968314,0.26722222222222225,top-center,710100,0.025320377411632164,Small (1-5%)
00000563.jpg,650,433,115,130,239,226,False,124,96,11904,1.5011547344110854,124,96,11904,1.2916666666666667,Medium,177.0,178.0,0.2723076923076923,0.4110854503464203,middle-left,281450,0.042295256706342155,Small (1-5%)
00000563.jpg,650,433,179,42,309,141,False,130,99,12870,1.5011547344110854,130,99,12870,1.3131313131313131,Medium,244.0,91.5,0.37538461538461537,0.2113163972286374,top-center,281450,0.045727482678983834,Small (1-5%)
00000563.jpg,650,433,280,143,404,240,False,124,97,12028,1.5011547344110854,124,97,12028,1.2783505154639174,Medium,342.0,191.5,0.5261538461538462,0.44226327944572746,middle-center,281450,0.04273583229703322,Small (1-5%)
00000563.jpg,650,433,310,229,455,341,False,145,112,16240,1.5011547344110854,145,112,16240,1.2946428571428572,Medium,382.5,285.0,0.5884615384615385,0.6581986143187067,middle-center,281450,0.05770119026470066,Medium (5-15%)
00000205.jpg,800,582,499,92,636,208,False,137,116,15892,1.3745704467353952,137,116,15892,1.1810344827586208,Medium,567.5,150.0,0.709375,0.25773195876288657,top-right,465600,0.034132302405498284,Small (1-5%)
00002412.jpg,1500,1000,139,264,519,559,False,380,295,112100,1.5,380,295,112100,1.2881355932203389,Very Large,329.0,411.5,0.21933333333333332,0.4115,middle-left,1500000,0.07473333333333333,Medium (5-15%)
00002412.jpg,1500,1000,1015,416,1364,682,False,349,266,92834,1.5,349,266,92834,1.3120300751879699,Very Large,1189.5,549.0,0.793,0.549,middle-right,1500000,0.06188933333333333,Medium (5-15%)
00002412.jpg,1500,1000,588,287,959,575,False,371,288,106848,1.5,371,288,106848,1.2881944444444444,Very Large,773.5,431.0,0.5156666666666667,0.431,middle-center,1500000,0.071232,Medium (5-15%)
00002406.jpg,1000,750,754,182,941,346,False,187,164,30668,1.3333333333333333,187,164,30668,1.1402439024390243,Large,847.5,264.0,0.8475,0.352,middle-right,750000,0.040890666666666665,Small (1-5%)
00000211.jpg,534,849,175,202,271,380,False,96,178,17088,0.6289752650176679,96,178,17088,0.5393258426966292,Medium,223.0,291.0,0.41760299625468167,0.34275618374558303,middle-center,453366,0.03769140164899882,Small (1-5%)
00000577.jpg,590,394,420,62,513,134,False,93,72,6696,1.49746192893401,93,72,6696,1.2916666666666667,Medium,466.5,98.0,0.7906779661016949,0.24873096446700507,top-right,232460,0.028804955691301728,Small (1-5%)
00000577.jpg,590,394,7,51,150,162,False,143,111,15873,1.49746192893401,143,111,15873,1.2882882882882882,Medium,78.5,106.5,0.13305084745762713,0.2703045685279188,top-left,232460,0.06828271530585907,Medium (5-15%)
00000577.jpg,590,394,236,104,385,220,False,149,116,17284,1.49746192893401,149,116,17284,1.2844827586206897,Medium,310.5,162.0,0.5262711864406779,0.41116751269035534,middle-center,232460,0.07435257678740428,Medium (5-15%)
00000577.jpg,590,394,342,85,435,157,False,93,72,6696,1.49746192893401,93,72,6696,1.2916666666666667,Medium,388.5,121.0,0.6584745762711864,0.30710659898477155,top-center,232460,0.028804955691301728,Small (1-5%)
00000577.jpg,590,394,185,105,269,170,False,84,65,5460,1.49746192893401,84,65,5460,1.2923076923076924,Medium,227.0,137.5,0.3847457627118644,0.3489847715736041,middle-center,232460,0.023487911898821302,Small (1-5%)
00000577.jpg,590,394,242,74,317,132,False,75,58,4350,1.49746192893401,75,58,4350,1.293103448275862,Small,279.5,103.0,0.47372881355932206,0.2614213197969543,top-center,232460,0.018712896842467523,Small (1-5%)
00001669.jpg,600,900,267,33,343,166,False,76,133,10108,0.6666666666666666,76,133,10108,0.5714285714285714,Medium,305.0,99.5,0.5083333333333333,0.11055555555555556,top-center,540000,0.01871851851851852,Small (1-5%)
00002360.jpg,381,600,150,131,207,234,False,57,103,5871,0.635,57,103,5871,0.5533980582524272,Medium,178.5,182.5,0.468503937007874,0.30416666666666664,top-center,228600,0.02568241469816273,Small (1-5%)
00003095.jpg,1300,959,266,207,762,633,False,496,426,211296,1.3555787278415015,496,426,211296,1.164319248826291,Very Large,514.0,420.0,0.3953846153846154,0.43795620437956206,middle-center,1246700,0.16948423838934787,Large (15-30%)
00001682.jpg,600,900,253,121,331,257,False,78,136,10608,0.6666666666666666,78,136,10608,0.5735294117647058,Medium,292.0,189.0,0.4866666666666667,0.21,top-center,540000,0.019644444444444444,Small (1-5%)
00001696.jpg,390,280,205,22,290,93,False,85,71,6035,1.3928571428571428,85,71,6035,1.1971830985915493,Medium,247.5,57.5,0.6346153846153846,0.20535714285714285,top-center,109200,0.055265567765567764,Medium (5-15%)
00000588.jpg,1800,1200,1244,293,1628,591,False,384,298,114432,1.5,384,298,114432,1.2885906040268456,Very Large,1436.0,442.0,0.7977777777777778,0.36833333333333335,middle-right,2160000,0.052977777777777776,Medium (5-15%)
00003081.jpg,616,823,177,99,483,565,False,306,466,142596,0.7484811664641555,306,466,142596,0.6566523605150214,Very Large,330.0,332.0,0.5357142857142857,0.40340218712029163,middle-center,506968,0.281272190749712,Large (15-30%)
00001866.jpg,1000,1500,427,320,680,752,False,253,432,109296,0.6666666666666666,253,432,109296,0.5856481481481481,Very Large,553.5,536.0,0.5535,0.35733333333333334,middle-center,1500000,0.072864,Medium (5-15%)
00001872.jpg,1300,881,258,23,602,300,False,344,277,95288,1.4755959137343928,344,277,95288,1.2418772563176896,Very Large,430.0,161.5,0.33076923076923076,0.18331441543700341,top-center,1145300,0.0831991617916703,Medium (5-15%)
00001873.jpg,800,582,417,99,658,303,False,241,204,49164,1.3745704467353952,241,204,49164,1.1813725490196079,Large,537.5,201.0,0.671875,0.34536082474226804,middle-right,465600,0.10559278350515464,Medium (5-15%)
00003080.jpg,390,280,14,59,189,202,False,175,143,25025,1.3928571428571428,175,143,25025,1.2237762237762237,Large,101.5,130.5,0.2602564102564103,0.4660714285714286,middle-left,109200,0.22916666666666666,Large (15-30%)
00003080.jpg,390,280,129,61,254,163,False,125,102,12750,1.3928571428571428,125,102,12750,1.2254901960784315,Medium,191.5,112.0,0.491025641025641,0.4,middle-center,109200,0.11675824175824176,Medium (5-15%)
00003080.jpg,390,280,166,1,328,121,False,162,120,19440,1.3928571428571428,162,120,19440,1.35,Medium,247.0,61.0,0.6333333333333333,0.21785714285714286,top-center,109200,0.17802197802197803,Large (15-30%)
00000589.jpg,590,433,53,30,112,81,False,59,51,3009,1.3625866050808315,59,51,3009,1.1568627450980393,Small,82.5,55.5,0.13983050847457626,0.12817551963048499,top-left,255470,0.011778290993071594,Small (1-5%)
00000589.jpg,590,433,360,29,414,75,False,54,46,2484,1.3625866050808315,54,46,2484,1.173913043478261,Small,387.0,52.0,0.6559322033898305,0.12009237875288684,top-center,255470,0.00972325517673308,Tiny (<1%)
00000589.jpg,590,433,478,48,533,95,False,55,47,2585,1.3625866050808315,55,47,2585,1.1702127659574468,Small,505.5,71.5,0.8567796610169491,0.1651270207852194,top-right,255470,0.010118604924257252,Small (1-5%)
00001697.jpg,800,746,1,1,339,371,False,338,370,125060,1.0723860589812333,338,370,125060,0.9135135135135135,Very Large,170.0,186.0,0.2125,0.24932975871313673,top-left,596800,0.2095509383378016,Large (15-30%)
00001668.jpg,626,417,245,45,373,144,False,128,99,12672,1.501199040767386,128,99,12672,1.292929292929293,Medium,309.0,94.5,0.4936102236421725,0.22661870503597123,top-center,261042,0.04854391247385478,Small (1-5%)
00000576.jpg,1500,1120,1005,53,1419,413,False,414,360,149040,1.3392857142857142,414,360,149040,1.15,Very Large,1212.0,233.0,0.808,0.2080357142857143,top-right,1680000,0.08871428571428572,Medium (5-15%)
00000576.jpg,1500,1120,852,349,1476,891,False,624,542,338208,1.3392857142857142,624,542,338208,1.151291512915129,Very Large,1164.0,620.0,0.776,0.5535714285714286,middle-right,1680000,0.20131428571428572,Large (15-30%)
00000576.jpg,1500,1120,602,297,1115,744,False,513,447,229311,1.3392857142857142,513,447,229311,1.1476510067114094,Very Large,858.5,520.5,0.5723333333333334,0.46473214285714287,middle-center,1680000,0.13649464285714286,Medium (5-15%)
00000576.jpg,1500,1120,437,279,953,728,False,516,449,231684,1.3392857142857142,516,449,231684,1.1492204899777283,Very Large,695.0,503.5,0.4633333333333333,0.44955357142857144,middle-center,1680000,0.13790714285714287,Medium (5-15%)
00000576.jpg,1500,1120,279,254,782,691,False,503,437,219811,1.3392857142857142,503,437,219811,1.1510297482837528,Very Large,530.5,472.5,0.3536666666666667,0.421875,middle-center,1680000,0.13083988095238094,Medium (5-15%)
00000576.jpg,1500,1120,95,259,600,759,False,505,500,252500,1.3392857142857142,505,500,252500,1.01,Very Large,347.5,509.0,0.23166666666666666,0.4544642857142857,middle-left,1680000,0.15029761904761904,Large (15-30%)
00000562.jpg,630,343,22,62,233,196,False,211,134,28274,1.836734693877551,211,134,28274,1.5746268656716418,Large,127.5,129.0,0.20238095238095238,0.3760932944606414,middle-left,216090,0.1308436299689944,Medium (5-15%)
00000562.jpg,630,343,310,23,561,182,False,251,159,39909,1.836734693877551,251,159,39909,1.578616352201258,Large,435.5,102.5,0.6912698412698413,0.2988338192419825,top-right,216090,0.18468693599888936,Large (15-30%)
00000562.jpg,630,343,162,80,369,212,False,207,132,27324,1.836734693877551,207,132,27324,1.5681818181818181,Large,265.5,146.0,0.42142857142857143,0.42565597667638483,middle-center,216090,0.1264473136193253,Medium (5-15%)
00000562.jpg,630,343,226,90,452,233,False,226,143,32318,1.836734693877551,226,143,32318,1.5804195804195804,Large,339.0,161.5,0.5380952380952381,0.4708454810495627,middle-center,216090,0.14955805451432275,Medium (5-15%)
00002375.jpg,551,751,161,48,313,289,False,152,241,36632,0.7336884154460719,152,241,36632,0.6307053941908713,Large,237.0,168.5,0.4301270417422868,0.22436750998668442,top-center,413801,0.08852564396896093,Medium (5-15%)
00002413.jpg,3000,2000,1756,307,2219,666,False,463,359,166217,1.5,463,359,166217,1.2896935933147633,Very Large,1987.5,486.5,0.6625,0.24325,top-center,6000000,0.027702833333333333,Small (1-5%)
00000204.jpg,300,470,128,70,163,134,False,35,64,2240,0.6382978723404256,35,64,2240,0.546875,Small,145.5,102.0,0.485,0.2170212765957447,top-center,141000,0.015886524822695036,Small (1-5%)
00001132.jpg,450,347,205,56,369,207,False,164,151,24764,1.2968299711815563,164,151,24764,1.086092715231788,Large,287.0,131.5,0.6377777777777778,0.37896253602305474,middle-center,156150,0.15859109830291387,Large (15-30%)
00003043.jpg,500,333,193,56,371,194,False,178,138,24564,1.5015015015015014,178,138,24564,1.289855072463768,Large,282.0,125.0,0.564,0.37537537537537535,middle-center,166500,0.14753153153153153,Medium (5-15%)
00003057.jpg,227,340,107,92,150,166,False,43,74,3182,0.6676470588235294,43,74,3182,0.581081081081081,Small,128.5,129.0,0.566079295154185,0.37941176470588234,middle-center,77180,0.04122829748639544,Small (1-5%)
00003057.jpg,227,340,81,34,134,126,False,53,92,4876,0.6676470588235294,53,92,4876,0.5760869565217391,Small,107.5,80.0,0.473568281938326,0.23529411764705882,top-center,77180,0.0631769888572169,Medium (5-15%)
00002349.jpg,612,408,163,44,364,203,False,201,159,31959,1.5,201,159,31959,1.2641509433962264,Large,263.5,123.5,0.4305555555555556,0.30269607843137253,top-center,249696,0.12799163783160322,Medium (5-15%)
00000238.jpg,400,600,154,74,225,195,False,71,121,8591,0.6666666666666666,71,121,8591,0.5867768595041323,Medium,189.5,134.5,0.47375,0.22416666666666665,top-center,240000,0.03579583333333333,Small (1-5%)
00000953.jpg,1000,1500,392,123,588,465,False,196,342,67032,0.6666666666666666,196,342,67032,0.5730994152046783,Very Large,490.0,294.0,0.49,0.196,top-center,1500000,0.044688,Small (1-5%)
00002822.jpg,1024,683,621,298,854,479,False,233,181,42173,1.499267935578331,233,181,42173,1.287292817679558,Large,737.5,388.5,0.72021484375,0.568814055636896,middle-right,699392,0.06029951729502196,Medium (5-15%)
00002822.jpg,1024,683,389,304,589,460,False,200,156,31200,1.499267935578331,200,156,31200,1.2820512820512822,Large,489.0,382.0,0.4775390625,0.5592972181551976,middle-center,699392,0.0446101756954612,Small (1-5%)
00002822.jpg,1024,683,248,255,486,440,False,238,185,44030,1.499267935578331,238,185,44030,1.2864864864864864,Large,367.0,347.5,0.3583984375,0.5087847730600292,middle-center,699392,0.06295468063689605,Medium (5-15%)
00002836.jpg,1300,956,460,176,640,330,False,180,154,27720,1.3598326359832635,180,154,27720,1.1688311688311688,Large,550.0,253.0,0.4230769230769231,0.26464435146443516,top-center,1242800,0.022304473768908914,Small (1-5%)
00003296.jpg,612,408,238,177,411,311,False,173,134,23182,1.5,173,134,23182,1.291044776119403,Large,324.5,244.0,0.5302287581699346,0.5980392156862745,middle-center,249696,0.09284089452774574,Medium (5-15%)
00003296.jpg,612,408,80,65,245,190,False,165,125,20625,1.5,165,125,20625,1.32,Large,162.5,127.5,0.26552287581699346,0.3125,top-left,249696,0.08260044213763937,Medium (5-15%)
00003296.jpg,612,408,136,78,291,201,False,155,123,19065,1.5,155,123,19065,1.2601626016260163,Medium,213.5,139.5,0.3488562091503268,0.34191176470588236,middle-center,249696,0.07635284505959246,Medium (5-15%)
00003296.jpg,612,408,408,103,612,285,False,204,182,37128,1.5,204,182,37128,1.120879120879121,Large,510.0,194.0,0.8333333333333334,0.47549019607843135,middle-right,249696,0.14869281045751634,Medium (5-15%)
00001481.jpg,650,433,169,61,344,197,False,175,136,23800,1.5011547344110854,175,136,23800,1.286764705882353,Large,256.5,129.0,0.3946153846153846,0.2979214780600462,top-center,281450,0.08456208918102683,Medium (5-15%)
00000947.jpg,682,1024,317,139,382,253,False,65,114,7410,0.666015625,65,114,7410,0.5701754385964912,Medium,349.5,196.0,0.5124633431085044,0.19140625,top-center,698368,0.010610451796187683,Small (1-5%)
00000774.jpg,736,1104,273,108,405,338,False,132,230,30360,0.6666666666666666,132,230,30360,0.5739130434782609,Large,339.0,223.0,0.46059782608695654,0.20199275362318841,top-center,812544,0.03736413043478261,Small (1-5%)
00002163.jpg,918,1390,372,133,609,551,False,237,418,99066,0.660431654676259,237,418,99066,0.5669856459330144,Very Large,490.5,342.0,0.5343137254901961,0.2460431654676259,top-center,1276020,0.07763671415808529,Medium (5-15%)
00002605.jpg,960,702,300,204,454,339,False,154,135,20790,1.3675213675213675,154,135,20790,1.1407407407407408,Large,377.0,271.5,0.3927083333333333,0.38675213675213677,middle-center,673920,0.030849358974358976,Small (1-5%)
00000012.jpg,600,400,183,73,402,243,False,219,170,37230,1.5,219,170,37230,1.2882352941176471,Large,292.5,158.0,0.4875,0.395,middle-center,240000,0.155125,Large (15-30%)
00000006.jpg,2667,4000,1002,787,1547,1739,False,545,952,518840,0.66675,545,952,518840,0.5724789915966386,Very Large,1274.5,1263.0,0.47787776527934006,0.31575,top-center,10668000,0.04863517060367454,Small (1-5%)
00002611.jpg,466,700,87,96,129,169,False,42,73,3066,0.6657142857142857,42,73,3066,0.5753424657534246,Small,108.0,132.5,0.2317596566523605,0.18928571428571428,top-left,326200,0.009399141630901288,Tiny (<1%)
00002611.jpg,466,700,313,68,358,147,False,45,79,3555,0.6657142857142857,45,79,3555,0.569620253164557,Small,335.5,107.5,0.7199570815450643,0.15357142857142858,top-right,326200,0.010898221949724096,Small (1-5%)
00003269.jpg,612,415,131,118,300,251,False,169,133,22477,1.4746987951807229,169,133,22477,1.2706766917293233,Large,215.5,184.5,0.352124183006536,0.44457831325301206,middle-center,253980,0.08849909441688322,Medium (5-15%)
00000760.jpg,800,533,320,85,571,279,False,251,194,48694,1.5009380863039399,251,194,48694,1.2938144329896908,Large,445.5,182.0,0.556875,0.34146341463414637,middle-center,426400,0.11419793621013133,Medium (5-15%)
00001456.jpg,667,1000,274,47,443,335,False,169,288,48672,0.667,169,288,48672,0.5868055555555556,Large,358.5,191.0,0.5374812593703149,0.191,top-center,667000,0.07297151424287857,Medium (5-15%)
00000990.jpg,612,408,236,27,497,235,False,261,208,54288,1.5,261,208,54288,1.2548076923076923,Very Large,366.5,131.0,0.5988562091503268,0.32107843137254904,top-center,249696,0.2174163783160323,Large (15-30%)
00001330.jpg,800,533,164,28,450,250,False,286,222,63492,1.5009380863039399,286,222,63492,1.2882882882882882,Very Large,307.0,139.0,0.38375,0.2607879924953096,top-center,426400,0.14890243902439024,Medium (5-15%)
00002639.jpg,1500,1219,842,341,980,469,False,138,128,17664,1.2305168170631666,138,128,17664,1.078125,Medium,911.0,405.0,0.6073333333333333,0.33223954060705496,middle-center,1828500,0.009660377358490567,Tiny (<1%)
00001324.jpg,1000,667,454,66,629,203,False,175,137,23975,1.4992503748125936,175,137,23975,1.2773722627737227,Large,541.5,134.5,0.5415,0.20164917541229385,top-center,667000,0.03594452773613194,Small (1-5%)
00001442.jpg,460,374,106,1,445,262,False,339,261,88479,1.2299465240641712,339,261,88479,1.2988505747126438,Very Large,275.5,131.5,0.5989130434782609,0.3516042780748663,middle-center,172040,0.5142931876307836,Very Large (>30%)
00003255.jpg,800,800,113,304,316,539,False,203,235,47705,1.0,203,235,47705,0.8638297872340426,Large,214.5,421.5,0.268125,0.526875,middle-left,640000,0.0745390625,Medium (5-15%)
00000827.jpg,666,440,382,56,547,180,False,165,124,20460,1.5136363636363637,165,124,20460,1.3306451612903225,Large,464.5,118.0,0.6974474474474475,0.2681818181818182,top-right,293040,0.06981981981981981,Medium (5-15%)
00002956.jpg,497,347,174,58,321,176,False,147,118,17346,1.4322766570605188,147,118,17346,1.2457627118644068,Medium,247.5,117.0,0.49798792756539234,0.3371757925072046,middle-center,172459,0.10058042781182774,Medium (5-15%)
00001287.jpg,1600,1167,492,42,1092,551,False,600,509,305400,1.3710368466152527,600,509,305400,1.1787819253438114,Very Large,792.0,296.5,0.495,0.254070265638389,top-center,1867200,0.16356041131105398,Large (15-30%)
00001293.jpg,626,418,195,60,400,223,False,205,163,33415,1.4976076555023923,205,163,33415,1.2576687116564418,Large,297.5,141.5,0.4752396166134185,0.33851674641148327,middle-center,261668,0.12769998624210832,Medium (5-15%)
00003484.jpg,543,810,104,57,465,682,False,361,625,225625,0.6703703703703704,361,625,225625,0.5776,Very Large,284.5,369.5,0.5239410681399632,0.4561728395061728,middle-center,439830,0.512982288611509,Very Large (>30%)
00000833.jpg,533,849,159,133,275,349,False,116,216,25056,0.6277974087161367,116,216,25056,0.5370370370370371,Large,217.0,241.0,0.4071294559099437,0.2838633686690224,top-center,452517,0.05537029548061178,Medium (5-15%)
00003309.jpg,612,408,366,104,499,206,False,133,102,13566,1.5,133,102,13566,1.303921568627451,Medium,432.5,155.0,0.7066993464052288,0.3799019607843137,middle-right,249696,0.054330065359477125,Medium (5-15%)
00003309.jpg,612,408,106,41,330,218,False,224,177,39648,1.5,224,177,39648,1.265536723163842,Large,218.0,129.5,0.3562091503267974,0.3174019607843137,top-center,249696,0.1587850826605152,Large (15-30%)
00002771.jpg,2500,1891,1429,876,1679,1092,False,250,216,54000,1.3220518244315178,250,216,54000,1.1574074074074074,Very Large,1554.0,984.0,0.6216,0.5203595980962453,middle-center,4727500,0.011422527763088313,Small (1-5%)
00002771.jpg,2500,1891,842,666,1103,896,False,261,230,60030,1.3220518244315178,261,230,60030,1.1347826086956523,Very Large,972.5,781.0,0.389,0.41300898995240615,middle-center,4727500,0.01269804336329984,Small (1-5%)
00000166.jpg,1000,610,433,25,944,380,False,511,355,181405,1.639344262295082,511,355,181405,1.43943661971831,Very Large,688.5,202.5,0.6885,0.3319672131147541,middle-right,610000,0.29738524590163934,Large (15-30%)
00001278.jpg,600,397,316,49,504,191,False,188,142,26696,1.5113350125944585,188,142,26696,1.323943661971831,Large,410.0,120.0,0.6833333333333333,0.3022670025188917,top-right,238200,0.11207388748950461,Medium (5-15%)
00000172.jpg,681,1024,319,141,455,375,False,136,234,31824,0.6650390625,136,234,31824,0.5811965811965812,Large,387.0,258.0,0.5682819383259912,0.251953125,top-center,697344,0.04563601321585903,Small (1-5%)
00002003.jpg,1024,684,162,30,1002,683,False,840,653,548520,1.4970760233918128,840,653,548520,1.2863705972434916,Very Large,582.0,356.5,0.568359375,0.5211988304093568,middle-center,700416,0.7831345942982456,Very Large (>30%)
00001522.jpg,626,417,362,63,490,165,False,128,102,13056,1.501199040767386,128,102,13056,1.2549019607843137,Medium,426.0,114.0,0.6805111821086262,0.2733812949640288,top-right,261042,0.050014940124577655,Medium (5-15%)
00001244.jpg,2000,1125,748,173,1175,452,False,427,279,119133,1.7777777777777777,427,279,119133,1.5304659498207884,Very Large,961.5,312.5,0.48075,0.2777777777777778,top-center,2250000,0.052948,Medium (5-15%)
00003453.jpg,236,157,128,9,190,58,False,62,49,3038,1.5031847133757963,62,49,3038,1.2653061224489797,Small,159.0,33.5,0.673728813559322,0.21337579617834396,top-right,37052,0.08199287487854906,Medium (5-15%)
00002995.jpg,2048,1362,965,161,1946,920,False,981,759,744579,1.5036710719530102,981,759,744579,1.2924901185770752,Very Large,1455.5,540.5,0.710693359375,0.39684287812041114,middle-right,2789376,0.26693389489262115,Large (15-30%)
00002759.jpg,1200,1200,420,372,621,607,False,201,235,47235,1.0,201,235,47235,0.8553191489361702,Large,520.5,489.5,0.43375,0.40791666666666665,middle-center,1440000,0.032802083333333336,Small (1-5%)
00003447.jpg,612,408,92,44,293,203,False,201,159,31959,1.5,201,159,31959,1.2641509433962264,Large,192.5,123.5,0.3145424836601307,0.30269607843137253,top-left,249696,0.12799163783160322,Medium (5-15%)
00001536.jpg,626,417,330,55,591,262,False,261,207,54027,1.501199040767386,261,207,54027,1.2608695652173914,Very Large,460.5,158.5,0.7356230031948882,0.3800959232613909,middle-right,261042,0.20696669501459536,Large (15-30%)
00001907.jpg,400,278,88,36,278,193,False,190,157,29830,1.4388489208633093,190,157,29830,1.2101910828025477,Large,183.0,114.5,0.4575,0.4118705035971223,middle-center,111200,0.26825539568345325,Large (15-30%)
00001913.jpg,867,1300,333,77,495,361,False,162,284,46008,0.666923076923077,162,284,46008,0.5704225352112676,Large,414.0,219.0,0.47750865051903113,0.16846153846153847,top-center,1127100,0.040819803034335904,Small (1-5%)
00001085.jpg,1600,1000,339,1,1378,629,False,1039,628,652492,1.6,1039,628,652492,1.6544585987261147,Very Large,858.5,315.0,0.5365625,0.315,top-center,1600000,0.4078075,Very Large (>30%)
00001091.jpg,4000,6000,1408,1,2359,1617,False,951,1616,1536816,0.6666666666666666,951,1616,1536816,0.588490099009901,Very Large,1883.5,809.0,0.470875,0.13483333333333333,top-center,24000000,0.064034,Medium (5-15%)
00000364.jpg,400,600,190,88,234,164,False,44,76,3344,0.6666666666666666,44,76,3344,0.5789473684210527,Small,212.0,126.0,0.53,0.21,top-center,240000,0.013933333333333334,Small (1-5%)
00002573.jpg,960,720,562,151,780,346,False,218,195,42510,1.3333333333333333,218,195,42510,1.117948717948718,Large,671.0,248.5,0.6989583333333333,0.3451388888888889,middle-right,691200,0.06150173611111111,Medium (5-15%)
00002573.jpg,960,720,151,154,258,247,False,107,93,9951,1.3333333333333333,107,93,9951,1.1505376344086022,Medium,204.5,200.5,0.21302083333333333,0.27847222222222223,top-left,691200,0.01439670138888889,Small (1-5%)
00002215.jpg,612,487,362,36,493,157,False,131,121,15851,1.2566735112936345,131,121,15851,1.0826446280991735,Medium,427.5,96.5,0.6985294117647058,0.19815195071868583,top-right,298044,0.05318342258190066,Medium (5-15%)
00002215.jpg,612,487,204,121,296,207,False,92,86,7912,1.2566735112936345,92,86,7912,1.069767441860465,Medium,250.0,164.0,0.4084967320261438,0.33675564681724846,middle-center,298044,0.026546415965427922,Small (1-5%)
00000416.jpg,1600,1167,609,70,861,285,False,252,215,54180,1.3710368466152527,252,215,54180,1.172093023255814,Very Large,735.0,177.5,0.459375,0.1520994001713796,top-center,1867200,0.029016709511568123,Small (1-5%)
00001708.jpg,1500,1098,879,201,1228,498,False,349,297,103653,1.366120218579235,349,297,103653,1.1750841750841752,Very Large,1053.5,349.5,0.7023333333333334,0.31830601092896177,top-right,1647000,0.06293442622950819,Medium (5-15%)
00002201.jpg,1200,633,779,293,1148,519,False,369,226,83394,1.8957345971563981,369,226,83394,1.6327433628318584,Very Large,963.5,406.0,0.8029166666666666,0.641390205371248,middle-right,759600,0.10978672985781991,Medium (5-15%)
00001046.jpg,390,280,122,3,365,202,False,243,199,48357,1.3928571428571428,243,199,48357,1.221105527638191,Large,243.5,102.5,0.6243589743589744,0.36607142857142855,middle-center,109200,0.44282967032967036,Very Large (>30%)
00000358.jpg,6000,4000,3241,724,4441,1655,False,1200,931,1117200,1.5,1200,931,1117200,1.288936627282492,Very Large,3841.0,1189.5,0.6401666666666667,0.297375,top-center,24000000,0.04655,Small (1-5%)
00001720.jpg,600,900,175,5,463,495,False,288,490,141120,0.6666666666666666,288,490,141120,0.5877551020408164,Very Large,319.0,250.0,0.5316666666666666,0.2777777777777778,top-center,540000,0.2613333333333333,Large (15-30%)
00002229.jpg,374,580,166,161,273,351,False,107,190,20330,0.6448275862068965,107,190,20330,0.5631578947368421,Large,219.5,256.0,0.5868983957219251,0.4413793103448276,middle-center,216920,0.09372118753457497,Medium (5-15%)
00003123.jpg,538,700,123,159,174,237,False,51,78,3978,0.7685714285714286,51,78,3978,0.6538461538461539,Small,148.5,198.0,0.2760223048327137,0.28285714285714286,top-left,376600,0.010562931492299522,Small (1-5%)
00001734.jpg,1023,709,534,53,849,306,False,315,253,79695,1.4428772919605077,315,253,79695,1.2450592885375493,Very Large,691.5,179.5,0.6759530791788856,0.2531734837799718,top-right,725307,0.10987761044633514,Medium (5-15%)
00001052.jpg,500,813,181,9,372,370,False,191,361,68951,0.6150061500615006,191,361,68951,0.5290858725761773,Very Large,276.5,189.5,0.553,0.23308733087330874,top-center,406500,0.16962115621156212,Large (15-30%)
00002563.jpg,1280,855,444,13,804,294,False,360,281,101160,1.4970760233918128,360,281,101160,1.2811387900355873,Very Large,624.0,153.5,0.4875,0.17953216374269007,top-center,1094400,0.09243421052631579,Medium (5-15%)
00002563.jpg,1280,855,700,247,1060,528,False,360,281,101160,1.4970760233918128,360,281,101160,1.2811387900355873,Very Large,880.0,387.5,0.6875,0.45321637426900585,middle-right,1094400,0.09243421052631579,Medium (5-15%)
00002205.jpg,861,1390,368,67,464,247,False,96,180,17280,0.6194244604316547,96,180,17280,0.5333333333333333,Medium,416.0,157.0,0.4831591173054588,0.11294964028776978,top-center,1196790,0.014438623317373975,Small (1-5%)
00001718.jpg,398,600,149,66,225,200,False,76,134,10184,0.6633333333333333,76,134,10184,0.5671641791044776,Medium,187.0,133.0,0.46984924623115576,0.22166666666666668,top-center,238800,0.042646566164154104,Small (1-5%)
00000406.jpg,200,200,80,51,119,97,False,39,46,1794,1.0,39,46,1794,0.8478260869565217,Small,99.5,74.0,0.4975,0.37,middle-center,40000,0.04485,Small (1-5%)
00002211.jpg,1300,956,202,64,1156,862,False,954,798,761292,1.3598326359832635,954,798,761292,1.1954887218045114,Very Large,679.0,463.0,0.5223076923076924,0.48430962343096234,middle-center,1242800,0.6125619568715803,Very Large (>30%)
00002577.jpg,683,1024,295,338,423,557,False,128,219,28032,0.6669921875,128,219,28032,0.5844748858447488,Large,359.0,447.5,0.5256222547584187,0.43701171875,middle-center,699392,0.0400805270863836,Small (1-5%)
00000348.jpg,590,342,319,69,418,137,False,99,68,6732,1.7251461988304093,99,68,6732,1.4558823529411764,Medium,368.5,103.0,0.6245762711864407,0.30116959064327486,top-center,201780,0.03336306868867083,Small (1-5%)
00001056.jpg,2940,1960,1374,340,1961,797,False,587,457,268259,1.5,587,457,268259,1.2844638949671772,Very Large,1667.5,568.5,0.5671768707482994,0.2900510204081633,top-center,5762400,0.04655334582812717,Small (1-5%)
00001730.jpg,600,420,265,35,408,151,False,143,116,16588,1.4285714285714286,143,116,16588,1.2327586206896552,Medium,336.5,93.0,0.5608333333333333,0.22142857142857142,top-center,252000,0.06582539682539683,Medium (5-15%)
00003127.jpg,6000,4000,3293,1004,4573,2019,False,1280,1015,1299200,1.5,1280,1015,1299200,1.2610837438423645,Very Large,3933.0,1511.5,0.6555,0.377875,middle-center,24000000,0.05413333333333333,Medium (5-15%)
00002239.jpg,1000,667,609,95,897,318,False,288,223,64224,1.4992503748125936,288,223,64224,1.2914798206278026,Very Large,753.0,206.5,0.753,0.3095952023988006,top-right,667000,0.09628785607196402,Medium (5-15%)
00002239.jpg,1000,667,385,163,613,340,False,228,177,40356,1.4992503748125936,228,177,40356,1.2881355932203389,Large,499.0,251.5,0.499,0.3770614692653673,middle-center,667000,0.060503748125937035,Medium (5-15%)
00002239.jpg,1000,667,87,91,351,292,False,264,201,53064,1.4992503748125936,264,201,53064,1.3134328358208955,Very Large,219.0,191.5,0.219,0.2871064467766117,top-left,667000,0.07955622188905548,Medium (5-15%)
00003133.jpg,612,408,174,230,273,306,False,99,76,7524,1.5,99,76,7524,1.3026315789473684,Medium,223.5,268.0,0.36519607843137253,0.6568627450980392,middle-center,249696,0.03013264129181084,Small (1-5%)
00003133.jpg,612,408,272,227,375,307,False,103,80,8240,1.5,103,80,8240,1.2875,Medium,323.5,267.0,0.5285947712418301,0.6544117647058824,middle-center,249696,0.0330001281558375,Small (1-5%)
00001724.jpg,407,612,93,99,283,423,False,190,324,61560,0.6650326797385621,190,324,61560,0.5864197530864198,Very Large,188.0,261.0,0.4619164619164619,0.4264705882352941,middle-center,249084,0.24714554126318833,Large (15-30%)
00001042.jpg,800,582,204,39,595,378,False,391,339,132549,1.3745704467353952,391,339,132549,1.1533923303834808,Very Large,399.5,208.5,0.499375,0.3582474226804124,middle-center,465600,0.28468427835051546,Large (15-30%)
00001917.jpg,1024,683,366,54,1016,569,False,650,515,334750,1.499267935578331,650,515,334750,1.2621359223300972,Very Large,691.0,311.5,0.6748046875,0.4560761346998536,middle-right,699392,0.4786300100658858,Very Large (>30%)
00001095.jpg,600,398,191,3,589,284,False,398,281,111838,1.5075376884422111,398,281,111838,1.416370106761566,Very Large,390.0,143.5,0.65,0.36055276381909546,middle-center,238800,0.4683333333333333,Very Large (>30%)
00002588.jpg,1024,1024,540,115,892,517,False,352,402,141504,1.0,352,402,141504,0.8756218905472637,Very Large,716.0,316.0,0.69921875,0.30859375,top-right,1048576,0.13494873046875,Medium (5-15%)
00002588.jpg,1024,1024,247,383,542,719,False,295,336,99120,1.0,295,336,99120,0.8779761904761905,Very Large,394.5,551.0,0.38525390625,0.5380859375,middle-center,1048576,0.0945281982421875,Medium (5-15%)
00001081.jpg,509,339,193,33,319,131,False,126,98,12348,1.5014749262536873,126,98,12348,1.2857142857142858,Medium,256.0,82.0,0.5029469548133595,0.24188790560471976,top-center,172551,0.07156145139697828,Medium (5-15%)
00000610.jpg,1500,1117,502,47,754,266,False,252,219,55188,1.3428827215756491,252,219,55188,1.1506849315068493,Very Large,628.0,156.5,0.4186666666666667,0.14010743061772604,top-center,1675500,0.03293822739480752,Small (1-5%)
00000610.jpg,1500,1117,736,329,1070,619,False,334,290,96860,1.3428827215756491,334,290,96860,1.1517241379310346,Very Large,903.0,474.0,0.602,0.4243509400179051,middle-center,1675500,0.05780960907191883,Medium (5-15%)
00000610.jpg,1500,1117,557,305,857,565,False,300,260,78000,1.3428827215756491,300,260,78000,1.1538461538461537,Very Large,707.0,435.0,0.4713333333333333,0.38943598925693823,middle-center,1675500,0.046553267681289166,Small (1-5%)
00002007.jpg,612,408,255,29,427,166,False,172,137,23564,1.5,172,137,23564,1.2554744525547445,Large,341.0,97.5,0.5571895424836601,0.23897058823529413,top-center,249696,0.09437075483788286,Medium (5-15%)
00003319.jpg,800,533,306,29,800,441,False,494,412,203528,1.5009380863039399,494,412,203528,1.1990291262135921,Very Large,553.0,235.0,0.69125,0.44090056285178236,middle-right,426400,0.4773170731707317,Very Large (>30%)
00000162.jpg,400,280,214,50,313,131,False,99,81,8019,1.4285714285714286,99,81,8019,1.2222222222222223,Medium,263.5,90.5,0.65875,0.32321428571428573,top-center,112000,0.07159821428571428,Medium (5-15%)
00002775.jpg,1024,800,316,239,438,350,False,122,111,13542,1.28,122,111,13542,1.0990990990990992,Medium,377.0,294.5,0.3681640625,0.368125,middle-center,819200,0.01653076171875,Small (1-5%)
00002013.jpg,1333,2000,430,134,840,850,False,410,716,293560,0.6665,410,716,293560,0.5726256983240223,Very Large,635.0,492.0,0.4763690922730683,0.246,top-center,2666000,0.11011252813203301,Medium (5-15%)
00000604.jpg,1600,1168,469,342,910,709,False,441,367,161847,1.36986301369863,441,367,161847,1.2016348773841963,Very Large,689.5,525.5,0.4309375,0.4499143835616438,middle-center,1868800,0.08660477311643835,Medium (5-15%)
00000604.jpg,1600,1168,103,204,594,622,False,491,418,205238,1.36986301369863,491,418,205238,1.174641148325359,Very Large,348.5,413.0,0.2178125,0.3535958904109589,middle-left,1868800,0.10982341609589041,Medium (5-15%)
00000604.jpg,1600,1168,802,37,1350,502,False,548,465,254820,1.36986301369863,548,465,254820,1.178494623655914,Very Large,1076.0,269.5,0.6725,0.230736301369863,top-right,1868800,0.1363548801369863,Medium (5-15%)
00003325.jpg,1200,750,345,85,767,392,False,422,307,129554,1.6,422,307,129554,1.3745928338762214,Very Large,556.0,238.5,0.4633333333333333,0.318,top-center,900000,0.14394888888888888,Medium (5-15%)
00001532.jpg,500,750,195,175,327,406,False,132,231,30492,0.6666666666666666,132,231,30492,0.5714285714285714,Large,261.0,290.5,0.522,0.3873333333333333,middle-center,375000,0.081312,Medium (5-15%)
00001254.jpg,1300,731,532,65,804,239,False,272,174,47328,1.7783857729138166,272,174,47328,1.5632183908045978,Large,668.0,152.0,0.5138461538461538,0.2079343365253078,top-center,950300,0.049803220035778174,Small (1-5%)
00003443.jpg,236,330,97,30,152,119,False,55,89,4895,0.7151515151515152,55,89,4895,0.6179775280898876,Small,124.5,74.5,0.527542372881356,0.22575757575757577,top-center,77880,0.06285310734463277,Medium (5-15%)
00002985.jpg,1300,868,638,47,876,233,False,238,186,44268,1.4976958525345623,238,186,44268,1.2795698924731183,Large,757.0,140.0,0.5823076923076923,0.16129032258064516,top-center,1128400,0.03923076923076923,Small (1-5%)
00003457.jpg,236,354,95,53,148,145,False,53,92,4876,0.6666666666666666,53,92,4876,0.5760869565217391,Small,121.5,99.0,0.5148305084745762,0.2796610169491525,top-center,83544,0.058364454658623,Medium (5-15%)
00002991.jpg,1080,720,564,105,689,202,False,125,97,12125,1.5,125,97,12125,1.288659793814433,Medium,626.5,153.5,0.5800925925925926,0.21319444444444444,top-center,777600,0.015592849794238682,Small (1-5%)
00002991.jpg,1080,720,174,236,287,323,False,113,87,9831,1.5,113,87,9831,1.2988505747126438,Medium,230.5,279.5,0.21342592592592594,0.38819444444444445,middle-left,777600,0.012642746913580248,Small (1-5%)
00002991.jpg,1080,720,797,197,907,284,False,110,87,9570,1.5,110,87,9570,1.264367816091954,Medium,852.0,240.5,0.7888888888888889,0.33402777777777776,middle-right,777600,0.012307098765432099,Small (1-5%)
00002991.jpg,1080,720,356,98,490,202,False,134,104,13936,1.5,134,104,13936,1.2884615384615385,Medium,423.0,150.0,0.39166666666666666,0.20833333333333334,top-center,777600,0.017921810699588477,Small (1-5%)
00001240.jpg,500,749,198,174,298,344,False,100,170,17000,0.6675567423230975,100,170,17000,0.5882352941176471,Medium,248.0,259.0,0.496,0.34579439252336447,middle-center,374500,0.04539385847797063,Small (1-5%)
00001526.jpg,866,1390,399,35,618,444,False,219,409,89571,0.6230215827338129,219,409,89571,0.5354523227383863,Very Large,508.5,239.5,0.5871824480369515,0.1723021582733813,top-center,1203740,0.07441058700383804,Medium (5-15%)
00003331.jpg,1600,1155,499,397,768,619,False,269,222,59718,1.3852813852813852,269,222,59718,1.2117117117117118,Very Large,633.5,508.0,0.3959375,0.43982683982683984,middle-center,1848000,0.03231493506493507,Small (1-5%)
00003331.jpg,1600,1155,688,32,1030,319,False,342,287,98154,1.3852813852813852,342,287,98154,1.1916376306620209,Very Large,859.0,175.5,0.536875,0.15194805194805194,top-center,1848000,0.05311363636363636,Medium (5-15%)
00003331.jpg,1600,1155,833,304,1102,530,False,269,226,60794,1.3852813852813852,269,226,60794,1.1902654867256637,Very Large,967.5,417.0,0.6046875,0.36103896103896105,middle-center,1848000,0.03289718614718615,Small (1-5%)
00003331.jpg,1600,1155,636,330,917,556,False,281,226,63506,1.3852813852813852,281,226,63506,1.2433628318584071,Very Large,776.5,443.0,0.4853125,0.38354978354978353,middle-center,1848000,0.03436471861471861,Small (1-5%)
00000837.jpg,400,191,8,1,251,139,False,243,138,33534,2.094240837696335,243,138,33534,1.7608695652173914,Large,129.5,70.0,0.32375,0.36649214659685864,middle-left,76400,0.43892670157068064,Very Large (>30%)
00003480.jpg,236,156,80,21,148,73,False,68,52,3536,1.5128205128205128,68,52,3536,1.3076923076923077,Small,114.0,47.0,0.4830508474576271,0.30128205128205127,top-center,36816,0.096045197740113,Medium (5-15%)
00001297.jpg,600,419,253,30,361,118,False,108,88,9504,1.431980906921241,108,88,9504,1.2272727272727273,Medium,307.0,74.0,0.5116666666666667,0.1766109785202864,top-center,251400,0.037804295942720764,Small (1-5%)
00002952.jpg,1300,889,612,105,955,372,False,343,267,91581,1.4623172103487063,343,267,91581,1.2846441947565543,Very Large,783.5,238.5,0.6026923076923076,0.26827896512935884,top-center,1155700,0.07924288310115082,Medium (5-15%)
00002952.jpg,1300,889,874,79,1233,358,False,359,279,100161,1.4623172103487063,359,279,100161,1.2867383512544803,Very Large,1053.5,218.5,0.8103846153846154,0.24578177727784026,top-right,1155700,0.08666695509215194,Medium (5-15%)
00000764.jpg,1001,1600,441,64,613,384,False,172,320,55040,0.625625,172,320,55040,0.5375,Very Large,527.0,224.0,0.5264735264735265,0.14,top-center,1601600,0.03436563436563437,Small (1-5%)
00002615.jpg,1024,682,346,184,501,304,False,155,120,18600,1.501466275659824,155,120,18600,1.2916666666666667,Medium,423.5,244.0,0.41357421875,0.35777126099706746,middle-center,698368,0.026633522727272728,Small (1-5%)
00001308.jpg,1067,1700,479,156,644,455,False,165,299,49335,0.6276470588235294,165,299,49335,0.5518394648829431,Large,561.5,305.5,0.5262417994376757,0.1797058823529412,top-center,1813900,0.027198302001212857,Small (1-5%)
00003279.jpg,679,1024,254,401,334,542,False,80,141,11280,0.6630859375,80,141,11280,0.5673758865248227,Medium,294.0,471.5,0.4329896907216495,0.46044921875,middle-center,695296,0.016223306332842417,Small (1-5%)
00002167.jpg,612,459,116,81,330,268,False,214,187,40018,1.3333333333333333,214,187,40018,1.1443850267379678,Large,223.0,174.5,0.36437908496732024,0.3801742919389978,middle-center,280908,0.14245945291696926,Medium (5-15%)
00000770.jpg,590,396,194,21,389,173,False,195,152,29640,1.4898989898989898,195,152,29640,1.2828947368421053,Large,291.5,97.0,0.4940677966101695,0.24494949494949494,top-center,233640,0.1268618387262455,Medium (5-15%)
00001446.jpg,590,885,236,55,399,339,False,163,284,46292,0.6666666666666666,163,284,46292,0.573943661971831,Large,317.5,197.0,0.538135593220339,0.22259887005649717,top-center,522150,0.08865651632672604,Medium (5-15%)
00000758.jpg,1300,867,487,54,853,339,False,366,285,104310,1.4994232987312572,366,285,104310,1.2842105263157895,Very Large,670.0,196.5,0.5153846153846153,0.22664359861591696,top-center,1127100,0.09254724514240086,Medium (5-15%)
00001320.jpg,682,1023,131,1,584,705,False,453,704,318912,0.6666666666666666,453,704,318912,0.6434659090909091,Very Large,357.5,353.0,0.5241935483870968,0.34506353861192574,middle-center,697686,0.45709961214643835,Very Large (>30%)
00001452.jpg,1332,850,761,55,1077,290,False,316,235,74260,1.5670588235294118,316,235,74260,1.3446808510638297,Very Large,919.0,172.5,0.68993993993994,0.20294117647058824,top-right,1132200,0.065589118530295,Medium (5-15%)
00000994.jpg,600,419,236,58,516,295,False,280,237,66360,1.431980906921241,280,237,66360,1.1814345991561181,Very Large,376.0,176.5,0.6266666666666667,0.4212410501193317,middle-center,251400,0.2639618138424821,Large (15-30%)
00003245.jpg,800,800,665,426,794,583,False,129,157,20253,1.0,129,157,20253,0.821656050955414,Large,729.5,504.5,0.911875,0.630625,middle-right,640000,0.0316453125,Small (1-5%)
00001485.jpg,319,450,133,95,219,236,False,86,141,12126,0.7088888888888889,86,141,12126,0.6099290780141844,Medium,176.0,165.5,0.5517241379310345,0.36777777777777776,middle-center,143550,0.0844723092998955,Medium (5-15%)
00000943.jpg,533,800,167,12,428,458,False,261,446,116406,0.66625,261,446,116406,0.5852017937219731,Very Large,297.5,235.0,0.5581613508442776,0.29375,top-center,426400,0.27299718574108817,Large (15-30%)
00003292.jpg,2000,1333,693,364,1363,895,False,670,531,355770,1.5003750937734435,670,531,355770,1.2617702448210923,Very Large,1028.0,629.5,0.514,0.4722430607651913,middle-center,2666000,0.1334471117779445,Medium (5-15%)
00002826.jpg,1300,956,581,89,947,403,False,366,314,114924,1.3598326359832635,366,314,114924,1.1656050955414012,Very Large,764.0,246.0,0.5876923076923077,0.25732217573221755,top-center,1242800,0.09247183778564531,Medium (5-15%)
00002198.jpg,471,630,215,33,283,139,False,68,106,7208,0.7476190476190476,68,106,7208,0.6415094339622641,Medium,249.0,86.0,0.5286624203821656,0.1365079365079365,top-center,296730,0.024291443399723653,Small (1-5%)
00001491.jpg,1470,980,412,50,776,332,False,364,282,102648,1.5,364,282,102648,1.2907801418439717,Very Large,594.0,191.0,0.40408163265306124,0.19489795918367347,top-center,1440600,0.0712536443148688,Medium (5-15%)
00000957.jpg,2946,1960,1204,139,1492,362,False,288,223,64224,1.5030612244897958,288,223,64224,1.2914798206278026,Very Large,1348.0,250.5,0.4575695858791582,0.1278061224489796,top-center,5774160,0.011122656802028346,Small (1-5%)
00000566.jpg,910,780,323,473,513,662,False,190,189,35910,1.1666666666666667,190,189,35910,1.0052910052910053,Large,418.0,567.5,0.4593406593406593,0.7275641025641025,bottom-center,709800,0.05059171597633136,Medium (5-15%)
00001678.jpg,450,319,188,46,269,112,False,81,66,5346,1.4106583072100314,81,66,5346,1.2272727272727273,Medium,228.5,79.0,0.5077777777777778,0.2476489028213166,top-center,143550,0.037241379310344824,Small (1-5%)
00002365.jpg,1600,1199,624,250,944,529,False,320,279,89280,1.3344453711426187,320,279,89280,1.146953405017921,Very Large,784.0,389.5,0.49,0.3248540450375313,top-center,1918400,0.046538782318598836,Small (1-5%)
00002403.jpg,313,512,70,12,172,203,False,102,191,19482,0.611328125,102,191,19482,0.5340314136125655,Medium,121.0,107.5,0.3865814696485623,0.2099609375,top-center,160256,0.12156799121405751,Medium (5-15%)
00001644.jpg,319,450,109,27,182,146,False,73,119,8687,0.7088888888888889,73,119,8687,0.6134453781512605,Medium,145.5,86.5,0.4561128526645768,0.1922222222222222,top-center,143550,0.06051549982584465,Medium (5-15%)
00003053.jpg,1920,1534,477,179,665,354,False,188,175,32900,1.2516297262059974,188,175,32900,1.0742857142857143,Large,571.0,266.5,0.29739583333333336,0.17372881355932204,top-left,2945280,0.01117041503694046,Small (1-5%)
00003053.jpg,1920,1534,1430,240,1708,493,False,278,253,70334,1.2516297262059974,278,253,70334,1.098814229249012,Very Large,1569.0,366.5,0.8171875,0.23891786179921773,top-right,2945280,0.023880242285962625,Small (1-5%)
00003053.jpg,1920,1534,740,235,941,421,False,201,186,37386,1.2516297262059974,201,186,37386,1.0806451612903225,Large,840.5,328.0,0.43776041666666665,0.2138200782268579,top-center,2945280,0.012693529986962191,Small (1-5%)
00003053.jpg,1920,1534,1127,357,1417,627,False,290,270,78300,1.2516297262059974,290,270,78300,1.0740740740740742,Very Large,1272.0,492.0,0.6625,0.32073011734028684,top-center,2945280,0.026584908735332462,Small (1-5%)
00003053.jpg,1920,1534,113,521,390,779,False,277,258,71466,1.2516297262059974,277,258,71466,1.073643410852713,Very Large,251.5,650.0,0.13098958333333333,0.423728813559322,middle-left,2945280,0.024264586049543676,Small (1-5%)
00002359.jpg,300,350,173,18,241,108,False,68,90,6120,0.8571428571428571,68,90,6120,0.7555555555555555,Medium,207.0,63.0,0.69,0.18,top-right,105000,0.05828571428571429,Medium (5-15%)
00001888.jpg,600,418,267,68,419,189,False,152,121,18392,1.4354066985645932,152,121,18392,1.256198347107438,Medium,343.0,128.5,0.5716666666666667,0.30741626794258375,top-center,250800,0.07333333333333333,Medium (5-15%)
00001650.jpg,417,626,58,26,332,495,False,274,469,128506,0.6661341853035144,274,469,128506,0.5842217484008528,Very Large,195.0,260.5,0.4676258992805755,0.41613418530351437,middle-center,261042,0.4922809356348787,Very Large (>30%)
00001877.jpg,1500,1120,652,53,972,338,False,320,285,91200,1.3392857142857142,320,285,91200,1.1228070175438596,Very Large,812.0,195.5,0.5413333333333333,0.17455357142857142,top-center,1680000,0.054285714285714284,Medium (5-15%)
00003090.jpg,900,900,355,315,469,447,False,114,132,15048,1.0,114,132,15048,0.8636363636363636,Medium,412.0,381.0,0.4577777777777778,0.42333333333333334,middle-center,810000,0.018577777777777776,Small (1-5%)
00003090.jpg,900,900,72,507,144,592,False,72,85,6120,1.0,72,85,6120,0.8470588235294118,Medium,108.0,549.5,0.12,0.6105555555555555,middle-left,810000,0.007555555555555556,Tiny (<1%)
00001687.jpg,1300,956,381,98,605,289,False,224,191,42784,1.3598326359832635,224,191,42784,1.1727748691099475,Large,493.0,193.5,0.3792307692307692,0.20240585774058578,top-center,1242800,0.034425490827164465,Small (1-5%)
00001693.jpg,1023,682,406,50,796,352,False,390,302,117780,1.5,390,302,117780,1.2913907284768211,Very Large,601.0,201.0,0.5874877810361682,0.29472140762463345,top-center,697686,0.1688151976677187,Large (15-30%)
00003085.jpg,1000,1500,281,685,690,1400,False,409,715,292435,0.6666666666666666,409,715,292435,0.5720279720279721,Very Large,485.5,1042.5,0.4855,0.695,bottom-center,1500000,0.19495666666666667,Large (15-30%)
00003085.jpg,1000,1500,223,13,544,550,False,321,537,172377,0.6666666666666666,321,537,172377,0.5977653631284916,Very Large,383.5,281.5,0.3835,0.18766666666666668,top-center,1500000,0.114918,Medium (5-15%)
00001692.jpg,1300,975,617,106,889,343,False,272,237,64464,1.3333333333333333,272,237,64464,1.1476793248945147,Very Large,753.0,224.5,0.5792307692307692,0.23025641025641025,top-center,1267500,0.05085917159763314,Medium (5-15%)
00001692.jpg,1300,975,405,280,633,480,False,228,200,45600,1.3333333333333333,228,200,45600,1.14,Large,519.0,380.0,0.3992307692307692,0.38974358974358975,middle-center,1267500,0.035976331360946745,Small (1-5%)
00000598.jpg,1024,683,246,164,425,304,False,179,140,25060,1.499267935578331,179,140,25060,1.2785714285714285,Large,335.5,234.0,0.32763671875,0.34260614934114203,middle-left,699392,0.03583112188872621,Small (1-5%)
00000598.jpg,1024,683,652,184,803,301,False,151,117,17667,1.499267935578331,151,117,17667,1.2905982905982907,Medium,727.5,242.5,0.71044921875,0.35505124450951686,middle-right,699392,0.025260511987554905,Small (1-5%)
00001686.jpg,559,309,110,5,497,254,False,387,249,96363,1.809061488673139,387,249,96363,1.5542168674698795,Very Large,303.5,129.5,0.5429338103756708,0.4190938511326861,middle-center,172731,0.5578790141896938,Very Large (>30%)
00001876.jpg,2000,1333,313,58,958,559,False,645,501,323145,1.5003750937734435,645,501,323145,1.2874251497005988,Very Large,635.5,308.5,0.31775,0.23143285821455364,top-left,2666000,0.12120967741935484,Medium (5-15%)
00001862.jpg,540,720,169,74,444,500,False,275,426,117150,0.75,275,426,117150,0.6455399061032864,Very Large,306.5,287.0,0.5675925925925925,0.39861111111111114,middle-center,388800,0.3013117283950617,Very Large (>30%)
00001651.jpg,333,519,114,145,164,236,False,50,91,4550,0.6416184971098265,50,91,4550,0.5494505494505495,Small,139.0,190.5,0.4174174174174174,0.3670520231213873,middle-center,172827,0.0263269049396217,Small (1-5%)
00001889.jpg,1000,667,527,87,803,296,False,276,209,57684,1.4992503748125936,276,209,57684,1.3205741626794258,Very Large,665.0,191.5,0.665,0.2871064467766117,top-center,667000,0.08648275862068966,Medium (5-15%)
00003046.jpg,533,800,258,252,340,396,False,82,144,11808,0.66625,82,144,11808,0.5694444444444444,Medium,299.0,324.0,0.5609756097560976,0.405,middle-center,426400,0.027692307692307693,Small (1-5%)
00003046.jpg,533,800,352,350,412,456,False,60,106,6360,0.66625,60,106,6360,0.5660377358490566,Medium,382.0,403.0,0.7166979362101313,0.50375,middle-right,426400,0.014915572232645403,Small (1-5%)
00003046.jpg,533,800,217,179,279,288,False,62,109,6758,0.66625,62,109,6758,0.5688073394495413,Medium,248.0,233.5,0.4652908067542214,0.291875,top-center,426400,0.015848968105065666,Small (1-5%)
00003046.jpg,533,800,266,81,326,184,False,60,103,6180,0.66625,60,103,6180,0.5825242718446602,Medium,296.0,132.5,0.5553470919324578,0.165625,top-center,426400,0.01449343339587242,Small (1-5%)
00002358.jpg,637,960,377,58,478,234,False,101,176,17776,0.6635416666666667,101,176,17776,0.5738636363636364,Medium,427.5,146.0,0.6711145996860283,0.15208333333333332,top-right,611520,0.029068550497121926,Small (1-5%)
00001137.jpg,1068,1700,533,406,701,718,False,168,312,52416,0.6282352941176471,168,312,52416,0.5384615384615384,Very Large,617.0,562.0,0.5777153558052435,0.3305882352941176,middle-center,1815600,0.02886979510905486,Small (1-5%)
00001123.jpg,1800,1202,693,309,1038,577,False,345,268,92460,1.497504159733777,345,268,92460,1.287313432835821,Very Large,865.5,443.0,0.48083333333333333,0.3685524126455907,middle-center,2163600,0.04273433166943982,Small (1-5%)
00003052.jpg,280,370,84,73,129,143,False,45,70,3150,0.7567567567567568,45,70,3150,0.6428571428571429,Small,106.5,108.0,0.38035714285714284,0.2918918918918919,top-center,103600,0.030405405405405407,Small (1-5%)
00003052.jpg,280,370,152,79,198,150,False,46,71,3266,0.7567567567567568,46,71,3266,0.647887323943662,Small,175.0,114.5,0.625,0.30945945945945946,top-center,103600,0.031525096525096524,Small (1-5%)
00002364.jpg,2000,2000,635,241,1454,1194,False,819,953,780507,1.0,819,953,780507,0.8593913955928646,Very Large,1044.5,717.5,0.52225,0.35875,middle-center,4000000,0.19512675,Large (15-30%)
00002416.jpg,1280,720,921,135,1076,239,False,155,104,16120,1.7777777777777777,155,104,16120,1.4903846153846154,Medium,998.5,187.0,0.780078125,0.25972222222222224,top-right,921600,0.017491319444444445,Small (1-5%)
00002416.jpg,1280,720,361,216,486,298,False,125,82,10250,1.7777777777777777,125,82,10250,1.524390243902439,Medium,423.5,257.0,0.330859375,0.35694444444444445,middle-center,921600,0.011121961805555556,Small (1-5%)
00001679.jpg,866,1300,481,190,630,450,False,149,260,38740,0.6661538461538462,149,260,38740,0.573076923076923,Large,555.5,320.0,0.6414549653579676,0.24615384615384617,top-center,1125800,0.03441108545034642,Small (1-5%)
00000567.jpg,1500,1000,450,302,1016,741,False,566,439,248474,1.5,566,439,248474,1.2892938496583144,Very Large,733.0,521.5,0.4886666666666667,0.5215,middle-center,1500000,0.16564933333333334,Large (15-30%)
00000567.jpg,1500,1000,2,413,504,830,False,502,417,209334,1.5,502,417,209334,1.2038369304556356,Very Large,253.0,621.5,0.16866666666666666,0.6215,middle-left,1500000,0.139556,Medium (5-15%)
00000567.jpg,1500,1000,768,63,1328,497,False,560,434,243040,1.5,560,434,243040,1.2903225806451613,Very Large,1048.0,280.0,0.6986666666666667,0.28,top-right,1500000,0.16202666666666668,Large (15-30%)
00002827.jpg,1000,667,590,187,777,333,False,187,146,27302,1.4992503748125936,187,146,27302,1.2808219178082192,Large,683.5,260.0,0.6835,0.38980509745127434,middle-right,667000,0.040932533733133436,Small (1-5%)
00002827.jpg,1000,667,102,208,281,344,False,179,136,24344,1.4992503748125936,179,136,24344,1.3161764705882353,Large,191.5,276.0,0.1915,0.41379310344827586,middle-left,667000,0.03649775112443778,Small (1-5%)
00002827.jpg,1000,667,330,254,488,377,False,158,123,19434,1.4992503748125936,158,123,19434,1.2845528455284554,Medium,409.0,315.5,0.409,0.47301349325337333,middle-center,667000,0.029136431784107946,Small (1-5%)
00000956.jpg,683,1024,232,122,362,350,False,130,228,29640,0.6669921875,130,228,29640,0.5701754385964912,Large,297.0,236.0,0.43484626647144947,0.23046875,top-center,699392,0.04237966691068814,Small (1-5%)
00003287.jpg,500,500,116,44,198,139,False,82,95,7790,1.0,82,95,7790,0.8631578947368421,Medium,157.0,91.5,0.314,0.183,top-left,250000,0.03116,Small (1-5%)
00003287.jpg,500,500,255,27,337,121,False,82,94,7708,1.0,82,94,7708,0.8723404255319149,Medium,296.0,74.0,0.592,0.148,top-center,250000,0.030832,Small (1-5%)
00002199.jpg,470,423,210,65,367,230,False,157,165,25905,1.1111111111111112,157,165,25905,0.9515151515151515,Large,288.5,147.5,0.6138297872340426,0.3486997635933806,middle-center,198810,0.1303002867059001,Medium (5-15%)
00003293.jpg,736,981,188,170,309,354,False,121,184,22264,0.7502548419979612,121,184,22264,0.657608695652174,Large,248.5,262.0,0.3376358695652174,0.2670744138634047,top-center,722016,0.030835881753312946,Small (1-5%)
00001484.jpg,400,272,198,84,366,217,False,168,133,22344,1.4705882352941178,168,133,22344,1.263157894736842,Large,282.0,150.5,0.705,0.5533088235294118,middle-right,108800,0.20536764705882352,Large (15-30%)
00001335.jpg,1333,2000,626,186,781,457,False,155,271,42005,0.6665,155,271,42005,0.5719557195571956,Large,703.5,321.5,0.5277569392348087,0.16075,top-center,2666000,0.015755813953488372,Small (1-5%)
00003244.jpg,640,960,282,354,352,476,False,70,122,8540,0.6666666666666666,70,122,8540,0.5737704918032787,Medium,317.0,415.0,0.4953125,0.4322916666666667,middle-center,614400,0.013899739583333333,Small (1-5%)
00000995.jpg,800,534,92,16,313,188,False,221,172,38012,1.4981273408239701,221,172,38012,1.2848837209302326,Large,202.5,102.0,0.253125,0.19101123595505617,top-left,427200,0.08897940074906367,Medium (5-15%)
00001453.jpg,1024,768,417,68,617,243,False,200,175,35000,1.3333333333333333,200,175,35000,1.1428571428571428,Large,517.0,155.5,0.5048828125,0.20247395833333334,top-center,786432,0.044504801432291664,Small (1-5%)
00000981.jpg,600,400,232,34,374,147,False,142,113,16046,1.5,142,113,16046,1.2566371681415929,Medium,303.0,90.5,0.505,0.22625,top-center,240000,0.06685833333333334,Medium (5-15%)
00002628.jpg,601,900,362,123,449,274,False,87,151,13137,0.6677777777777778,87,151,13137,0.5761589403973509,Medium,405.5,198.5,0.6747088186356073,0.22055555555555556,top-right,540900,0.024287298946200776,Small (1-5%)
00002628.jpg,601,900,247,157,330,302,False,83,145,12035,0.6677777777777778,83,145,12035,0.5724137931034483,Medium,288.5,229.5,0.4800332778702163,0.255,top-center,540900,0.022249953780735812,Small (1-5%)
00002600.jpg,570,778,274,1,343,100,False,69,99,6831,0.7326478149100257,69,99,6831,0.696969696969697,Medium,308.5,50.5,0.5412280701754386,0.06491002570694088,top-center,443460,0.015403869571099987,Small (1-5%)
00002600.jpg,570,778,9,105,109,268,False,100,163,16300,0.7326478149100257,100,163,16300,0.6134969325153374,Medium,59.0,186.5,0.10350877192982456,0.2397172236503856,top-left,443460,0.03675641546024444,Small (1-5%)
00000765.jpg,768,1024,291,59,407,239,False,116,180,20880,0.75,116,180,20880,0.6444444444444445,Large,349.0,149.0,0.4544270833333333,0.1455078125,top-center,786432,0.02655029296875,Small (1-5%)
00000003.jpg,500,350,101,25,176,87,False,75,62,4650,1.4285714285714286,75,62,4650,1.2096774193548387,Small,138.5,56.0,0.277,0.16,top-left,175000,0.026571428571428572,Small (1-5%)
00002953.jpg,844,1023,531,116,638,267,False,107,151,16157,0.8250244379276638,107,151,16157,0.7086092715231788,Medium,584.5,191.5,0.6925355450236966,0.18719452590420332,top-right,863412,0.01871296669492664,Small (1-5%)
00001282.jpg,333,519,187,20,228,93,False,41,73,2993,0.6416184971098265,41,73,2993,0.5616438356164384,Small,207.5,56.5,0.6231231231231231,0.10886319845857419,top-center,172827,0.017317895930612694,Small (1-5%)
00000836.jpg,1232,821,376,147,816,489,False,440,342,150480,1.5006090133982948,440,342,150480,1.286549707602339,Very Large,596.0,318.0,0.4837662337662338,0.3873325213154689,middle-center,1011472,0.14877327301200627,Medium (5-15%)
00001296.jpg,1000,667,226,109,484,309,False,258,200,51600,1.4992503748125936,258,200,51600,1.29,Very Large,355.0,209.0,0.355,0.31334332833583206,top-center,667000,0.07736131934032983,Medium (5-15%)
00000188.jpg,640,427,85,93,155,147,False,70,54,3780,1.4988290398126465,70,54,3780,1.2962962962962963,Small,120.0,120.0,0.1875,0.2810304449648712,top-left,273280,0.013831967213114754,Small (1-5%)
00003481.jpg,236,353,81,72,124,147,False,43,75,3225,0.6685552407932012,43,75,3225,0.5733333333333334,Small,102.5,109.5,0.4343220338983051,0.3101983002832861,top-center,83308,0.03871176837758679,Small (1-5%)
00002748.jpg,1024,765,626,111,753,221,False,127,110,13970,1.3385620915032679,127,110,13970,1.1545454545454545,Medium,689.5,166.0,0.67333984375,0.2169934640522876,top-right,783360,0.01783343545751634,Small (1-5%)
00002748.jpg,1024,765,765,142,983,336,False,218,194,42292,1.3385620915032679,218,194,42292,1.1237113402061856,Large,874.0,239.0,0.853515625,0.31241830065359477,top-right,783360,0.05398794934640523,Medium (5-15%)
00002990.jpg,1300,996,703,279,845,406,False,142,127,18034,1.3052208835341366,142,127,18034,1.1181102362204725,Medium,774.0,342.5,0.5953846153846154,0.34387550200803213,middle-center,1294800,0.013928019771393265,Small (1-5%)
00003456.jpg,236,337,80,257,117,319,False,37,62,2294,0.7002967359050445,37,62,2294,0.5967741935483871,Small,98.5,288.0,0.4173728813559322,0.8545994065281899,bottom-center,79532,0.02884373585475029,Small (1-5%)
00001527.jpg,600,900,208,57,286,193,False,78,136,10608,0.6666666666666666,78,136,10608,0.5735294117647058,Medium,247.0,125.0,0.4116666666666667,0.1388888888888889,top-center,540000,0.019644444444444444,Small (1-5%)
00001533.jpg,1024,709,513,118,895,426,False,382,308,117656,1.4442877291960508,382,308,117656,1.2402597402597402,Very Large,704.0,272.0,0.6875,0.383638928067701,middle-right,726016,0.16205703455571227,Large (15-30%)
00002984.jpg,682,1023,227,312,427,662,False,200,350,70000,0.6666666666666666,200,350,70000,0.5714285714285714,Very Large,327.0,487.0,0.47947214076246336,0.4760508308895406,middle-center,697686,0.1003316678276474,Medium (5-15%)
00002984.jpg,682,1023,112,37,313,388,False,201,351,70551,0.6666666666666666,201,351,70551,0.5726495726495726,Very Large,212.5,212.5,0.31158357771260997,0.20772238514174,top-left,697686,0.10112142138440502,Medium (5-15%)
00003442.jpg,459,612,191,145,313,329,False,122,184,22448,0.75,122,184,22448,0.6630434782608695,Large,252.0,237.0,0.5490196078431373,0.3872549019607843,middle-center,280908,0.0799122844490011,Medium (5-15%)
00001255.jpg,800,533,362,63,583,231,False,221,168,37128,1.5009380863039399,221,168,37128,1.3154761904761905,Large,472.5,147.0,0.590625,0.275797373358349,top-center,426400,0.08707317073170731,Medium (5-15%)
00000605.jpg,800,534,131,96,313,234,False,182,138,25116,1.4981273408239701,182,138,25116,1.318840579710145,Large,222.0,165.0,0.2775,0.3089887640449438,top-left,427200,0.058792134831460674,Medium (5-15%)
00000605.jpg,800,534,327,141,552,312,False,225,171,38475,1.4981273408239701,225,171,38475,1.3157894736842106,Large,439.5,226.5,0.549375,0.4241573033707865,middle-center,427200,0.09006320224719101,Medium (5-15%)
00000605.jpg,800,534,524,162,735,326,False,211,164,34604,1.4981273408239701,211,164,34604,1.2865853658536586,Large,629.5,244.0,0.786875,0.45692883895131087,middle-right,427200,0.08100187265917604,Medium (5-15%)
00000605.jpg,800,534,250,68,393,178,False,143,110,15730,1.4981273408239701,143,110,15730,1.3,Medium,321.5,123.0,0.401875,0.2303370786516854,top-center,427200,0.03682116104868914,Small (1-5%)
00000605.jpg,800,534,424,40,602,176,False,178,136,24208,1.4981273408239701,178,136,24208,1.3088235294117647,Large,513.0,108.0,0.64125,0.20224719101123595,top-center,427200,0.056666666666666664,Medium (5-15%)
00002012.jpg,1500,1120,502,61,795,316,False,293,255,74715,1.3392857142857142,293,255,74715,1.1490196078431372,Very Large,648.5,188.5,0.43233333333333335,0.16830357142857144,top-center,1680000,0.04447321428571428,Small (1-5%)
00002006.jpg,800,553,220,22,717,431,False,497,409,203273,1.4466546112115732,497,409,203273,1.215158924205379,Very Large,468.5,226.5,0.585625,0.40958408679927666,middle-center,442400,0.4594778481012658,Very Large (>30%)
00000177.jpg,6000,4000,1308,92,3873,2125,False,2565,2033,5214645,1.5,2565,2033,5214645,1.2616822429906542,Very Large,2590.5,1108.5,0.43175,0.277125,top-center,24000000,0.217276875,Large (15-30%)
00001902.jpg,2410,1465,881,222,1561,703,False,680,481,327080,1.6450511945392492,680,481,327080,1.4137214137214138,Very Large,1221.0,462.5,0.5066390041493776,0.31569965870307165,top-center,3530650,0.0926401654086358,Medium (5-15%)
00001916.jpg,1024,658,214,58,479,255,False,265,197,52205,1.5562310030395137,265,197,52205,1.3451776649746192,Very Large,346.5,156.5,0.33837890625,0.2378419452887538,top-center,673792,0.07747940017097264,Medium (5-15%)
00003132.jpg,1300,957,224,198,458,398,False,234,200,46800,1.3584117032392895,234,200,46800,1.17,Large,341.0,298.0,0.2623076923076923,0.3113897596656217,top-left,1244100,0.03761755485893417,Small (1-5%)
00003132.jpg,1300,957,631,222,836,397,False,205,175,35875,1.3584117032392895,205,175,35875,1.1714285714285715,Large,733.5,309.5,0.5642307692307692,0.3234064785788924,top-center,1244100,0.02883610642231332,Small (1-5%)
00001043.jpg,500,333,201,76,323,170,False,122,94,11468,1.5015015015015014,122,94,11468,1.297872340425532,Medium,262.0,123.0,0.524,0.36936936936936937,middle-center,166500,0.06887687687687688,Medium (5-15%)
00001057.jpg,590,393,179,144,297,238,False,118,94,11092,1.5012722646310432,118,94,11092,1.2553191489361701,Medium,238.0,191.0,0.4033898305084746,0.4860050890585242,middle-center,231870,0.04783715012722646,Small (1-5%)
00003126.jpg,533,800,125,62,363,468,False,238,406,96628,0.66625,238,406,96628,0.5862068965517241,Very Large,244.0,265.0,0.45778611632270166,0.33125,middle-center,426400,0.22661350844277672,Large (15-30%)
00001731.jpg,720,908,34,1,543,656,False,509,655,333395,0.7929515418502202,509,655,333395,0.7770992366412214,Very Large,288.5,328.5,0.40069444444444446,0.361784140969163,middle-center,653760,0.5099654307391092,Very Large (>30%)
00001719.jpg,768,1024,263,57,374,229,False,111,172,19092,0.75,111,172,19092,0.6453488372093024,Medium,318.5,143.0,0.4147135416666667,0.1396484375,top-center,786432,0.0242767333984375,Small (1-5%)
00000361.jpg,2600,1734,1286,460,1743,815,False,457,355,162235,1.4994232987312572,457,355,162235,1.287323943661972,Very Large,1514.5,637.5,0.5825,0.36764705882352944,middle-center,4508400,0.03598505012864874,Small (1-5%)
00000361.jpg,2600,1734,914,389,1391,759,False,477,370,176490,1.4994232987312572,477,370,176490,1.2891891891891891,Very Large,1152.5,574.0,0.44326923076923075,0.33102652825836215,middle-center,4508400,0.03914692573862124,Small (1-5%)
00000413.jpg,1058,1600,379,272,545,565,False,166,293,48638,0.66125,166,293,48638,0.5665529010238908,Large,462.0,418.5,0.43667296786389415,0.2615625,top-center,1692800,0.02873227788279773,Small (1-5%)
00002204.jpg,626,417,207,45,423,212,False,216,167,36072,1.501199040767386,216,167,36072,1.2934131736526946,Large,315.0,128.5,0.5031948881789138,0.30815347721822545,top-center,261042,0.1381846599397798,Medium (5-15%)
00002574.jpg,900,600,256,40,539,255,False,283,215,60845,1.5,283,215,60845,1.3162790697674418,Very Large,397.5,147.5,0.44166666666666665,0.24583333333333332,top-center,540000,0.11267592592592593,Medium (5-15%)
00002574.jpg,900,600,434,155,687,348,False,253,193,48829,1.5,253,193,48829,1.310880829015544,Large,560.5,251.5,0.6227777777777778,0.4191666666666667,middle-center,540000,0.09042407407407407,Medium (5-15%)
00000363.jpg,1281,681,192,149,484,330,False,292,181,52852,1.881057268722467,292,181,52852,1.6132596685082874,Very Large,338.0,239.5,0.26385636221701797,0.35168869309838474,middle-left,872361,0.06058501010476167,Medium (5-15%)
00002212.jpg,736,1104,242,73,410,366,False,168,293,49224,0.6666666666666666,168,293,49224,0.5733788395904437,Large,326.0,219.5,0.4429347826086957,0.19882246376811594,top-center,812544,0.06058010396975425,Medium (5-15%)
00000411.jpg,1080,1350,481,441,615,632,False,134,191,25594,0.8,134,191,25594,0.7015706806282722,Large,548.0,536.5,0.5074074074074074,0.39740740740740743,middle-center,1458000,0.017554183813443074,Small (1-5%)
00000377.jpg,1000,667,645,104,945,337,False,300,233,69900,1.4992503748125936,300,233,69900,1.2875536480686696,Very Large,795.0,220.5,0.795,0.3305847076461769,middle-right,667000,0.1047976011994003,Medium (5-15%)
00000377.jpg,1000,667,74,398,395,647,False,321,249,79929,1.4992503748125936,321,249,79929,1.2891566265060241,Very Large,234.5,522.5,0.2345,0.7833583208395802,bottom-left,667000,0.11983358320839581,Medium (5-15%)
00000377.jpg,1000,667,419,88,733,332,False,314,244,76616,1.4992503748125936,314,244,76616,1.2868852459016393,Very Large,576.0,210.0,0.576,0.3148425787106447,top-center,667000,0.11486656671664168,Medium (5-15%)
00000377.jpg,1000,667,106,119,382,328,False,276,209,57684,1.4992503748125936,276,209,57684,1.3205741626794258,Very Large,244.0,223.5,0.244,0.3350824587706147,middle-left,667000,0.08648275862068966,Medium (5-15%)
00000377.jpg,1000,667,1,173,219,411,False,218,238,51884,1.4992503748125936,218,238,51884,0.9159663865546218,Very Large,110.0,292.0,0.11,0.43778110944527737,middle-left,667000,0.07778710644677661,Medium (5-15%)
00002560.jpg,512,354,50,1,508,353,False,458,352,161216,1.4463276836158192,458,352,161216,1.3011363636363635,Very Large,279.0,177.0,0.544921875,0.5,middle-center,181248,0.8894774011299436,Very Large (>30%)
00001041.jpg,867,1390,191,183,343,467,False,152,284,43168,0.6237410071942446,152,284,43168,0.5352112676056338,Large,267.0,325.0,0.3079584775086505,0.23381294964028776,top-left,1205130,0.03582020196991196,Small (1-5%)
00002548.jpg,840,560,334,163,634,396,False,300,233,69900,1.5,300,233,69900,1.2875536480686696,Very Large,484.0,279.5,0.5761904761904761,0.49910714285714286,middle-center,470400,0.1485969387755102,Medium (5-15%)
00003130.jpg,868,1300,376,241,475,414,False,99,173,17127,0.6676923076923077,99,173,17127,0.5722543352601156,Medium,425.5,327.5,0.4902073732718894,0.2519230769230769,top-center,1128400,0.015178128323289613,Small (1-5%)
00001727.jpg,1300,788,656,143,1073,437,False,417,294,122598,1.649746192893401,417,294,122598,1.4183673469387754,Very Large,864.5,290.0,0.665,0.3680203045685279,middle-center,1024400,0.11967786021085514,Medium (5-15%)
00001733.jpg,800,534,487,43,657,176,False,170,133,22610,1.4981273408239701,170,133,22610,1.2781954887218046,Large,572.0,109.5,0.715,0.2050561797752809,top-right,427200,0.05292602996254682,Medium (5-15%)
00003124.jpg,500,751,124,213,197,339,False,73,126,9198,0.6657789613848203,73,126,9198,0.5793650793650794,Medium,160.5,276.0,0.321,0.36750998668442075,middle-left,375500,0.024495339547270307,Small (1-5%)
00001055.jpg,957,1300,285,173,379,321,False,94,148,13912,0.7361538461538462,94,148,13912,0.6351351351351351,Medium,332.0,247.0,0.34691745036572624,0.19,top-center,1244100,0.011182380837553251,Small (1-5%)
00001900.jpg,1500,1000,819,48,1300,421,False,481,373,179413,1.5,481,373,179413,1.289544235924933,Very Large,1059.5,234.5,0.7063333333333334,0.2345,top-right,1500000,0.11960866666666667,Medium (5-15%)
00001914.jpg,1300,956,337,11,1259,799,False,922,788,726536,1.3598326359832635,922,788,726536,1.1700507614213198,Very Large,798.0,405.0,0.6138461538461538,0.4236401673640167,middle-center,1242800,0.5845960733826843,Very Large (>30%)
00002010.jpg,590,394,258,100,347,169,False,89,69,6141,1.49746192893401,89,69,6141,1.289855072463768,Medium,302.5,134.5,0.5127118644067796,0.3413705583756345,middle-center,232460,0.02641744816312484,Small (1-5%)
00001519.jpg,1000,694,232,47,526,279,False,294,232,68208,1.440922190201729,294,232,68208,1.2672413793103448,Very Large,379.0,163.0,0.379,0.23487031700288186,top-center,694000,0.09828242074927954,Medium (5-15%)
00002776.jpg,2500,1667,1552,237,1972,563,False,420,326,136920,1.4997000599880024,420,326,136920,1.2883435582822085,Very Large,1762.0,400.0,0.7048,0.23995200959808038,top-right,4167500,0.03285422915416917,Small (1-5%)
00002776.jpg,2500,1667,1199,703,1517,944,False,318,241,76638,1.4997000599880024,318,241,76638,1.3195020746887967,Very Large,1358.0,823.5,0.5432,0.49400119976004797,middle-center,4167500,0.018389442111577683,Small (1-5%)
00002762.jpg,1000,1000,351,130,741,584,False,390,454,177060,1.0,390,454,177060,0.8590308370044053,Very Large,546.0,357.0,0.546,0.357,middle-center,1000000,0.17706,Large (15-30%)
00000175.jpg,1300,956,669,132,799,243,False,130,111,14430,1.3598326359832635,130,111,14430,1.1711711711711712,Medium,734.0,187.5,0.5646153846153846,0.1961297071129707,top-center,1242800,0.011610878661087867,Small (1-5%)
00002004.jpg,600,419,271,74,358,144,False,87,70,6090,1.431980906921241,87,70,6090,1.2428571428571429,Medium,314.5,109.0,0.5241666666666667,0.26014319809069214,top-center,251400,0.02422434367541766,Small (1-5%)
00001525.jpg,780,527,149,24,473,279,False,324,255,82620,1.4800759013282732,324,255,82620,1.2705882352941176,Very Large,311.0,151.5,0.39871794871794874,0.2874762808349146,top-center,411060,0.20099255583126552,Large (15-30%)
00003332.jpg,679,960,313,375,485,658,False,172,283,48676,0.7072916666666667,172,283,48676,0.607773851590106,Large,399.0,516.5,0.5876288659793815,0.5380208333333333,middle-center,651840,0.07467476681394207,Medium (5-15%)
00003454.jpg,236,354,75,34,129,128,False,54,94,5076,0.6666666666666666,54,94,5076,0.574468085106383,Medium,102.0,81.0,0.4322033898305085,0.2288135593220339,top-center,83544,0.06075840275782821,Medium (5-15%)
00001243.jpg,343,280,144,31,211,94,False,67,63,4221,1.225,67,63,4221,1.0634920634920635,Small,177.5,62.5,0.5174927113702624,0.22321428571428573,top-center,96040,0.04395043731778426,Small (1-5%)
00003440.jpg,236,354,98,54,143,133,False,45,79,3555,0.6666666666666666,45,79,3555,0.569620253164557,Small,120.5,93.5,0.510593220338983,0.2641242937853107,top-center,83544,0.042552427463372594,Small (1-5%)
00002986.jpg,960,640,4,111,142,219,False,138,108,14904,1.5,138,108,14904,1.2777777777777777,Medium,73.0,165.0,0.07604166666666666,0.2578125,top-left,614400,0.0242578125,Small (1-5%)
00002986.jpg,960,640,187,253,379,402,False,192,149,28608,1.5,192,149,28608,1.2885906040268456,Large,283.0,327.5,0.2947916666666667,0.51171875,middle-left,614400,0.0465625,Small (1-5%)
00002986.jpg,960,640,671,4,843,134,False,172,130,22360,1.5,172,130,22360,1.323076923076923,Large,757.0,69.0,0.7885416666666667,0.1078125,top-right,614400,0.036393229166666666,Small (1-5%)
00002986.jpg,960,640,524,155,663,263,False,139,108,15012,1.5,139,108,15012,1.287037037037037,Medium,593.5,209.0,0.6182291666666667,0.3265625,top-center,614400,0.02443359375,Small (1-5%)
00002986.jpg,960,640,796,89,950,209,False,154,120,18480,1.5,154,120,18480,1.2833333333333334,Medium,873.0,149.0,0.909375,0.2328125,top-right,614400,0.030078125,Small (1-5%)
00002038.jpg,1024,781,335,44,763,424,False,428,380,162640,1.3111395646606914,428,380,162640,1.1263157894736842,Very Large,549.0,234.0,0.5361328125,0.29961587708066584,top-center,799744,0.20336507682458388,Large (15-30%)
00002038.jpg,1024,781,102,211,523,585,False,421,374,157454,1.3111395646606914,421,374,157454,1.125668449197861,Very Large,312.5,398.0,0.30517578125,0.5096030729833547,middle-left,799744,0.19688050176056338,Large (15-30%)
00003326.jpg,375,500,286,122,326,184,False,40,62,2480,0.75,40,62,2480,0.6451612903225806,Small,306.0,153.0,0.816,0.306,top-right,187500,0.013226666666666666,Small (1-5%)
00001531.jpg,612,410,63,1,574,398,False,511,397,202867,1.4926829268292683,511,397,202867,1.2871536523929472,Very Large,318.5,199.5,0.5204248366013072,0.4865853658536585,middle-center,250920,0.8084927466921729,Very Large (>30%)
00002979.jpg,1200,631,422,128,833,380,False,411,252,103572,1.901743264659271,411,252,103572,1.630952380952381,Very Large,627.5,254.0,0.5229166666666667,0.40253565768621236,middle-center,757200,0.13678288431061808,Medium (5-15%)
00000820.jpg,1078,1600,265,136,399,367,False,134,231,30954,0.67375,134,231,30954,0.5800865800865801,Large,332.0,251.5,0.3079777365491651,0.1571875,top-left,1724800,0.01794642857142857,Small (1-5%)
00000820.jpg,1078,1600,708,227,823,430,False,115,203,23345,0.67375,115,203,23345,0.5665024630541872,Large,765.5,328.5,0.7101113172541744,0.2053125,top-right,1724800,0.013534902597402598,Small (1-5%)
00001280.jpg,436,280,150,16,228,74,False,78,58,4524,1.5571428571428572,78,58,4524,1.3448275862068966,Small,189.0,45.0,0.4334862385321101,0.16071428571428573,top-center,122080,0.037057667103538666,Small (1-5%)
00003497.jpg,236,354,64,130,138,256,False,74,126,9324,0.6666666666666666,74,126,9324,0.5873015873015873,Medium,101.0,193.0,0.4279661016949153,0.5451977401129944,middle-center,83544,0.11160586038494685,Medium (5-15%)
00003483.jpg,236,355,76,38,150,168,False,74,130,9620,0.6647887323943662,74,130,9620,0.5692307692307692,Medium,113.0,103.0,0.4788135593220339,0.29014084507042254,top-center,83780,0.11482454046311769,Medium (5-15%)
00002945.jpg,1080,1350,263,173,851,1030,False,588,857,503916,0.8,588,857,503916,0.6861143523920653,Very Large,557.0,601.5,0.5157407407407407,0.44555555555555554,middle-center,1458000,0.3456213991769547,Very Large (>30%)
00002945.jpg,1080,1350,5,300,502,1300,False,497,1000,497000,0.8,497,1000,497000,0.497,Very Large,253.5,800.0,0.23472222222222222,0.5925925925925926,middle-left,1458000,0.34087791495198905,Very Large (>30%)
00000834.jpg,1000,635,220,11,790,431,False,570,420,239400,1.5748031496062993,570,420,239400,1.3571428571428572,Very Large,505.0,221.0,0.505,0.3480314960629921,middle-center,635000,0.37700787401574803,Very Large (>30%)
00000015.jpg,1333,2000,471,315,774,845,False,303,530,160590,0.6665,303,530,160590,0.5716981132075472,Very Large,622.5,580.0,0.4669917479369842,0.29,top-center,2666000,0.06023630907726932,Medium (5-15%)
00002602.jpg,800,533,435,113,606,245,False,171,132,22572,1.5009380863039399,171,132,22572,1.2954545454545454,Large,520.5,179.0,0.650625,0.33583489681050654,middle-center,426400,0.05293621013133208,Medium (5-15%)
00001479.jpg,1600,1167,708,81,971,310,False,263,229,60227,1.3710368466152527,263,229,60227,1.148471615720524,Very Large,839.5,195.5,0.5246875,0.1675235646958012,top-center,1867200,0.03225524850042845,Small (1-5%)
00000767.jpg,1024,701,341,87,529,240,False,188,153,28764,1.4607703281027105,188,153,28764,1.2287581699346406,Large,435.0,163.5,0.4248046875,0.2332382310984308,top-center,717824,0.04007110378031384,Small (1-5%)
00000997.jpg,699,1050,254,24,394,263,False,140,239,33460,0.6657142857142857,140,239,33460,0.5857740585774058,Large,324.0,143.5,0.463519313304721,0.13666666666666666,top-center,733950,0.04558893657606104,Small (1-5%)
00003246.jpg,626,417,290,56,563,273,False,273,217,59241,1.501199040767386,273,217,59241,1.2580645161290323,Very Large,426.5,164.5,0.6813099041533547,0.39448441247002397,middle-right,261042,0.22694049233456684,Large (15-30%)
00003246.jpg,626,417,152,49,433,272,False,281,223,62663,1.501199040767386,281,223,62663,1.2600896860986548,Very Large,292.5,160.5,0.4672523961661342,0.38489208633093525,middle-center,261042,0.24004949395116496,Large (15-30%)
00001337.jpg,1300,956,521,155,947,520,False,426,365,155490,1.3598326359832635,426,365,155490,1.167123287671233,Very Large,734.0,337.5,0.5646153846153846,0.3530334728033473,middle-center,1242800,0.12511264885741874,Medium (5-15%)
00001323.jpg,391,280,137,21,247,113,False,110,92,10120,1.3964285714285714,110,92,10120,1.1956521739130435,Medium,192.0,67.0,0.49104859335038364,0.2392857142857143,top-center,109480,0.09243697478991597,Medium (5-15%)
00001445.jpg,600,600,362,13,445,112,False,83,99,8217,1.0,83,99,8217,0.8383838383838383,Medium,403.5,62.5,0.6725,0.10416666666666667,top-right,360000,0.022825,Small (1-5%)
00000983.jpg,866,1390,431,78,564,328,False,133,250,33250,0.6230215827338129,133,250,33250,0.532,Large,497.5,203.0,0.5744803695150116,0.1460431654676259,top-center,1203740,0.027622244006180737,Small (1-5%)
00000968.jpg,866,1300,486,24,594,212,False,108,188,20304,0.6661538461538462,108,188,20304,0.574468085106383,Large,540.0,118.0,0.6235565819861432,0.09076923076923077,top-center,1125800,0.01803517498667614,Small (1-5%)
00001492.jpg,880,660,531,171,719,331,False,188,160,30080,1.3333333333333333,188,160,30080,1.175,Large,625.0,251.0,0.7102272727272727,0.3803030303030303,middle-right,580800,0.051790633608815424,Medium (5-15%)
00001492.jpg,880,660,132,163,301,310,False,169,147,24843,1.3333333333333333,169,147,24843,1.1496598639455782,Large,216.5,236.5,0.24602272727272728,0.35833333333333334,middle-left,580800,0.04277376033057851,Small (1-5%)
00001492.jpg,880,660,334,38,466,154,False,132,116,15312,1.3333333333333333,132,116,15312,1.1379310344827587,Medium,400.0,96.0,0.45454545454545453,0.14545454545454545,top-center,580800,0.026363636363636363,Small (1-5%)
00002825.jpg,1280,853,608,126,763,249,False,155,123,19065,1.5005861664712778,155,123,19065,1.2601626016260163,Medium,685.5,187.5,0.535546875,0.2198124267291911,top-center,1091840,0.017461349648300116,Small (1-5%)
00000798.jpg,970,1455,327,1,619,494,False,292,493,143956,0.6666666666666666,292,493,143956,0.592292089249493,Very Large,473.0,247.5,0.48762886597938143,0.17010309278350516,top-center,1411350,0.10199879547950544,Medium (5-15%)
00003291.jpg,1024,681,610,174,762,289,False,152,115,17480,1.5036710719530102,152,115,17480,1.3217391304347825,Medium,686.0,231.5,0.669921875,0.3399412628487518,middle-center,697344,0.02506653817914831,Small (1-5%)
00003291.jpg,1024,681,438,252,565,352,False,127,100,12700,1.5036710719530102,127,100,12700,1.27,Medium,501.5,302.0,0.48974609375,0.4434654919236417,middle-center,697344,0.01821195851688693,Small (1-5%)
00003291.jpg,1024,681,227,78,375,193,False,148,115,17020,1.5036710719530102,148,115,17020,1.2869565217391303,Medium,301.0,135.5,0.2939453125,0.19897209985315711,top-left,697344,0.024406892437591778,Small (1-5%)
00001109.jpg,800,533,312,46,494,190,False,182,144,26208,1.5009380863039399,182,144,26208,1.2638888888888888,Large,403.0,118.0,0.50375,0.22138836772983114,top-center,426400,0.06146341463414634,Medium (5-15%)
00000571.jpg,626,417,231,179,393,304,False,162,125,20250,1.501199040767386,162,125,20250,1.296,Large,312.0,241.5,0.4984025559105431,0.579136690647482,middle-center,261042,0.07757372376858897,Medium (5-15%)
00002366.jpg,640,748,303,46,413,195,False,110,149,16390,0.8556149732620321,110,149,16390,0.738255033557047,Medium,358.0,120.5,0.559375,0.16109625668449198,top-center,478720,0.03423713235294118,Small (1-5%)
00002366.jpg,640,748,470,49,565,178,False,95,129,12255,0.8556149732620321,95,129,12255,0.7364341085271318,Medium,517.5,113.5,0.80859375,0.1517379679144385,top-right,478720,0.02559951537433155,Small (1-5%)
00000565.jpg,1024,769,751,231,979,431,False,228,200,45600,1.3315994798439532,228,200,45600,1.14,Large,865.0,331.0,0.8447265625,0.4304291287386216,middle-right,787456,0.057907997399219764,Medium (5-15%)
00000565.jpg,1024,769,542,276,756,463,False,214,187,40018,1.3315994798439532,214,187,40018,1.1443850267379678,Large,649.0,369.5,0.6337890625,0.48049414824447334,middle-center,787456,0.05081934736671001,Medium (5-15%)
00000565.jpg,1024,769,438,441,781,735,False,343,294,100842,1.3315994798439532,343,294,100842,1.1666666666666667,Very Large,609.5,588.0,0.59521484375,0.764629388816645,bottom-center,787456,0.12806048845903772,Medium (5-15%)
00000565.jpg,1024,769,277,378,531,596,False,254,218,55372,1.3315994798439532,254,218,55372,1.165137614678899,Very Large,404.0,487.0,0.39453125,0.6332899869960988,middle-center,787456,0.07031757964889467,Medium (5-15%)
00000565.jpg,1024,769,1,219,337,553,False,336,334,112224,1.3315994798439532,336,334,112224,1.0059880239520957,Very Large,169.0,386.0,0.1650390625,0.5019505851755527,middle-left,787456,0.14251462938881665,Medium (5-15%)
00000203.jpg,667,1000,292,4,619,573,False,327,569,186063,0.667,327,569,186063,0.5746924428822495,Very Large,455.5,288.5,0.6829085457271364,0.2885,top-right,667000,0.27895502248875564,Large (15-30%)
00000203.jpg,667,1000,96,124,382,611,False,286,487,139282,0.667,286,487,139282,0.5872689938398358,Very Large,239.0,367.5,0.3583208395802099,0.3675,middle-center,667000,0.20881859070464767,Large (15-30%)
00000203.jpg,667,1000,190,45,517,579,False,327,534,174618,0.667,327,534,174618,0.6123595505617978,Very Large,353.5,312.0,0.5299850074962519,0.312,top-center,667000,0.2617961019490255,Large (15-30%)
00002414.jpg,1400,933,584,128,1183,592,False,599,464,277936,1.5005359056806002,599,464,277936,1.290948275862069,Very Large,883.5,360.0,0.6310714285714286,0.3858520900321543,middle-center,1306200,0.21278211606185882,Large (15-30%)
00003044.jpg,5184,3456,2185,646,2829,1134,False,644,488,314272,1.5,644,488,314272,1.319672131147541,Very Large,2507.0,890.0,0.4836033950617284,0.25752314814814814,top-center,17915904,0.017541509487882946,Small (1-5%)
00001653.jpg,1000,667,341,101,649,340,False,308,239,73612,1.4992503748125936,308,239,73612,1.288702928870293,Very Large,495.0,220.5,0.495,0.3305847076461769,middle-center,667000,0.11036281859070465,Medium (5-15%)
00000559.jpg,1024,682,470,198,639,329,False,169,131,22139,1.501466275659824,169,131,22139,1.2900763358778626,Large,554.5,263.5,0.54150390625,0.38636363636363635,middle-center,698368,0.03170105159457478,Small (1-5%)
00000559.jpg,1024,682,580,144,728,259,False,148,115,17020,1.501466275659824,148,115,17020,1.2869565217391303,Medium,654.0,201.5,0.638671875,0.29545454545454547,top-center,698368,0.024371105205278593,Small (1-5%)
00000559.jpg,1024,682,380,160,507,259,False,127,99,12573,1.501466275659824,127,99,12573,1.2828282828282829,Medium,443.5,209.5,0.43310546875,0.30718475073313783,top-center,698368,0.018003402217741934,Small (1-5%)
00001647.jpg,800,533,403,49,624,220,False,221,171,37791,1.5009380863039399,221,171,37791,1.2923976608187135,Large,513.5,134.5,0.641875,0.2523452157598499,top-center,426400,0.0886280487804878,Medium (5-15%)
00002428.jpg,640,480,316,1,583,226,False,267,225,60075,1.3333333333333333,267,225,60075,1.1866666666666668,Very Large,449.5,113.5,0.70234375,0.23645833333333333,top-right,307200,0.195556640625,Large (15-30%)
00001121.jpg,334,519,147,27,213,148,False,66,121,7986,0.6435452793834296,66,121,7986,0.5454545454545454,Medium,180.0,87.5,0.5389221556886228,0.16859344894026976,top-center,173346,0.046069710290401855,Small (1-5%)
00001874.jpg,233,350,84,5,193,195,False,109,190,20710,0.6657142857142857,109,190,20710,0.5736842105263158,Large,138.5,100.0,0.5944206008583691,0.2857142857142857,top-center,81550,0.2539546290619252,Large (15-30%)
00001860.jpg,360,254,99,11,270,152,False,171,141,24111,1.4173228346456692,171,141,24111,1.2127659574468086,Large,184.5,81.5,0.5125,0.32086614173228345,top-center,91440,0.2636811023622047,Large (15-30%)
00001690.jpg,1470,980,641,145,969,399,False,328,254,83312,1.5,328,254,83312,1.2913385826771653,Very Large,805.0,272.0,0.5476190476190477,0.27755102040816326,top-center,1440600,0.057831459114257945,Medium (5-15%)
00001848.jpg,1300,947,480,81,770,327,False,290,246,71340,1.3727560718057021,290,246,71340,1.1788617886178863,Very Large,625.0,204.0,0.4807692307692308,0.21541710665258712,top-center,1231100,0.05794817642758509,Medium (5-15%)
00003087.jpg,960,444,744,121,949,238,False,205,117,23985,2.1621621621621623,205,117,23985,1.7521367521367521,Large,846.5,179.5,0.8817708333333333,0.40427927927927926,middle-right,426240,0.056271114864864864,Medium (5-15%)
00002399.jpg,900,600,399,130,811,450,False,412,320,131840,1.5,412,320,131840,1.2875,Very Large,605.0,290.0,0.6722222222222223,0.48333333333333334,middle-right,540000,0.24414814814814814,Large (15-30%)
00003093.jpg,1440,1800,267,521,681,1125,False,414,604,250056,0.8,414,604,250056,0.6854304635761589,Very Large,474.0,823.0,0.32916666666666666,0.4572222222222222,middle-left,2592000,0.09647222222222222,Medium (5-15%)
00003093.jpg,1440,1800,649,709,1211,1543,False,562,834,468708,0.8,562,834,468708,0.6738609112709832,Very Large,930.0,1126.0,0.6458333333333334,0.6255555555555555,middle-center,2592000,0.1808287037037037,Large (15-30%)
00003093.jpg,1440,1800,810,83,1436,993,False,626,910,569660,0.8,626,910,569660,0.6879120879120879,Very Large,1123.0,538.0,0.7798611111111111,0.29888888888888887,top-right,2592000,0.21977623456790124,Large (15-30%)
00001684.jpg,1001,1600,189,49,579,775,False,390,726,283140,0.625625,390,726,283140,0.5371900826446281,Very Large,384.0,412.0,0.3836163836163836,0.2575,top-center,1601600,0.1767857142857143,Large (15-30%)
00001685.jpg,518,612,213,114,285,213,False,72,99,7128,0.8464052287581699,72,99,7128,0.7272727272727273,Medium,249.0,163.5,0.4806949806949807,0.26715686274509803,top-center,317016,0.022484669543493072,Small (1-5%)
00003092.jpg,236,354,83,58,126,131,False,43,73,3139,0.6666666666666666,43,73,3139,0.589041095890411,Small,104.5,94.5,0.4427966101694915,0.2669491525423729,top-center,83544,0.037573015417025755,Small (1-5%)
00003086.jpg,626,417,390,100,548,223,False,158,123,19434,1.501199040767386,158,123,19434,1.2845528455284554,Medium,469.0,161.5,0.7492012779552716,0.3872901678657074,middle-right,261042,0.07444779001080286,Medium (5-15%)
00003086.jpg,626,417,98,129,234,232,False,136,103,14008,1.501199040767386,136,103,14008,1.3203883495145632,Medium,166.0,180.5,0.26517571884984026,0.43285371702637887,middle-left,261042,0.05366186284199478,Medium (5-15%)
00003086.jpg,626,417,249,116,398,232,False,149,116,17284,1.501199040767386,149,116,17284,1.2844827586206897,Medium,323.5,174.0,0.5167731629392971,0.4172661870503597,middle-center,261042,0.06621156748722427,Medium (5-15%)
00003086.jpg,626,417,471,165,626,290,False,155,125,19375,1.501199040767386,155,125,19375,1.24,Medium,548.5,227.5,0.8761980830670927,0.5455635491606715,middle-right,261042,0.07422177274155117,Medium (5-15%)
00003086.jpg,626,417,4,166,140,274,False,136,108,14688,1.501199040767386,136,108,14688,1.2592592592592593,Medium,72.0,220.0,0.11501597444089456,0.5275779376498801,middle-left,261042,0.05626680764014986,Medium (5-15%)
00001691.jpg,1280,720,828,28,1188,264,False,360,236,84960,1.7777777777777777,360,236,84960,1.5254237288135593,Very Large,1008.0,146.0,0.7875,0.20277777777777778,top-right,921600,0.0921875,Medium (5-15%)
00001691.jpg,1280,720,184,24,489,223,False,305,199,60695,1.7777777777777777,305,199,60695,1.5326633165829147,Very Large,336.5,123.5,0.262890625,0.17152777777777778,top-left,921600,0.06585828993055555,Medium (5-15%)
00001861.jpg,1300,922,416,64,774,360,False,358,296,105968,1.4099783080260304,358,296,105968,1.2094594594594594,Very Large,595.0,212.0,0.4576923076923077,0.2299349240780911,top-center,1198600,0.0884098114466878,Medium (5-15%)
00003051.jpg,600,400,163,32,408,222,False,245,190,46550,1.5,245,190,46550,1.2894736842105263,Large,285.5,127.0,0.47583333333333333,0.3175,top-center,240000,0.19395833333333334,Large (15-30%)
00001646.jpg,680,1024,256,85,392,323,False,136,238,32368,0.6640625,136,238,32368,0.5714285714285714,Large,324.0,204.0,0.4764705882352941,0.19921875,top-center,696320,0.046484375,Small (1-5%)
00000558.jpg,622,415,161,207,230,261,False,69,54,3726,1.4987951807228916,69,54,3726,1.2777777777777777,Small,195.5,234.0,0.31430868167202575,0.563855421686747,middle-left,258130,0.01443458722349204,Small (1-5%)
00000558.jpg,622,415,480,222,543,272,False,63,50,3150,1.4987951807228916,63,50,3150,1.26,Small,511.5,247.0,0.822347266881029,0.5951807228915663,middle-right,258130,0.01220315344981211,Small (1-5%)
00001120.jpg,612,408,128,14,543,343,False,415,329,136535,1.5,415,329,136535,1.2613981762917934,Very Large,335.5,178.5,0.548202614379085,0.4375,middle-center,249696,0.5468049147763681,Very Large (>30%)
00002429.jpg,650,667,95,22,514,522,False,419,500,209500,0.974512743628186,419,500,209500,0.838,Very Large,304.5,272.0,0.4684615384615385,0.4077961019490255,middle-center,433550,0.48321992849728984,Very Large (>30%)
00001652.jpg,781,1024,331,82,418,215,False,87,133,11571,0.7626953125,87,133,11571,0.6541353383458647,Medium,374.5,148.5,0.4795134443021767,0.14501953125,top-center,799744,0.0144683798815621,Small (1-5%)
00003045.jpg,700,466,390,107,550,230,False,160,123,19680,1.502145922746781,160,123,19680,1.3008130081300813,Medium,470.0,168.5,0.6714285714285714,0.361587982832618,middle-right,326200,0.060331085223789084,Medium (5-15%)
00000564.jpg,1300,957,223,192,597,513,False,374,321,120054,1.3584117032392895,374,321,120054,1.1651090342679127,Very Large,410.0,352.5,0.3153846153846154,0.3683385579937304,middle-left,1244100,0.09649867374005305,Medium (5-15%)
00000564.jpg,1300,957,447,94,875,461,False,428,367,157076,1.3584117032392895,428,367,157076,1.1662125340599454,Very Large,661.0,277.5,0.5084615384615384,0.28996865203761757,top-center,1244100,0.12625673177397315,Medium (5-15%)
00000564.jpg,1300,957,715,96,1132,454,False,417,358,149286,1.3584117032392895,417,358,149286,1.164804469273743,Very Large,923.5,275.0,0.7103846153846154,0.28735632183908044,top-right,1244100,0.11999517723655655,Medium (5-15%)
00000564.jpg,1300,957,1,155,247,484,False,246,329,80934,1.3584117032392895,246,329,80934,0.7477203647416414,Very Large,124.0,319.5,0.09538461538461539,0.3338557993730408,middle-left,1244100,0.06505425608873884,Medium (5-15%)
00000564.jpg,1300,957,1031,361,1296,742,False,265,381,100965,1.3584117032392895,265,381,100965,0.6955380577427821,Very Large,1163.5,551.5,0.895,0.5762800417972832,middle-right,1244100,0.08115505184470702,Medium (5-15%)
00002373.jpg,682,1024,311,103,412,279,False,101,176,17776,0.666015625,101,176,17776,0.5738636363636364,Medium,361.5,191.0,0.5300586510263929,0.1865234375,top-center,698368,0.025453629032258066,Small (1-5%)
00002415.jpg,500,280,121,1,499,259,False,378,258,97524,1.7857142857142858,378,258,97524,1.4651162790697674,Very Large,310.0,130.0,0.62,0.4642857142857143,middle-center,140000,0.6966,Very Large (>30%)
00001108.jpg,600,419,181,11,312,117,False,131,106,13886,1.431980906921241,131,106,13886,1.2358490566037736,Medium,246.5,64.0,0.41083333333333333,0.15274463007159905,top-center,251400,0.055234685759745425,Medium (5-15%)
00002367.jpg,700,350,81,2,563,271,False,482,269,129658,2.0,482,269,129658,1.79182156133829,Very Large,322.0,136.5,0.46,0.39,middle-center,245000,0.5292163265306122,Very Large (>30%)
00002830.jpg,829,1200,95,326,182,471,False,87,145,12615,0.6908333333333333,87,145,12615,0.6,Medium,138.5,398.5,0.16706875753920386,0.33208333333333334,middle-left,994800,0.012680940892641736,Small (1-5%)
00002830.jpg,829,1200,414,119,506,271,False,92,152,13984,0.6908333333333333,92,152,13984,0.6052631578947368,Medium,460.0,195.0,0.5548854041013269,0.1625,top-center,994800,0.01405709690390028,Small (1-5%)
00002830.jpg,829,1200,354,272,434,405,False,80,133,10640,0.6908333333333333,80,133,10640,0.6015037593984962,Medium,394.0,338.5,0.4752714113389626,0.28208333333333335,top-center,994800,0.010695617209489345,Small (1-5%)
00002830.jpg,829,1200,535,471,643,652,False,108,181,19548,0.6908333333333333,108,181,19548,0.5966850828729282,Medium,589.0,561.5,0.7104945717732207,0.46791666666666665,middle-right,994800,0.01965018094089264,Small (1-5%)
00002830.jpg,829,1200,522,156,610,305,False,88,149,13112,0.6908333333333333,88,149,13112,0.5906040268456376,Medium,566.0,230.5,0.6827503015681544,0.19208333333333333,top-right,994800,0.0131805388017692,Small (1-5%)
00000941.jpg,900,600,314,108,523,270,False,209,162,33858,1.5,209,162,33858,1.2901234567901234,Large,418.5,189.0,0.465,0.315,top-center,540000,0.0627,Medium (5-15%)
00001487.jpg,400,620,158,52,241,203,False,83,151,12533,0.6451612903225806,83,151,12533,0.5496688741721855,Medium,199.5,127.5,0.49875,0.2056451612903226,top-center,248000,0.05053629032258065,Medium (5-15%)
00000799.jpg,1300,957,185,29,494,299,False,309,270,83430,1.3584117032392895,309,270,83430,1.1444444444444444,Very Large,339.5,164.0,0.2611538461538462,0.17136886102403343,top-left,1244100,0.06706052568121533,Medium (5-15%)
00000955.jpg,1000,1620,218,207,519,774,False,301,567,170667,0.6172839506172839,301,567,170667,0.5308641975308642,Very Large,368.5,490.5,0.3685,0.30277777777777776,top-center,1620000,0.10535,Medium (5-15%)
00001493.jpg,1500,964,579,68,935,341,False,356,273,97188,1.5560165975103735,356,273,97188,1.304029304029304,Very Large,757.0,204.5,0.5046666666666667,0.2121369294605809,top-center,1446000,0.06721161825726141,Medium (5-15%)
00003284.jpg,612,408,387,158,520,262,False,133,104,13832,1.5,133,104,13832,1.2788461538461537,Medium,453.5,210.0,0.7410130718954249,0.5147058823529411,middle-right,249696,0.05539536075868256,Medium (5-15%)
00003284.jpg,612,408,179,86,309,188,False,130,102,13260,1.5,130,102,13260,1.2745098039215685,Medium,244.0,137.0,0.39869281045751637,0.33578431372549017,middle-center,249696,0.05310457516339869,Medium (5-15%)
00000969.jpg,853,1000,388,128,538,333,False,150,205,30750,0.853,150,205,30750,0.7317073170731707,Large,463.0,230.5,0.5427901524032825,0.2305,top-center,853000,0.03604923798358734,Small (1-5%)
00000982.jpg,533,849,256,145,314,253,False,58,108,6264,0.6277974087161367,58,108,6264,0.5370370370370371,Medium,285.0,199.0,0.5347091932457786,0.23439340400471143,top-center,452517,0.013842573870152945,Small (1-5%)
00003247.jpg,800,533,332,123,499,253,False,167,130,21710,1.5009380863039399,167,130,21710,1.2846153846153847,Large,415.5,188.0,0.519375,0.3527204502814259,middle-center,426400,0.05091463414634146,Medium (5-15%)
00000996.jpg,1067,1700,308,169,508,540,False,200,371,74200,0.6276470588235294,200,371,74200,0.5390835579514824,Very Large,408.0,354.5,0.3823805060918463,0.20852941176470588,top-center,1813900,0.040906334417553335,Small (1-5%)
00000996.jpg,1067,1700,493,231,672,564,False,179,333,59607,0.6276470588235294,179,333,59607,0.5375375375375375,Very Large,582.5,397.5,0.5459231490159325,0.2338235294117647,top-center,1813900,0.03286123821599868,Small (1-5%)
00001450.jpg,850,1280,288,354,486,694,False,198,340,67320,0.6640625,198,340,67320,0.5823529411764706,Very Large,387.0,524.0,0.45529411764705885,0.409375,middle-center,1088000,0.061875,Medium (5-15%)
00002617.jpg,1800,1200,1123,368,1508,666,False,385,298,114730,1.5,385,298,114730,1.2919463087248322,Very Large,1315.5,517.0,0.7308333333333333,0.43083333333333335,middle-right,2160000,0.05311574074074074,Medium (5-15%)
00002171.jpg,830,430,321,2,783,281,False,462,279,128898,1.930232558139535,462,279,128898,1.6559139784946237,Very Large,552.0,141.5,0.6650602409638554,0.32906976744186045,top-center,356900,0.3611599887923788,Very Large (>30%)
00000772.jpg,600,475,123,51,246,164,False,123,113,13899,1.263157894736842,123,113,13899,1.0884955752212389,Medium,184.5,107.5,0.3075,0.22631578947368422,top-left,285000,0.04876842105263158,Small (1-5%)
00002165.jpg,2760,1890,815,1,2020,915,False,1205,914,1101370,1.4603174603174602,1205,914,1101370,1.3183807439824946,Very Large,1417.5,458.0,0.5135869565217391,0.24232804232804234,top-center,5216400,0.2111360325128441,Large (15-30%)
00002603.jpg,840,473,596,271,696,337,False,100,66,6600,1.7758985200845665,100,66,6600,1.5151515151515151,Medium,646.0,304.0,0.7690476190476191,0.642706131078224,middle-right,397320,0.016611295681063124,Small (1-5%)
00002603.jpg,840,473,330,28,409,80,False,79,52,4108,1.7758985200845665,79,52,4108,1.5192307692307692,Small,369.5,54.0,0.4398809523809524,0.11416490486257928,top-center,397320,0.010339273129970804,Small (1-5%)
00002603.jpg,840,473,138,300,213,348,False,75,48,3600,1.7758985200845665,75,48,3600,1.5625,Small,175.5,324.0,0.20892857142857144,0.6849894291754757,bottom-left,397320,0.009060706735125339,Tiny (<1%)
00001295.jpg,749,937,128,235,215,361,False,87,126,10962,0.7993596584845251,87,126,10962,0.6904761904761905,Medium,171.5,298.0,0.22897196261682243,0.31803628601921025,top-left,701813,0.015619545377472347,Small (1-5%)
00001295.jpg,749,937,21,264,100,378,False,79,114,9006,0.7993596584845251,79,114,9006,0.6929824561403509,Medium,60.5,321.0,0.08077436582109479,0.3425827107790822,middle-left,701813,0.01283247816726108,Small (1-5%)
00001295.jpg,749,937,248,185,328,301,False,80,116,9280,0.7993596584845251,80,116,9280,0.6896551724137931,Medium,288.0,243.0,0.38451268357810414,0.25933831376734257,top-center,701813,0.013222895557648547,Small (1-5%)
00001295.jpg,749,937,494,176,583,308,False,89,132,11748,0.7993596584845251,89,132,11748,0.6742424242424242,Medium,538.5,242.0,0.7189586114819759,0.25827107790821774,top-right,701813,0.01673950183310939,Small (1-5%)
00001295.jpg,749,937,355,233,446,365,False,91,132,12012,0.7993596584845251,91,132,12012,0.6893939393939394,Medium,400.5,299.0,0.534712950600801,0.31910352187833513,top-center,701813,0.0171156704136287,Small (1-5%)
00002944.jpg,533,800,217,161,349,392,False,132,231,30492,0.66625,132,231,30492,0.5714285714285714,Large,283.0,276.5,0.5309568480300187,0.345625,middle-center,426400,0.07151031894934334,Medium (5-15%)
00003482.jpg,236,157,88,48,133,83,False,45,35,1575,1.5031847133757963,45,35,1575,1.2857142857142858,Small,110.5,65.5,0.4682203389830508,0.4171974522292994,middle-center,37052,0.042507826837957466,Small (1-5%)
00000835.jpg,2946,1960,1827,136,2344,537,False,517,401,207317,1.5030612244897958,517,401,207317,1.2892768079800498,Very Large,2085.5,336.5,0.707909029192125,0.17168367346938776,top-right,5774160,0.03590427005832883,Small (1-5%)
00003496.jpg,235,307,74,26,105,74,False,31,48,1488,0.7654723127035831,31,48,1488,0.6458333333333334,Small,89.5,50.0,0.38085106382978723,0.16286644951140064,top-center,72145,0.02062512994663525,Small (1-5%)
00002788.jpg,735,1000,218,131,459,504,False,241,373,89893,0.735,241,373,89893,0.646112600536193,Very Large,338.5,317.5,0.4605442176870748,0.3175,top-center,735000,0.12230340136054421,Medium (5-15%)
00001281.jpg,1300,957,355,98,691,386,False,336,288,96768,1.3584117032392895,336,288,96768,1.1666666666666667,Very Large,523.0,242.0,0.4023076923076923,0.25287356321839083,top-center,1244100,0.07778152881601158,Medium (5-15%)
00002978.jpg,427,640,148,29,318,319,False,170,290,49300,0.6671875,170,290,49300,0.5862068965517241,Large,233.0,174.0,0.5456674473067916,0.271875,top-center,273280,0.18040105386416863,Large (15-30%)
00000809.jpg,2000,1333,813,216,1231,540,False,418,324,135432,1.5003750937734435,418,324,135432,1.2901234567901234,Very Large,1022.0,378.0,0.511,0.2835708927231808,top-center,2666000,0.05079969992498125,Medium (5-15%)
00002987.jpg,960,444,386,56,853,302,False,467,246,114882,2.1621621621621623,467,246,114882,1.8983739837398375,Very Large,619.5,179.0,0.6453125,0.40315315315315314,middle-center,426240,0.2695242117117117,Large (15-30%)
00001530.jpg,467,635,153,1,284,184,False,131,183,23973,0.7354330708661417,131,183,23973,0.7158469945355191,Large,218.5,92.5,0.4678800856531049,0.14566929133858267,top-center,296545,0.08084101906961844,Medium (5-15%)
00003327.jpg,612,413,219,121,295,182,False,76,61,4636,1.4818401937046004,76,61,4636,1.2459016393442623,Small,257.0,151.5,0.4199346405228758,0.3668280871670702,middle-center,252756,0.01834179999683489,Small (1-5%)
00003333.jpg,255,340,81,66,125,134,False,44,68,2992,0.75,44,68,2992,0.6470588235294118,Small,103.0,100.0,0.403921568627451,0.29411764705882354,top-center,86700,0.034509803921568626,Small (1-5%)
00002993.jpg,1500,1500,793,326,1035,608,False,242,282,68244,1.0,242,282,68244,0.8581560283687943,Very Large,914.0,467.0,0.6093333333333333,0.31133333333333335,top-center,2250000,0.030330666666666665,Small (1-5%)
00000174.jpg,1500,1125,31,202,616,712,False,585,510,298350,1.3333333333333333,585,510,298350,1.1470588235294117,Very Large,323.5,457.0,0.21566666666666667,0.4062222222222222,middle-left,1687500,0.1768,Large (15-30%)
00000174.jpg,1500,1125,888,201,1486,722,False,598,521,311558,1.3333333333333333,598,521,311558,1.1477927063339732,Very Large,1187.0,461.5,0.7913333333333333,0.4102222222222222,middle-right,1687500,0.18462696296296296,Large (15-30%)
00002763.jpg,605,756,287,107,344,189,False,57,82,4674,0.8002645502645502,57,82,4674,0.6951219512195121,Small,315.5,148.0,0.5214876033057851,0.19576719576719576,top-center,457380,0.010219073855437492,Small (1-5%)
00002763.jpg,605,756,130,306,190,392,False,60,86,5160,0.8002645502645502,60,86,5160,0.6976744186046512,Medium,160.0,349.0,0.2644628099173554,0.46164021164021163,middle-left,457380,0.011281647645284009,Small (1-5%)
00002005.jpg,512,512,208,1,312,94,False,104,93,9672,1.0,104,93,9672,1.118279569892473,Medium,260.0,47.5,0.5078125,0.0927734375,top-center,262144,0.036895751953125,Small (1-5%)
00000612.jpg,900,601,284,183,464,323,False,180,140,25200,1.497504159733777,180,140,25200,1.2857142857142858,Large,374.0,253.0,0.41555555555555557,0.4209650582362729,middle-center,540900,0.04658901830282862,Small (1-5%)
00000612.jpg,900,601,138,159,326,305,False,188,146,27448,1.497504159733777,188,146,27448,1.2876712328767124,Large,232.0,232.0,0.2577777777777778,0.3860232945091514,middle-left,540900,0.050745054538731744,Medium (5-15%)
00000612.jpg,900,601,463,156,655,309,False,192,153,29376,1.497504159733777,192,153,29376,1.2549019607843137,Large,559.0,232.5,0.6211111111111111,0.38685524126455906,middle-center,540900,0.054309484193011646,Medium (5-15%)
00002011.jpg,1600,1068,463,100,790,360,False,327,260,85020,1.4981273408239701,327,260,85020,1.2576923076923077,Very Large,626.5,230.0,0.3915625,0.2153558052434457,top-center,1708800,0.04975421348314607,Small (1-5%)
00002777.jpg,1024,683,379,131,715,392,False,336,261,87696,1.499267935578331,336,261,87696,1.2873563218390804,Very Large,547.0,261.5,0.5341796875,0.3828696925329429,middle-center,699392,0.12538890922401172,Medium (5-15%)
00001929.jpg,600,900,126,46,288,328,False,162,282,45684,0.6666666666666666,162,282,45684,0.574468085106383,Large,207.0,187.0,0.345,0.20777777777777778,top-center,540000,0.0846,Medium (5-15%)
00001097.jpg,1300,957,413,96,679,328,False,266,232,61712,1.3584117032392895,266,232,61712,1.146551724137931,Very Large,546.0,212.0,0.42,0.22152560083594566,top-center,1244100,0.04960372960372961,Small (1-5%)
00001083.jpg,673,1024,241,77,548,620,False,307,543,166701,0.6572265625,307,543,166701,0.565377532228361,Very Large,394.5,348.5,0.5861812778603269,0.34033203125,middle-center,689152,0.24189293508543833,Large (15-30%)
00001901.jpg,861,1300,385,105,547,389,False,162,284,46008,0.6623076923076923,162,284,46008,0.5704225352112676,Large,466.0,247.0,0.5412311265969802,0.19,top-center,1119300,0.04110426159206647,Small (1-5%)
00001732.jpg,866,1300,431,152,553,366,False,122,214,26108,0.6661538461538462,122,214,26108,0.5700934579439252,Large,492.0,259.0,0.5681293302540416,0.19923076923076924,top-center,1125800,0.023190620003553028,Small (1-5%)
00002549.jpg,800,800,189,175,356,369,False,167,194,32398,1.0,167,194,32398,0.8608247422680413,Large,272.5,272.0,0.340625,0.34,middle-center,640000,0.050621875,Medium (5-15%)
00002549.jpg,800,800,426,158,619,383,False,193,225,43425,1.0,193,225,43425,0.8577777777777778,Large,522.5,270.5,0.653125,0.338125,middle-center,640000,0.0678515625,Medium (5-15%)
00001040.jpg,590,426,193,41,311,140,False,118,99,11682,1.3849765258215962,118,99,11682,1.1919191919191918,Medium,252.0,90.5,0.4271186440677966,0.21244131455399062,top-center,251340,0.04647887323943662,Small (1-5%)
00001726.jpg,1000,667,447,75,735,298,False,288,223,64224,1.4992503748125936,288,223,64224,1.2914798206278026,Very Large,591.0,186.5,0.591,0.27961019490254874,top-center,667000,0.09628785607196402,Medium (5-15%)
00003131.jpg,682,1024,324,181,407,326,False,83,145,12035,0.666015625,83,145,12035,0.5724137931034483,Medium,365.5,253.5,0.5359237536656891,0.24755859375,top-center,698368,0.017233034732404694,Small (1-5%)
00000362.jpg,1300,867,513,64,1057,495,False,544,431,234464,1.4994232987312572,544,431,234464,1.2621809744779582,Very Large,785.0,279.5,0.6038461538461538,0.3223760092272203,top-center,1127100,0.20802413273001508,Large (15-30%)
00000339.jpg,1000,1500,392,611,533,858,False,141,247,34827,0.6666666666666666,141,247,34827,0.5708502024291497,Large,462.5,734.5,0.4625,0.48966666666666664,middle-center,1500000,0.023218,Small (1-5%)
00001027.jpg,3456,5184,486,1032,2500,4471,False,2014,3439,6926146,0.6666666666666666,2014,3439,6926146,0.585635359116022,Very Large,1493.0,2751.5,0.4320023148148148,0.5307677469135802,middle-center,17915904,0.38659204693215593,Very Large (>30%)
00001741.jpg,236,373,72,3,150,142,False,78,139,10842,0.6327077747989276,78,139,10842,0.5611510791366906,Medium,111.0,72.5,0.4703389830508475,0.19436997319034852,top-center,88028,0.12316535647748443,Medium (5-15%)
00001999.jpg,400,225,27,7,320,199,False,293,192,56256,1.7777777777777777,293,192,56256,1.5260416666666667,Very Large,173.5,103.0,0.43375,0.4577777777777778,middle-center,90000,0.6250666666666667,Very Large (>30%)
00003156.jpg,1200,1199,563,357,706,523,False,143,166,23738,1.0008340283569641,143,166,23738,0.8614457831325302,Large,634.5,440.0,0.52875,0.3669724770642202,middle-center,1438800,0.016498470948012232,Small (1-5%)
00003156.jpg,1200,1199,721,305,870,478,False,149,173,25777,1.0008340283569641,149,173,25777,0.861271676300578,Large,795.5,391.5,0.6629166666666667,0.32652210175145957,top-center,1438800,0.017915624131220463,Small (1-5%)
00003156.jpg,1200,1199,214,298,384,491,False,170,193,32810,1.0008340283569641,170,193,32810,0.8808290155440415,Large,299.0,394.5,0.24916666666666668,0.32902418682235196,top-left,1438800,0.022803725326661105,Small (1-5%)
00003142.jpg,735,490,175,84,567,389,False,392,305,119560,1.5,392,305,119560,1.2852459016393443,Very Large,371.0,236.5,0.5047619047619047,0.4826530612244898,middle-center,360150,0.33197278911564626,Very Large (>30%)
00001755.jpg,1300,956,616,100,870,323,False,254,223,56642,1.3598326359832635,254,223,56642,1.1390134529147982,Very Large,743.0,211.5,0.5715384615384616,0.22123430962343096,top-center,1242800,0.045576118442227226,Small (1-5%)
00001033.jpg,1024,704,354,75,587,266,False,233,191,44503,1.4545454545454546,233,191,44503,1.219895287958115,Large,470.5,170.5,0.45947265625,0.2421875,top-center,720896,0.06173289905894886,Medium (5-15%)
00000305.jpg,1200,1800,553,383,750,728,False,197,345,67965,0.6666666666666666,197,345,67965,0.5710144927536231,Very Large,651.5,555.5,0.5429166666666667,0.3086111111111111,top-center,2160000,0.03146527777777778,Small (1-5%)
00002512.jpg,660,373,338,19,504,129,False,166,110,18260,1.769436997319035,166,110,18260,1.509090909090909,Medium,421.0,74.0,0.6378787878787879,0.19839142091152814,top-center,246180,0.0741733690795353,Medium (5-15%)
00001769.jpg,866,1390,339,160,520,498,False,181,338,61178,0.6230215827338129,181,338,61178,0.5355029585798816,Very Large,429.5,329.0,0.4959584295612009,0.23669064748201438,top-center,1203740,0.05082326748301128,Medium (5-15%)
00002260.jpg,1280,720,21,1,1113,680,False,1092,679,741468,1.7777777777777777,1092,679,741468,1.6082474226804124,Very Large,567.0,340.5,0.44296875,0.47291666666666665,middle-center,921600,0.8045442708333334,Very Large (>30%)
00001782.jpg,600,398,272,47,529,245,False,257,198,50886,1.5075376884422111,257,198,50886,1.297979797979798,Very Large,400.5,146.0,0.6675,0.36683417085427134,middle-center,238800,0.21309045226130655,Large (15-30%)
00001796.jpg,590,393,208,53,559,325,False,351,272,95472,1.5012722646310432,351,272,95472,1.2904411764705883,Very Large,383.5,189.0,0.65,0.48091603053435117,middle-center,231870,0.4117479622202096,Very Large (>30%)
00001966.jpg,400,289,152,19,316,156,False,164,137,22468,1.3840830449826989,164,137,22468,1.197080291970803,Large,234.0,87.5,0.585,0.3027681660899654,top-center,115600,0.1943598615916955,Large (15-30%)
00001972.jpg,1500,1120,570,27,1022,410,False,452,383,173116,1.3392857142857142,452,383,173116,1.1801566579634464,Very Large,796.0,218.5,0.5306666666666666,0.19508928571428572,top-center,1680000,0.10304523809523809,Medium (5-15%)
00003354.jpg,900,900,414,61,569,242,False,155,181,28055,1.0,155,181,28055,0.856353591160221,Large,491.5,151.5,0.5461111111111111,0.16833333333333333,top-center,810000,0.0346358024691358,Small (1-5%)
00001543.jpg,1001,1600,237,72,465,496,False,228,424,96672,0.625625,228,424,96672,0.5377358490566038,Very Large,351.0,284.0,0.35064935064935066,0.1775,top-center,1601600,0.06035964035964036,Medium (5-15%)
00000885.jpg,333,500,67,45,189,259,False,122,214,26108,0.666,122,214,26108,0.5700934579439252,Large,128.0,152.0,0.3843843843843844,0.304,top-center,166500,0.1568048048048048,Large (15-30%)
00001225.jpg,1300,957,354,58,644,306,False,290,248,71920,1.3584117032392895,290,248,71920,1.1693548387096775,Very Large,499.0,182.0,0.38384615384615384,0.19017763845350052,top-center,1244100,0.05780885780885781,Medium (5-15%)
00003426.jpg,236,306,177,169,213,224,False,36,55,1980,0.7712418300653595,36,55,1980,0.6545454545454545,Small,195.0,196.5,0.826271186440678,0.6421568627450981,middle-right,72216,0.027417746759720838,Small (1-5%)
00001231.jpg,2000,1335,896,277,1424,687,False,528,410,216480,1.4981273408239701,528,410,216480,1.2878048780487805,Very Large,1160.0,482.0,0.58,0.3610486891385768,middle-center,2670000,0.08107865168539326,Medium (5-15%)
00001557.jpg,993,1300,304,340,616,805,False,312,465,145080,0.7638461538461538,312,465,145080,0.6709677419354839,Very Large,460.0,572.5,0.46324269889224573,0.4403846153846154,middle-center,1290900,0.11238670694864049,Medium (5-15%)
00000891.jpg,1000,752,164,99,786,643,False,622,544,338368,1.3297872340425532,622,544,338368,1.1433823529411764,Very Large,475.0,371.0,0.475,0.4933510638297872,middle-center,752000,0.44995744680851063,Very Large (>30%)
00000661.jpg,1500,1000,120,97,273,216,False,153,119,18207,1.5,153,119,18207,1.2857142857142858,Medium,196.5,156.5,0.131,0.1565,top-left,1500000,0.012138,Small (1-5%)
00000661.jpg,1500,1000,1318,114,1468,233,False,150,119,17850,1.5,150,119,17850,1.2605042016806722,Medium,1393.0,173.5,0.9286666666666666,0.1735,top-right,1500000,0.0119,Small (1-5%)
00000661.jpg,1500,1000,406,133,535,235,False,129,102,13158,1.5,129,102,13158,1.2647058823529411,Medium,470.5,184.0,0.31366666666666665,0.184,top-left,1500000,0.008772,Tiny (<1%)
00002076.jpg,1500,1120,527,54,959,429,False,432,375,162000,1.3392857142857142,432,375,162000,1.152,Very Large,743.0,241.5,0.49533333333333335,0.215625,top-center,1680000,0.09642857142857143,Medium (5-15%)
00003368.jpg,1376,2000,782,231,949,520,False,167,289,48263,0.688,167,289,48263,0.5778546712802768,Large,865.5,375.5,0.6289970930232558,0.18775,top-center,2752000,0.017537427325581396,Small (1-5%)
00002710.jpg,1300,957,751,90,979,285,False,228,195,44460,1.3584117032392895,228,195,44460,1.1692307692307693,Large,865.0,187.5,0.6653846153846154,0.19592476489028213,top-center,1244100,0.035736677115987464,Small (1-5%)
00002710.jpg,1300,957,259,373,503,582,False,244,209,50996,1.3584117032392895,244,209,50996,1.167464114832536,Very Large,381.0,477.5,0.29307692307692307,0.49895506792058514,middle-left,1244100,0.04099027409372237,Small (1-5%)
00002710.jpg,1300,957,528,336,777,549,False,249,213,53037,1.3584117032392895,249,213,53037,1.1690140845070423,Very Large,652.5,442.5,0.5019230769230769,0.46238244514106586,middle-center,1244100,0.042630817458403664,Small (1-5%)
00002710.jpg,1300,957,181,1,435,195,False,254,194,49276,1.3584117032392895,254,194,49276,1.309278350515464,Large,308.0,98.0,0.23692307692307693,0.10240334378265413,top-left,1244100,0.039607748573265815,Small (1-5%)
00002710.jpg,1300,957,344,25,598,243,False,254,218,55372,1.3584117032392895,254,218,55372,1.165137614678899,Very Large,471.0,134.0,0.36230769230769233,0.1400208986415883,top-center,1244100,0.04450767623181416,Small (1-5%)
00001219.jpg,333,519,136,110,185,200,False,49,90,4410,0.6416184971098265,49,90,4410,0.5444444444444444,Small,160.5,155.0,0.481981981981982,0.29865125240847784,top-center,172827,0.02551684632609488,Small (1-5%)
00000107.jpg,2000,1335,775,364,998,537,False,223,173,38579,1.4981273408239701,223,173,38579,1.2890173410404624,Large,886.5,450.5,0.44325,0.3374531835205993,middle-center,2670000,0.014449063670411984,Small (1-5%)
00002704.jpg,2048,1365,791,4,1371,308,False,580,304,176320,1.5003663003663004,580,304,176320,1.9078947368421053,Very Large,1081.0,156.0,0.52783203125,0.11428571428571428,top-center,2795520,0.06307234432234432,Medium (5-15%)
00002062.jpg,800,561,211,69,677,449,False,466,380,177080,1.4260249554367201,466,380,177080,1.2263157894736842,Very Large,444.0,259.0,0.555,0.46167557932263814,middle-center,448800,0.39456327985739753,Very Large (>30%)
00000675.jpg,750,501,189,106,268,167,False,79,61,4819,1.4970059880239521,79,61,4819,1.2950819672131149,Small,228.5,136.5,0.30466666666666664,0.27245508982035926,top-left,375750,0.012825016633399867,Small (1-5%)
00000675.jpg,750,501,274,81,372,155,False,98,74,7252,1.4970059880239521,98,74,7252,1.3243243243243243,Medium,323.0,118.0,0.43066666666666664,0.23552894211576847,top-center,375750,0.019300066533599468,Small (1-5%)
00000675.jpg,750,501,376,76,473,151,False,97,75,7275,1.4970059880239521,97,75,7275,1.2933333333333332,Medium,424.5,113.5,0.566,0.22654690618762474,top-center,375750,0.019361277445109782,Small (1-5%)
00000675.jpg,750,501,402,170,489,238,False,87,68,5916,1.4970059880239521,87,68,5916,1.2794117647058822,Medium,445.5,204.0,0.594,0.40718562874251496,middle-center,375750,0.015744510978043913,Small (1-5%)
00001580.jpg,333,519,179,88,214,149,False,35,61,2135,0.6416184971098265,35,61,2135,0.5737704918032787,Small,196.5,118.5,0.5900900900900901,0.22832369942196531,top-center,172827,0.01235339385628403,Small (1-5%)
00003397.jpg,417,626,178,131,271,294,False,93,163,15159,0.6661341853035144,93,163,15159,0.5705521472392638,Medium,224.5,212.5,0.5383693045563549,0.33945686900958466,middle-center,261042,0.058071114992989635,Medium (5-15%)
00002089.jpg,370,280,203,22,285,95,False,82,73,5986,1.3214285714285714,82,73,5986,1.1232876712328768,Medium,244.0,58.5,0.6594594594594595,0.20892857142857144,top-center,103600,0.05777992277992278,Medium (5-15%)
00002937.jpg,612,408,205,57,310,138,False,105,81,8505,1.5,105,81,8505,1.2962962962962963,Medium,257.5,97.5,0.4207516339869281,0.23897058823529413,top-center,249696,0.03406141868512111,Small (1-5%)
00002937.jpg,612,408,140,96,204,145,False,64,49,3136,1.5,64,49,3136,1.3061224489795917,Small,172.0,120.5,0.28104575163398693,0.29534313725490197,top-left,249696,0.012559272074843008,Small (1-5%)
00002937.jpg,612,408,491,76,561,130,False,70,54,3780,1.5,70,54,3780,1.2962962962962963,Small,526.0,103.0,0.8594771241830066,0.25245098039215685,top-right,249696,0.01513840830449827,Small (1-5%)
00002923.jpg,720,480,395,193,542,307,False,147,114,16758,1.5,147,114,16758,1.2894736842105263,Medium,468.5,250.0,0.6506944444444445,0.5208333333333334,middle-center,345600,0.048489583333333336,Small (1-5%)
00002923.jpg,720,480,356,86,513,208,False,157,122,19154,1.5,157,122,19154,1.2868852459016393,Medium,434.5,147.0,0.6034722222222222,0.30625,top-center,345600,0.0554224537037037,Medium (5-15%)
00001594.jpg,683,1024,260,216,373,408,False,113,192,21696,0.6669921875,113,192,21696,0.5885416666666666,Large,316.5,312.0,0.4633967789165447,0.3046875,top-center,699392,0.031021229868228403,Small (1-5%)
00003220.jpg,500,333,237,82,293,125,False,56,43,2408,1.5015015015015014,56,43,2408,1.302325581395349,Small,265.0,103.5,0.53,0.3108108108108108,top-center,166500,0.014462462462462463,Small (1-5%)
00000729.jpg,980,980,518,532,682,724,False,164,192,31488,1.0,164,192,31488,0.8541666666666666,Large,600.0,628.0,0.6122448979591837,0.6408163265306123,middle-center,960400,0.03278633902540608,Small (1-5%)
00000729.jpg,980,980,237,495,432,723,False,195,228,44460,1.0,195,228,44460,0.8552631578947368,Large,334.5,609.0,0.3413265306122449,0.6214285714285714,middle-center,960400,0.046293211162015825,Small (1-5%)
00000729.jpg,980,980,689,633,862,829,False,173,196,33908,1.0,173,196,33908,0.8826530612244898,Large,775.5,731.0,0.7913265306122449,0.7459183673469387,bottom-right,960400,0.03530612244897959,Small (1-5%)
00000729.jpg,980,980,558,331,746,549,False,188,218,40984,1.0,188,218,40984,0.8623853211009175,Large,652.0,440.0,0.6653061224489796,0.4489795918367347,middle-center,960400,0.042673885880882965,Small (1-5%)
00000729.jpg,980,980,391,417,566,617,False,175,200,35000,1.0,175,200,35000,0.875,Large,478.5,517.0,0.488265306122449,0.5275510204081633,middle-center,960400,0.03644314868804665,Small (1-5%)
00000729.jpg,980,980,770,497,965,721,False,195,224,43680,1.0,195,224,43680,0.8705357142857143,Large,867.5,609.0,0.8852040816326531,0.6214285714285714,middle-right,960400,0.045481049562682216,Small (1-5%)
00000729.jpg,980,980,699,397,867,593,False,168,196,32928,1.0,168,196,32928,0.8571428571428571,Large,783.0,495.0,0.7989795918367347,0.5051020408163265,middle-right,960400,0.03428571428571429,Small (1-5%)
00000729.jpg,980,980,80,360,304,620,False,224,260,58240,1.0,224,260,58240,0.8615384615384616,Very Large,192.0,490.0,0.19591836734693877,0.5,middle-left,960400,0.060641399416909623,Medium (5-15%)
00001351.jpg,683,1024,317,204,392,334,False,75,130,9750,0.6669921875,75,130,9750,0.5769230769230769,Medium,354.5,269.0,0.5190336749633968,0.2626953125,top-center,699392,0.013940679904831626,Small (1-5%)
00002658.jpg,400,600,70,173,149,309,False,79,136,10744,0.6666666666666666,79,136,10744,0.5808823529411765,Medium,109.5,241.0,0.27375,0.40166666666666667,middle-left,240000,0.04476666666666667,Small (1-5%)
00002658.jpg,400,600,230,70,281,156,False,51,86,4386,0.6666666666666666,51,86,4386,0.5930232558139535,Small,255.5,113.0,0.63875,0.18833333333333332,top-center,240000,0.018275,Small (1-5%)
00002880.jpg,1000,714,389,167,665,402,False,276,235,64860,1.4005602240896358,276,235,64860,1.174468085106383,Very Large,527.0,284.5,0.527,0.39845938375350143,middle-center,714000,0.09084033613445378,Medium (5-15%)
00001423.jpg,1067,1700,540,180,672,425,False,132,245,32340,0.6276470588235294,132,245,32340,0.5387755102040817,Large,606.0,302.5,0.5679475164011246,0.17794117647058824,top-center,1813900,0.017828987265009096,Small (1-5%)
00000715.jpg,1500,1000,798,357,1185,658,False,387,301,116487,1.5,387,301,116487,1.2857142857142858,Very Large,991.5,507.5,0.661,0.5075,middle-center,1500000,0.077658,Medium (5-15%)
00000715.jpg,1500,1000,342,297,764,625,False,422,328,138416,1.5,422,328,138416,1.2865853658536586,Very Large,553.0,461.0,0.36866666666666664,0.461,middle-center,1500000,0.09227733333333334,Medium (5-15%)
00000715.jpg,1500,1000,621,361,1017,662,False,396,301,119196,1.5,396,301,119196,1.3156146179401993,Very Large,819.0,511.5,0.546,0.5115,middle-center,1500000,0.079464,Medium (5-15%)
00002102.jpg,1000,667,501,47,866,331,False,365,284,103660,1.4992503748125936,365,284,103660,1.2852112676056338,Very Large,683.5,189.0,0.6835,0.28335832083958024,top-right,667000,0.15541229385307345,Large (15-30%)
00000067.jpg,1333,2000,700,244,949,680,False,249,436,108564,0.6665,249,436,108564,0.5711009174311926,Very Large,824.5,462.0,0.618529632408102,0.231,top-center,2666000,0.04072168042010502,Small (1-5%)
00001379.jpg,1800,1200,460,113,844,411,False,384,298,114432,1.5,384,298,114432,1.2885906040268456,Very Large,652.0,262.0,0.3622222222222222,0.21833333333333332,top-center,2160000,0.052977777777777776,Medium (5-15%)
00002670.jpg,1470,980,553,580,806,772,False,253,192,48576,1.5,253,192,48576,1.3177083333333333,Large,679.5,676.0,0.46224489795918366,0.689795918367347,bottom-center,1440600,0.03371928363182008,Small (1-5%)
00002670.jpg,1470,980,830,571,1158,825,False,328,254,83312,1.5,328,254,83312,1.2913385826771653,Very Large,994.0,698.0,0.6761904761904762,0.7122448979591837,bottom-right,1440600,0.057831459114257945,Medium (5-15%)
00002116.jpg,1067,1700,461,47,675,443,False,214,396,84744,0.6276470588235294,214,396,84744,0.5404040404040404,Very Large,568.0,245.0,0.5323336457357076,0.14411764705882352,top-center,1813900,0.04671922377198302,Small (1-5%)
00000701.jpg,1000,1000,345,337,645,687,False,300,350,105000,1.0,300,350,105000,0.8571428571428571,Very Large,495.0,512.0,0.495,0.512,middle-center,1000000,0.105,Medium (5-15%)
00000701.jpg,1000,1000,678,439,960,767,False,282,328,92496,1.0,282,328,92496,0.8597560975609756,Very Large,819.0,603.0,0.819,0.603,middle-right,1000000,0.092496,Medium (5-15%)
00000932.jpg,436,600,206,68,284,193,False,78,125,9750,0.7266666666666667,78,125,9750,0.624,Medium,245.0,130.5,0.5619266055045872,0.2175,top-center,261600,0.03727064220183486,Small (1-5%)
00002843.jpg,900,663,256,105,363,197,False,107,92,9844,1.3574660633484164,107,92,9844,1.1630434782608696,Medium,309.5,151.0,0.3438888888888889,0.2277526395173454,top-center,596700,0.016497402379755322,Small (1-5%)
00002843.jpg,900,663,462,120,562,204,False,100,84,8400,1.3574660633484164,100,84,8400,1.1904761904761905,Medium,512.0,162.0,0.5688888888888889,0.24434389140271492,top-center,596700,0.014077425842131725,Small (1-5%)
00001392.jpg,1000,1500,406,580,610,936,False,204,356,72624,0.6666666666666666,204,356,72624,0.5730337078651685,Very Large,508.0,758.0,0.508,0.5053333333333333,middle-center,1500000,0.048416,Small (1-5%)
00001386.jpg,760,434,136,1,682,347,False,546,346,188916,1.7511520737327189,546,346,188916,1.5780346820809248,Very Large,409.0,174.0,0.5381578947368421,0.4009216589861751,middle-center,329840,0.5727504244482173,Very Large (>30%)
00002857.jpg,612,408,164,128,307,238,False,143,110,15730,1.5,143,110,15730,1.3,Medium,235.5,183.0,0.38480392156862747,0.4485294117647059,middle-center,249696,0.0629966038703063,Medium (5-15%)
00002857.jpg,612,408,336,47,505,181,False,169,134,22646,1.5,169,134,22646,1.2611940298507462,Large,420.5,114.0,0.6870915032679739,0.27941176470588236,top-right,249696,0.09069428424964757,Medium (5-15%)
00002857.jpg,612,408,200,142,345,255,False,145,113,16385,1.5,145,113,16385,1.2831858407079646,Medium,272.5,198.5,0.4452614379084967,0.48651960784313725,middle-center,249696,0.06561979366910163,Medium (5-15%)
00002857.jpg,612,408,240,154,389,269,False,149,115,17135,1.5,149,115,17135,1.2956521739130435,Medium,314.5,211.5,0.5138888888888888,0.5183823529411765,middle-center,249696,0.06862344611047033,Medium (5-15%)
00002857.jpg,612,408,1,66,144,212,False,143,146,20878,1.5,143,146,20878,0.9794520547945206,Large,72.5,139.0,0.1184640522875817,0.34068627450980393,middle-left,249696,0.08361367422786108,Medium (5-15%)
00002857.jpg,612,408,372,45,582,218,False,210,173,36330,1.5,210,173,36330,1.2138728323699421,Large,477.0,131.5,0.7794117647058824,0.32230392156862747,top-right,249696,0.14549692425990005,Medium (5-15%)
00002857.jpg,612,408,90,78,218,173,False,128,95,12160,1.5,128,95,12160,1.3473684210526315,Medium,154.0,125.5,0.25163398692810457,0.3075980392156863,top-left,249696,0.04869921824939126,Small (1-5%)
00000926.jpg,1356,1681,376,164,619,516,False,243,352,85536,0.8066627007733492,243,352,85536,0.6903409090909091,Very Large,497.5,340.0,0.3668879056047198,0.20226055919095776,top-center,2279436,0.03752507199149263,Small (1-5%)
00001635.jpg,407,612,166,88,269,268,False,103,180,18540,0.6650326797385621,103,180,18540,0.5722222222222222,Medium,217.5,178.0,0.5343980343980343,0.2908496732026144,top-center,249084,0.07443272149154502,Medium (5-15%)
00003036.jpg,1200,800,350,118,829,489,False,479,371,177709,1.5,479,371,177709,1.2911051212938005,Very Large,589.5,303.5,0.49125,0.379375,middle-center,960000,0.18511354166666666,Large (15-30%)
00001621.jpg,1307,1960,224,374,363,618,False,139,244,33916,0.6668367346938775,139,244,33916,0.569672131147541,Large,293.5,496.0,0.22456006120887528,0.2530612244897959,top-left,2561720,0.013239542182596068,Small (1-5%)
00001147.jpg,500,334,124,60,208,124,False,84,64,5376,1.4970059880239521,84,64,5376,1.3125,Medium,166.0,92.0,0.332,0.2754491017964072,top-center,167000,0.03219161676646706,Small (1-5%)
00002466.jpg,1024,682,126,80,478,353,False,352,273,96096,1.501466275659824,352,273,96096,1.2893772893772895,Very Large,302.0,216.5,0.294921875,0.31744868035190615,top-left,698368,0.1376008064516129,Medium (5-15%)
00002300.jpg,962,1215,359,132,661,576,False,302,444,134088,0.7917695473251029,302,444,134088,0.6801801801801802,Very Large,510.0,354.0,0.5301455301455301,0.291358024691358,top-center,1168830,0.11471984805318139,Medium (5-15%)
00000517.jpg,2000,1333,4,244,460,621,False,456,377,171912,1.5003750937734435,456,377,171912,1.209549071618037,Very Large,232.0,432.5,0.116,0.3244561140285071,top-left,2666000,0.06448312078019505,Medium (5-15%)
00000517.jpg,2000,1333,747,506,1264,899,False,517,393,203181,1.5003750937734435,517,393,203181,1.3155216284987277,Very Large,1005.5,702.5,0.50275,0.527006751687922,middle-center,2666000,0.0762119279819955,Medium (5-15%)
00001609.jpg,1300,956,777,322,981,494,False,204,172,35088,1.3598326359832635,204,172,35088,1.186046511627907,Large,879.0,408.0,0.6761538461538461,0.42677824267782427,middle-right,1242800,0.028233022207917607,Small (1-5%)
00000503.jpg,1300,1043,650,500,946,777,False,296,277,81992,1.2464046021093,296,277,81992,1.068592057761733,Very Large,798.0,638.5,0.6138461538461538,0.612176414189837,middle-center,1355900,0.06047053617523416,Medium (5-15%)
00000503.jpg,1300,1043,292,331,536,554,False,244,223,54412,1.2464046021093,244,223,54412,1.094170403587444,Very Large,414.0,442.5,0.31846153846153846,0.4242569511025887,middle-left,1355900,0.04012980308282322,Small (1-5%)
00000503.jpg,1300,1043,600,331,838,549,False,238,218,51884,1.2464046021093,238,218,51884,1.091743119266055,Very Large,719.0,440.0,0.553076923076923,0.4218600191754554,middle-center,1355900,0.038265358802271554,Small (1-5%)
00000503.jpg,1300,1043,317,561,566,793,False,249,232,57768,1.2464046021093,249,232,57768,1.0732758620689655,Very Large,441.5,677.0,0.3396153846153846,0.6490891658676894,middle-center,1355900,0.04260491186665683,Small (1-5%)
00000503.jpg,1300,1043,456,255,640,426,False,184,171,31464,1.2464046021093,184,171,31464,1.0760233918128654,Large,548.0,340.5,0.42153846153846153,0.3264621284755513,top-center,1355900,0.02320525112471421,Small (1-5%)
00000503.jpg,1300,1043,611,185,773,335,False,162,150,24300,1.2464046021093,162,150,24300,1.08,Large,692.0,260.0,0.5323076923076923,0.24928092042186,top-center,1355900,0.017921675639796446,Small (1-5%)
00000503.jpg,1300,1043,879,282,1238,624,False,359,342,122778,1.2464046021093,359,342,122778,1.0497076023391814,Very Large,1058.5,453.0,0.8142307692307692,0.4343240651965484,middle-right,1355900,0.09055092558448263,Medium (5-15%)
00002314.jpg,448,600,272,143,324,225,False,52,82,4264,0.7466666666666667,52,82,4264,0.6341463414634146,Small,298.0,184.0,0.6651785714285714,0.30666666666666664,top-center,268800,0.01586309523809524,Small (1-5%)
00002314.jpg,448,600,150,151,202,233,False,52,82,4264,0.7466666666666667,52,82,4264,0.6341463414634146,Small,176.0,192.0,0.39285714285714285,0.32,top-center,268800,0.01586309523809524,Small (1-5%)
00002472.jpg,640,468,177,154,282,243,False,105,89,9345,1.3675213675213675,105,89,9345,1.1797752808988764,Medium,229.5,198.5,0.35859375,0.42414529914529914,middle-center,299520,0.031199919871794872,Small (1-5%)
00002472.jpg,640,468,406,144,523,244,False,117,100,11700,1.3675213675213675,117,100,11700,1.17,Medium,464.5,194.0,0.72578125,0.41452991452991456,middle-right,299520,0.0390625,Small (1-5%)
00000265.jpg,667,1000,295,170,519,560,False,224,390,87360,0.667,224,390,87360,0.5743589743589743,Very Large,407.0,365.0,0.6101949025487257,0.365,middle-center,667000,0.13097451274362817,Medium (5-15%)
00001190.jpg,236,340,49,1,134,139,False,85,138,11730,0.6941176470588235,85,138,11730,0.6159420289855072,Medium,91.5,70.0,0.3877118644067797,0.20588235294117646,top-center,80240,0.1461864406779661,Medium (5-15%)
00002499.jpg,800,675,248,1,800,555,False,552,554,305808,1.1851851851851851,552,554,305808,0.9963898916967509,Very Large,524.0,278.0,0.655,0.41185185185185186,middle-center,540000,0.5663111111111111,Very Large (>30%)
00001184.jpg,1024,683,350,131,538,277,False,188,146,27448,1.499267935578331,188,146,27448,1.2876712328767124,Large,444.0,204.0,0.43359375,0.2986822840409956,top-center,699392,0.03924551610541727,Small (1-5%)
00001806.jpg,1050,700,296,96,978,625,False,682,529,360778,1.5,682,529,360778,1.289224952741021,Very Large,637.0,360.5,0.6066666666666667,0.515,middle-center,735000,0.49085442176870747,Very Large (>30%)
00001807.jpg,1200,798,569,122,945,413,False,376,291,109416,1.5037593984962405,376,291,109416,1.2920962199312716,Very Large,757.0,267.5,0.6308333333333334,0.33521303258145363,middle-center,957600,0.11426065162907269,Medium (5-15%)
00001813.jpg,683,1024,160,293,485,860,False,325,567,184275,0.6669921875,325,567,184275,0.5731922398589065,Very Large,322.5,576.5,0.47218155197657397,0.56298828125,middle-center,699392,0.2634788502013177,Large (15-30%)
00001191.jpg,1000,714,421,55,674,266,False,253,211,53383,1.4005602240896358,253,211,53383,1.1990521327014219,Very Large,547.5,160.5,0.5475,0.22478991596638656,top-center,714000,0.07476610644257703,Medium (5-15%)
00000502.jpg,1300,956,647,219,843,387,False,196,168,32928,1.3598326359832635,196,168,32928,1.1666666666666667,Large,745.0,303.0,0.573076923076923,0.3169456066945607,top-center,1242800,0.02649501126488574,Small (1-5%)
00000502.jpg,1300,956,293,369,531,573,False,238,204,48552,1.3598326359832635,238,204,48552,1.1666666666666667,Large,412.0,471.0,0.3169230769230769,0.49267782426778245,middle-left,1242800,0.03906662375281622,Small (1-5%)
00000502.jpg,1300,956,265,225,453,382,False,188,157,29516,1.3598326359832635,188,157,29516,1.197452229299363,Large,359.0,303.5,0.27615384615384614,0.3174686192468619,top-left,1242800,0.023749597682652075,Small (1-5%)
00000502.jpg,1300,956,811,410,1065,628,False,254,218,55372,1.3598326359832635,254,218,55372,1.165137614678899,Very Large,938.0,519.0,0.7215384615384616,0.5428870292887029,middle-right,1242800,0.04455423237850016,Small (1-5%)
00000502.jpg,1300,956,779,136,971,304,False,192,168,32256,1.3598326359832635,192,168,32256,1.1428571428571428,Large,875.0,220.0,0.6730769230769231,0.2301255230125523,top-right,1242800,0.025954296749275827,Small (1-5%)
00001608.jpg,1000,709,566,90,789,273,False,223,183,40809,1.4104372355430184,223,183,40809,1.2185792349726776,Large,677.5,181.5,0.6775,0.2559943582510578,top-right,709000,0.05755853314527504,Medium (5-15%)
00000516.jpg,1300,956,365,164,589,355,False,224,191,42784,1.3598326359832635,224,191,42784,1.1727748691099475,Large,477.0,259.5,0.3669230769230769,0.27144351464435146,top-center,1242800,0.034425490827164465,Small (1-5%)
00000516.jpg,1300,956,603,129,978,457,False,375,328,123000,1.3598326359832635,375,328,123000,1.1432926829268293,Very Large,790.5,293.0,0.6080769230769231,0.3064853556485356,top-center,1242800,0.09897006758931445,Medium (5-15%)
00000516.jpg,1300,956,472,35,726,258,False,254,223,56642,1.3598326359832635,254,223,56642,1.1390134529147982,Very Large,599.0,146.5,0.46076923076923076,0.1532426778242678,top-center,1242800,0.045576118442227226,Small (1-5%)
00000516.jpg,1300,956,980,249,1282,508,False,302,259,78218,1.3598326359832635,302,259,78218,1.166023166023166,Very Large,1131.0,378.5,0.87,0.3959205020920502,middle-right,1242800,0.0629369166398455,Medium (5-15%)
00000516.jpg,1300,956,113,262,409,521,False,296,259,76664,1.3598326359832635,296,259,76664,1.1428571428571428,Very Large,261.0,391.5,0.20076923076923076,0.40951882845188287,middle-left,1242800,0.06168651432249759,Medium (5-15%)
00000516.jpg,1300,956,190,101,378,262,False,188,161,30268,1.3598326359832635,188,161,30268,1.1677018633540373,Large,284.0,181.5,0.21846153846153846,0.18985355648535565,top-left,1242800,0.024354682973929835,Small (1-5%)
00002301.jpg,1200,1800,492,293,717,685,False,225,392,88200,0.6666666666666666,225,392,88200,0.5739795918367347,Very Large,604.5,489.0,0.50375,0.27166666666666667,top-center,2160000,0.04083333333333333,Small (1-5%)
00001620.jpg,1000,667,450,95,785,361,False,335,266,89110,1.4992503748125936,335,266,89110,1.2593984962406015,Very Large,617.5,228.0,0.6175,0.34182908545727136,middle-center,667000,0.1335982008995502,Medium (5-15%)
00001152.jpg,1257,1300,524,171,731,421,False,207,250,51750,0.9669230769230769,207,250,51750,0.828,Very Large,627.5,296.0,0.4992044550517104,0.2276923076923077,top-center,1634100,0.031668808518450525,Small (1-5%)
00003023.jpg,549,309,415,121,520,188,False,105,67,7035,1.7766990291262137,105,67,7035,1.5671641791044777,Medium,467.5,154.5,0.8515482695810564,0.5,middle-right,169641,0.04146992767078713,Small (1-5%)
00003023.jpg,549,309,130,128,235,197,False,105,69,7245,1.7766990291262137,105,69,7245,1.5217391304347827,Medium,182.5,162.5,0.3324225865209472,0.5258899676375405,middle-center,169641,0.042707835959467345,Small (1-5%)
00003023.jpg,549,309,409,31,512,99,False,103,68,7004,1.7766990291262137,103,68,7004,1.5147058823529411,Medium,460.5,65.0,0.8387978142076503,0.21035598705501618,top-right,169641,0.041287188828172436,Small (1-5%)
00003023.jpg,549,309,104,9,192,67,False,88,58,5104,1.7766990291262137,88,58,5104,1.5172413793103448,Medium,148.0,38.0,0.26958105646630237,0.12297734627831715,top-left,169641,0.030087066216303842,Small (1-5%)
00003023.jpg,549,309,243,52,361,129,False,118,77,9086,1.7766990291262137,118,77,9086,1.5324675324675325,Medium,302.0,90.5,0.5500910746812386,0.2928802588996764,top-center,169641,0.05356016529023055,Medium (5-15%)
00001634.jpg,500,333,205,36,322,129,False,117,93,10881,1.5015015015015014,117,93,10881,1.2580645161290323,Medium,263.5,82.5,0.527,0.24774774774774774,top-center,166500,0.06535135135135135,Medium (5-15%)
00002856.jpg,612,408,265,118,445,258,False,180,140,25200,1.5,180,140,25200,1.2857142857142858,Large,355.0,188.0,0.5800653594771242,0.46078431372549017,middle-center,249696,0.10092272202998846,Medium (5-15%)
00000099.jpg,950,1300,334,349,501,609,False,167,260,43420,0.7307692307692307,167,260,43420,0.6423076923076924,Large,417.5,479.0,0.4394736842105263,0.36846153846153845,middle-center,1235000,0.0351578947368421,Small (1-5%)
00000099.jpg,950,1300,582,471,732,705,False,150,234,35100,0.7307692307692307,150,234,35100,0.6410256410256411,Large,657.0,588.0,0.6915789473684211,0.4523076923076923,middle-right,1235000,0.028421052631578948,Small (1-5%)
00000099.jpg,950,1300,314,119,461,348,False,147,229,33663,0.7307692307692307,147,229,33663,0.6419213973799127,Large,387.5,233.5,0.40789473684210525,0.17961538461538462,top-center,1235000,0.02725748987854251,Small (1-5%)
00001387.jpg,2940,1960,737,231,1467,786,False,730,555,405150,1.5,730,555,405150,1.3153153153153154,Very Large,1102.0,508.5,0.37482993197278913,0.25943877551020406,top-center,5762400,0.07030924614743857,Medium (5-15%)
00000933.jpg,683,1024,232,122,362,350,False,130,228,29640,0.6669921875,130,228,29640,0.5701754385964912,Large,297.0,236.0,0.43484626647144947,0.23046875,top-center,699392,0.04237966691068814,Small (1-5%)
00002842.jpg,480,360,157,13,255,96,False,98,83,8134,1.3333333333333333,98,83,8134,1.180722891566265,Medium,206.0,54.5,0.42916666666666664,0.15138888888888888,top-center,172800,0.04707175925925926,Small (1-5%)
00002842.jpg,480,360,255,26,344,103,False,89,77,6853,1.3333333333333333,89,77,6853,1.155844155844156,Medium,299.5,64.5,0.6239583333333333,0.17916666666666667,top-center,172800,0.03965856481481481,Small (1-5%)
00002842.jpg,480,360,70,92,149,163,False,79,71,5609,1.3333333333333333,79,71,5609,1.1126760563380282,Medium,109.5,127.5,0.228125,0.3541666666666667,middle-left,172800,0.03245949074074074,Small (1-5%)
00002842.jpg,480,360,332,63,406,127,False,74,64,4736,1.3333333333333333,74,64,4736,1.15625,Small,369.0,95.0,0.76875,0.2638888888888889,top-right,172800,0.027407407407407408,Small (1-5%)
00002842.jpg,480,360,214,116,288,180,False,74,64,4736,1.3333333333333333,74,64,4736,1.15625,Small,251.0,148.0,0.5229166666666667,0.4111111111111111,middle-center,172800,0.027407407407407408,Small (1-5%)
00002117.jpg,1300,1152,557,14,823,288,False,266,274,72884,1.1284722222222223,266,274,72884,0.9708029197080292,Very Large,690.0,151.0,0.5307692307692308,0.1310763888888889,top-center,1497600,0.04866720085470085,Small (1-5%)
00002117.jpg,1300,1152,741,75,985,327,False,244,252,61488,1.1284722222222223,244,252,61488,0.9682539682539683,Very Large,863.0,201.0,0.6638461538461539,0.17447916666666666,top-center,1497600,0.04105769230769231,Small (1-5%)
00002103.jpg,1500,1120,519,35,933,402,False,414,367,151938,1.3392857142857142,414,367,151938,1.1280653950953679,Very Large,726.0,218.5,0.484,0.19508928571428572,top-center,1680000,0.09043928571428571,Medium (5-15%)
00000072.jpg,612,407,360,54,515,176,False,155,122,18910,1.5036855036855037,155,122,18910,1.2704918032786885,Medium,437.5,115.0,0.7148692810457516,0.28255528255528256,top-right,249084,0.07591816415345827,Medium (5-15%)
00001344.jpg,920,1380,155,244,364,610,False,209,366,76494,0.6666666666666666,209,366,76494,0.5710382513661202,Very Large,259.5,427.0,0.28206521739130436,0.3094202898550725,top-left,1269600,0.06025047258979206,Medium (5-15%)
00001422.jpg,667,1000,344,250,480,493,False,136,243,33048,0.667,136,243,33048,0.5596707818930041,Large,412.0,371.5,0.6176911544227887,0.3715,middle-center,667000,0.04954722638680659,Small (1-5%)
00001436.jpg,1333,2000,516,249,839,825,False,323,576,186048,0.6665,323,576,186048,0.5607638888888888,Very Large,677.5,537.0,0.508252063015754,0.2685,top-center,2666000,0.0697854463615904,Medium (5-15%)
00002659.jpg,1500,1371,783,728,970,926,False,187,198,37026,1.0940919037199124,187,198,37026,0.9444444444444444,Large,876.5,827.0,0.5843333333333334,0.6032093362509118,middle-center,2056500,0.01800437636761488,Small (1-5%)
00001350.jpg,600,900,242,47,318,179,False,76,132,10032,0.6666666666666666,76,132,10032,0.5757575757575758,Medium,280.0,113.0,0.4666666666666667,0.12555555555555556,top-center,540000,0.018577777777777776,Small (1-5%)
00002922.jpg,868,1300,461,135,572,331,False,111,196,21756,0.6676923076923077,111,196,21756,0.5663265306122449,Large,516.5,233.0,0.5950460829493087,0.17923076923076922,top-center,1128400,0.019280397022332505,Small (1-5%)
00000853.jpg,1315,2000,610,173,770,456,False,160,283,45280,0.6575,160,283,45280,0.5653710247349824,Large,690.0,314.5,0.5247148288973384,0.15725,top-center,2630000,0.017216730038022814,Small (1-5%)
00001595.jpg,1000,854,367,54,615,300,False,248,246,61008,1.17096018735363,248,246,61008,1.008130081300813,Very Large,491.0,177.0,0.491,0.20725995316159251,top-center,854000,0.07143793911007026,Medium (5-15%)
00000847.jpg,4083,5104,1541,1215,2412,2456,False,871,1241,1080911,0.799960815047022,871,1241,1080911,0.701853344077357,Very Large,1976.5,1835.5,0.48408033308841536,0.3596199059561129,middle-center,20839632,0.05186804642231686,Medium (5-15%)
00001581.jpg,656,1024,288,142,440,420,False,152,278,42256,0.640625,152,278,42256,0.5467625899280576,Large,364.0,281.0,0.5548780487804879,0.2744140625,top-center,671744,0.06290491615853659,Medium (5-15%)
00002705.jpg,960,641,318,160,713,467,False,395,307,121265,1.497659906396256,395,307,121265,1.286644951140065,Very Large,515.5,313.5,0.5369791666666667,0.4890795631825273,middle-center,615360,0.1970635075403016,Large (15-30%)
00002063.jpg,867,1390,368,319,451,474,False,83,155,12865,0.6237410071942446,83,155,12865,0.535483870967742,Medium,409.5,396.5,0.47231833910034604,0.28525179856115107,top-center,1205130,0.010675196866728071,Small (1-5%)
00003369.jpg,612,485,11,74,136,189,False,125,115,14375,1.2618556701030927,125,115,14375,1.0869565217391304,Medium,73.5,131.5,0.12009803921568628,0.2711340206185567,top-left,296820,0.048430024930934575,Small (1-5%)
00003369.jpg,612,485,260,47,380,158,False,120,111,13320,1.2618556701030927,120,111,13320,1.0810810810810811,Medium,320.0,102.5,0.5228758169934641,0.211340206185567,top-center,296820,0.04487568223165555,Small (1-5%)
00002077.jpg,267,400,90,52,220,278,False,130,226,29380,0.6675,130,226,29380,0.5752212389380531,Large,155.0,165.0,0.5805243445692884,0.4125,middle-center,106800,0.2750936329588015,Large (15-30%)
00002711.jpg,786,469,153,45,310,152,False,157,107,16799,1.67590618336887,157,107,16799,1.4672897196261683,Medium,231.5,98.5,0.294529262086514,0.21002132196162046,top-left,368634,0.045570945707666684,Small (1-5%)
00002739.jpg,626,418,290,83,384,156,False,94,73,6862,1.4976076555023923,94,73,6862,1.2876712328767124,Medium,337.0,119.5,0.5383386581469649,0.28588516746411485,top-center,261668,0.026224070195820657,Small (1-5%)
00003427.jpg,612,408,135,42,476,307,False,341,265,90365,1.5,341,265,90365,1.2867924528301886,Very Large,305.5,174.5,0.4991830065359477,0.42769607843137253,middle-center,249696,0.3619000704857106,Very Large (>30%)
00001556.jpg,608,342,35,1,566,291,False,531,290,153990,1.7777777777777777,531,290,153990,1.8310344827586207,Very Large,300.5,146.0,0.4942434210526316,0.4269005847953216,middle-center,207936,0.740564404432133,Very Large (>30%)
00000884.jpg,1024,663,281,35,403,127,False,122,92,11224,1.5444947209653093,122,92,11224,1.326086956521739,Medium,342.0,81.0,0.333984375,0.12217194570135746,top-center,678912,0.016532334087481147,Small (1-5%)
00001542.jpg,2269,1960,1689,251,1921,489,False,232,238,55216,1.1576530612244897,232,238,55216,0.9747899159663865,Very Large,1805.0,370.0,0.7955046275892463,0.18877551020408162,top-right,4447240,0.012415790467795756,Small (1-5%)
00003433.jpg,236,354,78,61,123,140,False,45,79,3555,0.6666666666666666,45,79,3555,0.569620253164557,Small,100.5,100.5,0.4258474576271186,0.2838983050847458,top-center,83544,0.042552427463372594,Small (1-5%)
00001973.jpg,654,980,204,101,347,345,False,143,244,34892,0.6673469387755102,143,244,34892,0.5860655737704918,Large,275.5,223.0,0.4212538226299694,0.22755102040816327,top-center,640920,0.054440491793047496,Medium (5-15%)
00001967.jpg,1024,678,558,194,746,339,False,188,145,27260,1.5103244837758112,188,145,27260,1.296551724137931,Large,652.0,266.5,0.63671875,0.39306784660766964,middle-center,694272,0.03926415007374631,Small (1-5%)
00001797.jpg,958,1277,277,139,705,788,False,428,649,277772,0.750195771339076,428,649,277772,0.6594761171032357,Very Large,491.0,463.5,0.5125260960334029,0.3629600626468285,middle-center,1223366,0.22705551731861112,Large (15-30%)
00000489.jpg,750,1127,371,329,489,536,False,118,207,24426,0.6654835847382431,118,207,24426,0.5700483091787439,Large,430.0,432.5,0.5733333333333334,0.38376220053238685,middle-center,845250,0.02889795918367347,Small (1-5%)
00001783.jpg,958,1231,425,127,678,506,False,253,379,95887,0.7782290820471162,253,379,95887,0.6675461741424802,Very Large,551.5,316.5,0.5756784968684759,0.2571080422420796,top-center,1179298,0.08130854118297495,Medium (5-15%)
00003194.jpg,612,433,465,32,535,89,False,70,57,3990,1.4133949191685913,70,57,3990,1.2280701754385965,Small,500.0,60.5,0.8169934640522876,0.1397228637413395,top-right,264996,0.015056831046506363,Small (1-5%)
00001768.jpg,1024,683,359,198,654,426,False,295,228,67260,1.499267935578331,295,228,67260,1.293859649122807,Very Large,506.5,312.0,0.49462890625,0.4568081991215227,middle-center,699392,0.09616924414348463,Medium (5-15%)
00002275.jpg,612,408,219,45,464,235,False,245,190,46550,1.5,245,190,46550,1.2894736842105263,Large,341.5,140.0,0.5580065359477124,0.3431372549019608,middle-center,249696,0.18642669486095093,Large (15-30%)
00001754.jpg,600,849,231,197,362,413,False,131,216,28296,0.7067137809187279,131,216,28296,0.6064814814814815,Large,296.5,305.0,0.49416666666666664,0.35924617196702,middle-center,509400,0.055547703180212016,Medium (5-15%)
00003143.jpg,1285,2048,533,511,872,1141,False,339,630,213570,0.62744140625,339,630,213570,0.5380952380952381,Very Large,702.5,826.0,0.546692607003891,0.4033203125,middle-center,2631680,0.08115348370622569,Medium (5-15%)
00003143.jpg,1285,2048,484,1051,720,1479,False,236,428,101008,0.62744140625,236,428,101008,0.5514018691588785,Very Large,602.0,1265.0,0.46848249027237354,0.61767578125,middle-center,2631680,0.038381566147859925,Small (1-5%)
00001032.jpg,1000,1250,357,377,595,723,False,238,346,82348,0.8,238,346,82348,0.6878612716763006,Very Large,476.0,550.0,0.476,0.44,middle-center,1250000,0.0658784,Medium (5-15%)
00001026.jpg,418,626,145,99,232,252,False,87,153,13311,0.6677316293929713,87,153,13311,0.5686274509803921,Medium,188.5,175.5,0.45095693779904306,0.2803514376996805,top-center,261668,0.05086980448507269,Medium (5-15%)
00000338.jpg,640,427,158,103,263,183,False,105,80,8400,1.4988290398126465,105,80,8400,1.3125,Medium,210.5,143.0,0.32890625,0.33489461358313816,middle-left,273280,0.030737704918032786,Small (1-5%)
00000338.jpg,640,427,342,50,455,137,False,113,87,9831,1.4988290398126465,113,87,9831,1.2988505747126438,Medium,398.5,93.5,0.62265625,0.2189695550351288,top-center,273280,0.0359740925058548,Small (1-5%)
00000338.jpg,640,427,237,72,342,153,False,105,81,8505,1.4988290398126465,105,81,8505,1.2962962962962963,Medium,289.5,112.5,0.45234375,0.26346604215456676,top-center,273280,0.0311219262295082,Small (1-5%)
00002249.jpg,1330,919,128,82,1197,905,False,1069,823,879787,1.4472252448313385,1069,823,879787,1.298906439854192,Very Large,662.5,493.5,0.4981203007518797,0.5369967355821545,middle-center,1222270,0.7197975897305833,Very Large (>30%)
00001740.jpg,1470,980,359,254,896,671,False,537,417,223929,1.5,537,417,223929,1.2877697841726619,Very Large,627.5,462.5,0.4268707482993197,0.4719387755102041,middle-center,1440600,0.1554414827155352,Large (15-30%)
00003141.jpg,600,397,56,112,176,204,False,120,92,11040,1.5113350125944585,120,92,11040,1.3043478260869565,Medium,116.0,158.0,0.19333333333333333,0.3979848866498741,middle-left,238200,0.04634760705289673,Small (1-5%)
00003141.jpg,600,397,397,217,523,311,False,126,94,11844,1.5113350125944585,126,94,11844,1.3404255319148937,Medium,460.0,264.0,0.7666666666666667,0.6649874055415617,middle-right,238200,0.04972292191435768,Small (1-5%)
00003141.jpg,600,397,134,156,299,283,False,165,127,20955,1.5113350125944585,165,127,20955,1.2992125984251968,Large,216.5,219.5,0.36083333333333334,0.552896725440806,middle-center,238200,0.08797229219143576,Medium (5-15%)
00003141.jpg,600,397,20,212,186,339,False,166,127,21082,1.5113350125944585,166,127,21082,1.3070866141732282,Large,103.0,275.5,0.17166666666666666,0.6939546599496221,bottom-left,238200,0.08850545759865659,Medium (5-15%)
00003141.jpg,600,397,277,143,414,246,False,137,103,14111,1.5113350125944585,137,103,14111,1.3300970873786409,Medium,345.5,194.5,0.5758333333333333,0.4899244332493703,middle-center,238200,0.05924013434089001,Medium (5-15%)
00003141.jpg,600,397,467,133,598,236,False,131,103,13493,1.5113350125944585,131,103,13493,1.2718446601941749,Medium,532.5,184.5,0.8875,0.464735516372796,middle-right,238200,0.05664567590260285,Medium (5-15%)
00003141.jpg,600,397,1,147,84,228,False,83,81,6723,1.5113350125944585,83,81,6723,1.0246913580246915,Medium,42.5,187.5,0.07083333333333333,0.4722921914357683,middle-left,238200,0.028224181360201512,Small (1-5%)
00001756.jpg,800,533,243,1,797,411,False,554,410,227140,1.5009380863039399,554,410,227140,1.351219512195122,Very Large,520.0,206.0,0.65,0.38649155722326456,middle-center,426400,0.5326923076923077,Very Large (>30%)
00000448.jpg,650,433,528,192,624,266,False,96,74,7104,1.5011547344110854,96,74,7104,1.2972972972972974,Medium,576.0,229.0,0.8861538461538462,0.5288683602771362,middle-right,281450,0.025240717711849353,Small (1-5%)
00000448.jpg,650,433,176,177,250,235,False,74,58,4292,1.5011547344110854,74,58,4292,1.2758620689655173,Small,213.0,206.0,0.32769230769230767,0.47575057736720555,middle-left,281450,0.015249600284242316,Small (1-5%)
00000448.jpg,650,433,242,120,318,178,False,76,58,4408,1.5011547344110854,76,58,4408,1.3103448275862069,Small,280.0,149.0,0.4307692307692308,0.3441108545034642,middle-center,281450,0.015661751643275892,Small (1-5%)
00001742.jpg,360,255,149,45,221,104,False,72,59,4248,1.411764705882353,72,59,4248,1.2203389830508475,Small,185.0,74.5,0.5138888888888888,0.29215686274509806,top-center,91800,0.04627450980392157,Small (1-5%)
00003155.jpg,700,466,181,5,563,294,False,382,289,110398,1.502145922746781,382,289,110398,1.3217993079584776,Very Large,372.0,149.5,0.5314285714285715,0.3208154506437768,top-center,326200,0.33843654199877377,Very Large (>30%)
00002263.jpg,2560,1627,192,646,447,835,False,255,189,48195,1.5734480639213275,255,189,48195,1.3492063492063493,Large,319.5,740.5,0.1248046875,0.4551321450522434,middle-left,4165120,0.011571095190534727,Small (1-5%)
00003169.jpg,500,500,228,145,308,238,False,80,93,7440,1.0,80,93,7440,0.8602150537634409,Medium,268.0,191.5,0.536,0.383,middle-center,250000,0.02976,Small (1-5%)
00000460.jpg,1300,956,715,62,975,289,False,260,227,59020,1.3598326359832635,260,227,59020,1.145374449339207,Very Large,845.0,175.5,0.65,0.18357740585774057,top-center,1242800,0.04748953974895397,Small (1-5%)
00002511.jpg,1300,957,454,204,642,368,False,188,164,30832,1.3584117032392895,188,164,30832,1.146341463414634,Large,548.0,286.0,0.42153846153846153,0.2988505747126437,top-center,1244100,0.02478257374809099,Small (1-5%)
00001795.jpg,1024,683,1,1,1005,683,False,1004,682,684728,1.499267935578331,1004,682,684728,1.4721407624633431,Very Large,503.0,342.0,0.4912109375,0.5007320644216691,middle-center,699392,0.9790332174231332,Very Large (>30%)
00003196.jpg,509,339,249,57,439,205,False,190,148,28120,1.5014749262536873,190,148,28120,1.2837837837837838,Large,344.0,131.0,0.6758349705304518,0.3864306784660767,middle-right,172551,0.16296631140938042,Large (15-30%)
00003196.jpg,509,339,181,64,364,209,False,183,145,26535,1.5014749262536873,183,145,26535,1.2620689655172415,Large,272.5,136.5,0.5353634577603144,0.4026548672566372,middle-center,172551,0.1537806213815046,Large (15-30%)
00001959.jpg,996,1600,368,131,543,458,False,175,327,57225,0.6225,175,327,57225,0.5351681957186545,Very Large,455.5,294.5,0.45732931726907633,0.1840625,top-center,1593600,0.035909262048192774,Small (1-5%)
00001781.jpg,682,1024,197,97,509,628,False,312,531,165672,0.666015625,312,531,165672,0.5875706214689266,Very Large,353.0,362.5,0.5175953079178885,0.35400390625,middle-center,698368,0.23722736436950145,Large (15-30%)
00001971.jpg,1300,956,513,14,773,236,False,260,222,57720,1.3598326359832635,260,222,57720,1.1711711711711712,Very Large,643.0,125.0,0.4946153846153846,0.1307531380753138,top-center,1242800,0.046443514644351466,Small (1-5%)
00001965.jpg,590,393,214,93,384,224,False,170,131,22270,1.5012722646310432,170,131,22270,1.297709923664122,Large,299.0,158.5,0.5067796610169492,0.4033078880407125,middle-center,231870,0.096045197740113,Medium (5-15%)
00001554.jpg,626,417,363,56,532,187,False,169,131,22139,1.501199040767386,169,131,22139,1.2900763358778626,Large,447.5,121.5,0.7148562300319489,0.29136690647482016,top-right,261042,0.08481010718581684,Medium (5-15%)
00003343.jpg,1000,1000,745,595,874,743,False,129,148,19092,1.0,129,148,19092,0.8716216216216216,Medium,809.5,669.0,0.8095,0.669,middle-right,1000000,0.019092,Small (1-5%)
00003425.jpg,800,800,305,178,405,294,False,100,116,11600,1.0,100,116,11600,0.8620689655172413,Medium,355.0,236.0,0.44375,0.295,top-center,640000,0.018125,Small (1-5%)
00000138.jpg,390,280,159,70,234,132,False,75,62,4650,1.3928571428571428,75,62,4650,1.2096774193548387,Small,196.5,101.0,0.5038461538461538,0.3607142857142857,middle-center,109200,0.042582417582417584,Small (1-5%)
00003431.jpg,736,1111,169,470,257,620,False,88,150,13200,0.6624662466246625,88,150,13200,0.5866666666666667,Medium,213.0,545.0,0.28940217391304346,0.49054905490549056,middle-left,817696,0.016142918639690057,Small (1-5%)
00003431.jpg,736,1111,332,254,436,437,False,104,183,19032,0.6624662466246625,104,183,19032,0.5683060109289617,Medium,384.0,345.5,0.5217391304347826,0.310981098109811,top-center,817696,0.023275153602316752,Small (1-5%)
00003431.jpg,736,1111,198,320,284,471,False,86,151,12986,0.6624662466246625,86,151,12986,0.5695364238410596,Medium,241.0,395.5,0.327445652173913,0.355985598559856,middle-left,817696,0.01588120768598599,Small (1-5%)
00003431.jpg,736,1111,431,342,515,486,False,84,144,12096,0.6624662466246625,84,144,12096,0.5833333333333334,Medium,473.0,414.0,0.6426630434782609,0.3726372637263726,middle-center,817696,0.014792783626188705,Small (1-5%)
00002049.jpg,1600,1167,605,99,918,365,False,313,266,83258,1.3710368466152527,313,266,83258,1.1766917293233083,Very Large,761.5,232.0,0.4759375,0.19880034275921166,top-center,1867200,0.044589760068551844,Small (1-5%)
00003357.jpg,844,1390,139,146,308,470,False,169,324,54756,0.6071942446043166,169,324,54756,0.5216049382716049,Very Large,223.5,308.0,0.26481042654028436,0.22158273381294963,top-left,1173160,0.046673940468478295,Small (1-5%)
00001540.jpg,1600,1087,696,221,1310,706,False,614,485,297790,1.4719411223551058,614,485,297790,1.265979381443299,Very Large,1003.0,463.5,0.626875,0.4264029438822447,middle-center,1739200,0.17122240110395584,Large (15-30%)
00000886.jpg,800,1200,283,237,415,466,False,132,229,30228,0.6666666666666666,132,229,30228,0.5764192139737991,Large,349.0,351.5,0.43625,0.29291666666666666,top-center,960000,0.0314875,Small (1-5%)
00001568.jpg,626,417,265,32,437,166,False,172,134,23048,1.501199040767386,172,134,23048,1.2835820895522387,Large,351.0,99.0,0.560702875399361,0.23741007194244604,top-center,261042,0.08829230545276238,Medium (5-15%)
00000110.jpg,1600,1168,514,89,1260,737,False,746,648,483408,1.36986301369863,746,648,483408,1.1512345679012346,Very Large,887.0,413.0,0.554375,0.3535958904109589,middle-center,1868800,0.25867294520547945,Large (15-30%)
00002707.jpg,500,333,188,35,402,200,False,214,165,35310,1.5015015015015014,214,165,35310,1.2969696969696969,Large,295.0,117.5,0.59,0.35285285285285284,middle-center,166500,0.21207207207207207,Large (15-30%)
00002713.jpg,1024,683,456,139,684,316,False,228,177,40356,1.499267935578331,228,177,40356,1.2881355932203389,Large,570.0,227.5,0.556640625,0.3330893118594436,middle-center,699392,0.05770154648609078,Medium (5-15%)
00002713.jpg,1024,683,699,80,1022,354,False,323,274,88502,1.499267935578331,323,274,88502,1.1788321167883211,Very Large,860.5,217.0,0.84033203125,0.31771595900439237,top-right,699392,0.12654133876281112,Medium (5-15%)
00000104.jpg,950,1300,334,349,501,609,False,167,260,43420,0.7307692307692307,167,260,43420,0.6423076923076924,Large,417.5,479.0,0.4394736842105263,0.36846153846153845,middle-center,1235000,0.0351578947368421,Small (1-5%)
00000104.jpg,950,1300,582,471,732,705,False,150,234,35100,0.7307692307692307,150,234,35100,0.6410256410256411,Large,657.0,588.0,0.6915789473684211,0.4523076923076923,middle-right,1235000,0.028421052631578948,Small (1-5%)
00000104.jpg,950,1300,314,119,461,348,False,147,229,33663,0.7307692307692307,147,229,33663,0.6419213973799127,Large,387.5,233.5,0.40789473684210525,0.17961538461538462,top-center,1235000,0.02725748987854251,Small (1-5%)
00002075.jpg,1024,694,447,94,748,331,False,301,237,71337,1.4755043227665705,301,237,71337,1.270042194092827,Very Large,597.5,212.5,0.58349609375,0.3061959654178674,top-center,710656,0.10038190066642651,Medium (5-15%)
00001597.jpg,1300,956,634,270,888,487,False,254,217,55118,1.3598326359832635,254,217,55118,1.1705069124423964,Very Large,761.0,378.5,0.5853846153846154,0.3959205020920502,middle-center,1242800,0.04434985516575475,Small (1-5%)
00000851.jpg,612,612,1,41,408,564,False,407,523,212861,1.0,407,523,212861,0.7782026768642447,Very Large,204.5,302.5,0.3341503267973856,0.494281045751634,middle-center,374544,0.5683204109530522,Very Large (>30%)
00002920.jpg,1024,681,193,154,569,445,False,376,291,109416,1.5036710719530102,376,291,109416,1.2920962199312716,Very Large,381.0,299.5,0.3720703125,0.4397944199706314,middle-center,697344,0.15690390969162996,Large (15-30%)
00002920.jpg,1024,681,405,273,713,516,False,308,243,74844,1.5036710719530102,308,243,74844,1.2674897119341564,Very Large,559.0,394.5,0.5458984375,0.579295154185022,middle-center,697344,0.10732723017621146,Medium (5-15%)
00002934.jpg,1170,550,628,39,1037,268,False,409,229,93661,2.1272727272727274,409,229,93661,1.7860262008733625,Very Large,832.5,153.5,0.7115384615384616,0.2790909090909091,top-right,643500,0.14554933954933955,Medium (5-15%)
00002934.jpg,1170,550,367,147,711,335,False,344,188,64672,2.1272727272727274,344,188,64672,1.8297872340425532,Very Large,539.0,241.0,0.46068376068376066,0.4381818181818182,middle-center,643500,0.1005003885003885,Medium (5-15%)
00002934.jpg,1170,550,36,93,420,303,False,384,210,80640,2.1272727272727274,384,210,80640,1.8285714285714285,Very Large,228.0,198.0,0.19487179487179487,0.36,middle-left,643500,0.12531468531468531,Medium (5-15%)
00001583.jpg,2000,1333,536,94,1112,531,False,576,437,251712,1.5003750937734435,576,437,251712,1.3180778032036613,Very Large,824.0,312.5,0.412,0.23443360840210054,top-center,2666000,0.09441560390097524,Medium (5-15%)
00000845.jpg,600,439,178,31,464,279,False,286,248,70928,1.366742596810934,286,248,70928,1.153225806451613,Very Large,321.0,155.0,0.535,0.3530751708428246,middle-center,263400,0.2692786636294609,Large (15-30%)
00003394.jpg,612,433,261,191,416,321,False,155,130,20150,1.4133949191685913,155,130,20150,1.1923076923076923,Large,338.5,256.0,0.5531045751633987,0.5912240184757506,middle-center,264996,0.07603888360579028,Medium (5-15%)
00003394.jpg,612,433,198,142,329,250,False,131,108,14148,1.4133949191685913,131,108,14148,1.212962962962963,Medium,263.5,196.0,0.4305555555555556,0.45265588914549654,middle-center,264996,0.05338948512430376,Medium (5-15%)
00003394.jpg,612,433,119,164,231,257,False,112,93,10416,1.4133949191685913,112,93,10416,1.2043010752688172,Medium,175.0,210.5,0.28594771241830064,0.48614318706697457,middle-left,264996,0.039306253679300816,Small (1-5%)
00003394.jpg,612,433,147,41,254,129,False,107,88,9416,1.4133949191685913,107,88,9416,1.2159090909090908,Medium,200.5,85.0,0.3276143790849673,0.19630484988452657,top-left,264996,0.0355326118130085,Small (1-5%)
00002908.jpg,533,800,186,86,366,400,False,180,314,56520,0.66625,180,314,56520,0.5732484076433121,Very Large,276.0,243.0,0.5178236397748592,0.30375,top-center,426400,0.1325515947467167,Medium (5-15%)
00000879.jpg,2000,3019,656,296,1092,1062,False,436,766,333976,0.6624710168930109,436,766,333976,0.5691906005221932,Very Large,874.0,679.0,0.437,0.2249089102351772,top-center,6038000,0.055312355084465054,Medium (5-15%)
00001420.jpg,800,1200,334,162,490,436,False,156,274,42744,0.6666666666666666,156,274,42744,0.5693430656934306,Large,412.0,299.0,0.515,0.24916666666666668,top-center,960000,0.044525,Small (1-5%)
00003237.jpg,500,604,221,256,315,388,False,94,132,12408,0.8278145695364238,94,132,12408,0.7121212121212122,Medium,268.0,322.0,0.536,0.5331125827814569,middle-center,302000,0.04108609271523179,Small (1-5%)
00002129.jpg,1300,866,583,235,860,450,False,277,215,59555,1.5011547344110854,277,215,59555,1.2883720930232558,Very Large,721.5,342.5,0.555,0.39549653579676675,middle-center,1125800,0.052900159886303075,Medium (5-15%)
00002897.jpg,612,408,222,56,395,190,False,173,134,23182,1.5,173,134,23182,1.291044776119403,Large,308.5,123.0,0.5040849673202614,0.3014705882352941,top-center,249696,0.09284089452774574,Medium (5-15%)
00000058.jpg,2000,1268,707,292,1259,690,False,552,398,219696,1.5772870662460567,552,398,219696,1.3869346733668342,Very Large,983.0,491.0,0.4915,0.3872239747634069,middle-center,2536000,0.08663091482649843,Medium (5-15%)
00000058.jpg,2000,1268,511,336,1039,718,False,528,382,201696,1.5772870662460567,528,382,201696,1.382198952879581,Very Large,775.0,527.0,0.3875,0.415615141955836,middle-center,2536000,0.07953312302839116,Medium (5-15%)
00001352.jpg,1001,1600,426,412,609,754,False,183,342,62586,0.625625,183,342,62586,0.5350877192982456,Very Large,517.5,583.0,0.516983016983017,0.364375,middle-center,1601600,0.03907717282717283,Small (1-5%)
00002883.jpg,1536,1024,164,196,1039,874,False,875,678,593250,1.5,875,678,593250,1.2905604719764012,Very Large,601.5,535.0,0.3916015625,0.5224609375,middle-center,1572864,0.3771781921386719,Very Large (>30%)
00002115.jpg,626,418,355,60,564,223,False,209,163,34067,1.4976076555023923,209,163,34067,1.2822085889570551,Large,459.5,141.5,0.7340255591054313,0.33851674641148327,middle-right,261668,0.13019169329073482,Medium (5-15%)
00000702.jpg,736,736,368,275,477,399,False,109,124,13516,1.0,109,124,13516,0.8790322580645161,Medium,422.5,337.0,0.5740489130434783,0.4578804347826087,middle-center,541696,0.024951264177693763,Small (1-5%)
00000702.jpg,736,736,469,277,580,406,False,111,129,14319,1.0,111,129,14319,0.8604651162790697,Medium,524.5,341.5,0.7126358695652174,0.4639945652173913,middle-right,541696,0.026433645439508508,Small (1-5%)
00000702.jpg,736,736,257,285,359,403,False,102,118,12036,1.0,102,118,12036,0.864406779661017,Medium,308.0,344.0,0.41847826086956524,0.4673913043478261,middle-center,541696,0.022219104442344047,Small (1-5%)
00000702.jpg,736,736,151,358,278,505,False,127,147,18669,1.0,127,147,18669,0.8639455782312925,Medium,214.5,431.5,0.2914402173913043,0.5862771739130435,middle-left,541696,0.03446397979678639,Small (1-5%)
00000702.jpg,736,736,287,194,366,288,False,79,94,7426,1.0,79,94,7426,0.8404255319148937,Medium,326.5,241.0,0.4436141304347826,0.327445652173913,top-center,541696,0.013708796077504725,Small (1-5%)
00002667.jpg,600,419,257,65,445,218,False,188,153,28764,1.431980906921241,188,153,28764,1.2287581699346406,Large,351.0,141.5,0.585,0.33770883054892603,middle-center,251400,0.11441527446300716,Medium (5-15%)
00002101.jpg,1000,667,381,267,535,386,False,154,119,18326,1.4992503748125936,154,119,18326,1.2941176470588236,Medium,458.0,326.5,0.458,0.48950524737631185,middle-center,667000,0.027475262368815593,Small (1-5%)
00002101.jpg,1000,667,530,146,698,277,False,168,131,22008,1.4992503748125936,168,131,22008,1.282442748091603,Large,614.0,211.5,0.614,0.31709145427286356,top-center,667000,0.03299550224887556,Small (1-5%)
00001385.jpg,695,1050,400,209,476,340,False,76,131,9956,0.6619047619047619,76,131,9956,0.5801526717557252,Medium,438.0,274.5,0.6302158273381295,0.26142857142857145,top-center,729750,0.01364302843439534,Small (1-5%)
00002854.jpg,900,600,225,2,785,409,False,560,407,227920,1.5,560,407,227920,1.375921375921376,Very Large,505.0,205.5,0.5611111111111111,0.3425,middle-center,540000,0.4220740740740741,Very Large (>30%)
00002698.jpg,4800,3600,2708,446,4091,1653,False,1383,1207,1669281,1.3333333333333333,1383,1207,1669281,1.1458160729080364,Very Large,3399.5,1049.5,0.7082291666666667,0.2915277777777778,top-right,17280000,0.09660190972222223,Medium (5-15%)
00002698.jpg,4800,3600,1233,468,1792,955,False,559,487,272233,1.3333333333333333,559,487,272233,1.1478439425051334,Very Large,1512.5,711.5,0.3151041666666667,0.1976388888888889,top-left,17280000,0.015754224537037037,Small (1-5%)
00001391.jpg,450,288,144,15,190,50,False,46,35,1610,1.5625,46,35,1610,1.3142857142857143,Small,167.0,32.5,0.3711111111111111,0.11284722222222222,top-center,129600,0.01242283950617284,Small (1-5%)
00000931.jpg,1000,1620,299,152,508,546,False,209,394,82346,0.6172839506172839,209,394,82346,0.5304568527918782,Very Large,403.5,349.0,0.4035,0.2154320987654321,top-center,1620000,0.05083086419753086,Medium (5-15%)
00002868.jpg,400,600,148,75,323,387,False,175,312,54600,0.6666666666666666,175,312,54600,0.5608974358974359,Very Large,235.5,231.0,0.58875,0.385,middle-center,240000,0.2275,Large (15-30%)
00001144.jpg,267,400,74,112,159,259,False,85,147,12495,0.6675,85,147,12495,0.5782312925170068,Medium,116.5,185.5,0.4363295880149813,0.46375,middle-center,106800,0.11699438202247191,Medium (5-15%)
00003035.jpg,390,280,54,75,131,139,False,77,64,4928,1.3928571428571428,77,64,4928,1.203125,Small,92.5,107.0,0.23717948717948717,0.3821428571428571,middle-left,109200,0.04512820512820513,Small (1-5%)
00003035.jpg,390,280,140,50,239,134,False,99,84,8316,1.3928571428571428,99,84,8316,1.1785714285714286,Medium,189.5,92.0,0.4858974358974359,0.32857142857142857,top-center,109200,0.07615384615384616,Medium (5-15%)
00003035.jpg,390,280,270,50,355,121,False,85,71,6035,1.3928571428571428,85,71,6035,1.1971830985915493,Medium,312.5,85.5,0.8012820512820513,0.3053571428571429,top-right,109200,0.055265567765567764,Medium (5-15%)
00003035.jpg,390,280,150,144,240,220,False,90,76,6840,1.3928571428571428,90,76,6840,1.1842105263157894,Medium,195.0,182.0,0.5,0.65,middle-center,109200,0.06263736263736264,Medium (5-15%)
00001622.jpg,866,1300,388,317,491,496,False,103,179,18437,0.6661538461538462,103,179,18437,0.5754189944134078,Medium,439.5,406.5,0.5075057736720554,0.3126923076923077,top-center,1125800,0.016376798720909577,Small (1-5%)
00000528.jpg,1300,957,798,279,1047,492,False,249,213,53037,1.3584117032392895,249,213,53037,1.1690140845070423,Very Large,922.5,385.5,0.7096153846153846,0.40282131661442006,middle-right,1244100,0.042630817458403664,Small (1-5%)
00000528.jpg,1300,957,416,214,676,437,False,260,223,57980,1.3584117032392895,260,223,57980,1.1659192825112108,Very Large,546.0,325.5,0.42,0.3401253918495298,middle-center,1244100,0.04660397074190178,Small (1-5%)
00000528.jpg,1300,957,193,318,483,561,False,290,243,70470,1.3584117032392895,290,243,70470,1.1934156378600822,Very Large,338.0,439.5,0.26,0.4592476489028213,middle-left,1244100,0.056643356643356645,Medium (5-15%)
00000528.jpg,1300,957,662,153,900,353,False,238,200,47600,1.3584117032392895,238,200,47600,1.19,Large,781.0,253.0,0.6007692307692307,0.26436781609195403,top-center,1244100,0.038260589984727915,Small (1-5%)
00001636.jpg,864,1300,236,83,382,332,False,146,249,36354,0.6646153846153846,146,249,36354,0.5863453815261044,Large,309.0,207.5,0.3576388888888889,0.1596153846153846,top-center,1123200,0.03236645299145299,Small (1-5%)
00003021.jpg,550,374,32,77,229,233,False,197,156,30732,1.4705882352941178,197,156,30732,1.2628205128205128,Large,130.5,155.0,0.23727272727272727,0.4144385026737968,middle-left,205700,0.14940204180845892,Medium (5-15%)
00002459.jpg,1200,1800,239,1,1162,1346,False,923,1345,1241435,0.6666666666666666,923,1345,1241435,0.6862453531598512,Very Large,700.5,673.5,0.58375,0.37416666666666665,middle-center,2160000,0.5747384259259259,Very Large (>30%)
00002471.jpg,568,433,37,8,220,170,False,183,162,29646,1.3117782909930715,183,162,29646,1.1296296296296295,Large,128.5,89.0,0.2262323943661972,0.20554272517321015,top-left,245944,0.12053963503887064,Medium (5-15%)
00002471.jpg,568,433,301,11,436,131,False,135,120,16200,1.3117782909930715,135,120,16200,1.125,Medium,368.5,71.0,0.6487676056338029,0.16397228637413394,top-center,245944,0.06586865302670526,Medium (5-15%)
00001178.jpg,1600,1167,576,190,1057,599,False,481,409,196729,1.3710368466152527,481,409,196729,1.176039119804401,Very Large,816.5,394.5,0.5103125,0.3380462724935733,middle-center,1867200,0.10536043273350472,Medium (5-15%)
00000266.jpg,700,467,352,88,576,258,False,224,170,38080,1.4989293361884368,224,170,38080,1.3176470588235294,Large,464.0,173.0,0.6628571428571428,0.37044967880085655,middle-center,326900,0.11648822269807281,Medium (5-15%)
00002317.jpg,682,1024,225,64,413,393,False,188,329,61852,0.666015625,188,329,61852,0.5714285714285714,Very Large,319.0,228.5,0.46774193548387094,0.22314453125,top-center,698368,0.08856648643695014,Medium (5-15%)
00003009.jpg,500,701,183,171,260,297,False,77,126,9702,0.7132667617689016,77,126,9702,0.6111111111111112,Medium,221.5,234.0,0.443,0.3338088445078459,middle-center,350500,0.02768045649072753,Small (1-5%)
00002303.jpg,2061,3000,515,452,1354,1874,False,839,1422,1193058,0.687,839,1422,1193058,0.590014064697609,Very Large,934.5,1163.0,0.4534206695778748,0.38766666666666666,middle-center,6183000,0.19295778748180495,Large (15-30%)
00000272.jpg,399,620,148,93,198,184,False,50,91,4550,0.6435483870967742,50,91,4550,0.5494505494505495,Small,173.0,138.5,0.43358395989974935,0.22338709677419355,top-center,247380,0.01839275608375778,Small (1-5%)
00001839.jpg,866,1300,177,8,566,687,False,389,679,264131,0.6661538461538462,389,679,264131,0.572901325478645,Very Large,371.5,347.5,0.4289838337182448,0.2673076923076923,top-center,1125800,0.2346162728726239,Large (15-30%)
00001193.jpg,800,582,133,88,384,301,False,251,213,53463,1.3745704467353952,251,213,53463,1.1784037558685445,Very Large,258.5,194.5,0.323125,0.33419243986254293,middle-left,465600,0.11482603092783505,Medium (5-15%)
00001805.jpg,1300,956,543,75,926,402,False,383,327,125241,1.3598326359832635,383,327,125241,1.1712538226299694,Very Large,734.5,238.5,0.565,0.24947698744769875,top-center,1242800,0.10077325394271001,Medium (5-15%)
00001811.jpg,907,1390,221,267,461,694,False,240,427,102480,0.6525179856115108,240,427,102480,0.5620608899297423,Very Large,341.0,480.5,0.37596471885336274,0.34568345323741007,middle-center,1260730,0.08128623892506723,Medium (5-15%)
00001810.jpg,408,612,127,15,264,253,False,137,238,32606,0.6666666666666666,137,238,32606,0.5756302521008403,Large,195.5,134.0,0.4791666666666667,0.21895424836601307,top-center,249696,0.13058278867102396,Medium (5-15%)
00001192.jpg,1300,957,632,210,998,524,False,366,314,114924,1.3584117032392895,366,314,114924,1.1656050955414012,Very Large,815.0,367.0,0.6269230769230769,0.3834900731452456,middle-center,1244100,0.09237521099590065,Medium (5-15%)
00001186.jpg,1500,1143,616,97,903,351,False,287,254,72898,1.3123359580052494,287,254,72898,1.1299212598425197,Very Large,759.5,224.0,0.5063333333333333,0.19597550306211722,top-center,1714500,0.04251851851851852,Small (1-5%)
00000298.jpg,768,512,77,118,184,200,False,107,82,8774,1.5,107,82,8774,1.3048780487804879,Medium,130.5,159.0,0.169921875,0.310546875,top-left,393216,0.022313435872395832,Small (1-5%)
00000298.jpg,768,512,203,97,289,165,False,86,68,5848,1.5,86,68,5848,1.2647058823529411,Medium,246.0,131.0,0.3203125,0.255859375,top-left,393216,0.014872233072916666,Small (1-5%)
00001838.jpg,500,333,186,25,295,109,False,109,84,9156,1.5015015015015014,109,84,9156,1.2976190476190477,Medium,240.5,67.0,0.481,0.2012012012012012,top-center,166500,0.054990990990990994,Medium (5-15%)
00001179.jpg,800,534,404,39,611,199,False,207,160,33120,1.4981273408239701,207,160,33120,1.29375,Large,507.5,119.0,0.634375,0.22284644194756553,top-center,427200,0.07752808988764046,Medium (5-15%)
00003008.jpg,1242,918,158,1,1083,309,False,925,308,284900,1.3529411764705883,925,308,284900,3.0032467532467533,Very Large,620.5,155.0,0.499597423510467,0.16884531590413943,top-center,1140156,0.24987808685828958,Large (15-30%)
00003020.jpg,414,230,160,96,255,157,False,95,61,5795,1.8,95,61,5795,1.5573770491803278,Medium,207.5,126.5,0.501207729468599,0.55,middle-center,95220,0.060859063222012184,Medium (5-15%)
00001637.jpg,1307,1960,499,570,778,1047,False,279,477,133083,0.6668367346938775,279,477,133083,0.5849056603773585,Very Large,638.5,808.5,0.4885233358837031,0.4125,middle-center,2561720,0.05195064253704542,Medium (5-15%)
00001151.jpg,1331,2000,476,613,754,1099,False,278,486,135108,0.6655,278,486,135108,0.5720164609053497,Very Large,615.0,856.0,0.46205860255447034,0.428,middle-center,2662000,0.05075432006010518,Medium (5-15%)
00001623.jpg,433,650,152,187,244,349,False,92,162,14904,0.6661538461538462,92,162,14904,0.5679012345679012,Medium,198.0,268.0,0.45727482678983833,0.4123076923076923,middle-center,281450,0.05295434357790016,Medium (5-15%)
00003034.jpg,1000,1527,622,667,725,849,False,103,182,18746,0.6548788474132285,103,182,18746,0.5659340659340659,Medium,673.5,758.0,0.6735,0.49639816633922723,middle-right,1527000,0.012276358873608383,Small (1-5%)
00002869.jpg,681,1024,228,127,394,410,False,166,283,46978,0.6650390625,166,283,46978,0.5865724381625441,Large,311.0,268.5,0.4566813509544787,0.26220703125,top-center,697344,0.06736703836270191,Medium (5-15%)
00001390.jpg,334,519,153,38,231,176,False,78,138,10764,0.6435452793834296,78,138,10764,0.5652173913043478,Medium,192.0,107.0,0.5748502994011976,0.20616570327552985,top-center,173346,0.06209546225468139,Medium (5-15%)
00002841.jpg,480,360,272,69,362,148,False,90,79,7110,1.3333333333333333,90,79,7110,1.139240506329114,Medium,317.0,108.5,0.6604166666666667,0.3013888888888889,top-center,172800,0.04114583333333333,Small (1-5%)
00000930.jpg,800,533,153,35,306,154,False,153,119,18207,1.5009380863039399,153,119,18207,1.2857142857142858,Medium,229.5,94.5,0.286875,0.1772983114446529,top-left,426400,0.04269934333958724,Small (1-5%)
00000924.jpg,735,980,341,69,492,303,False,151,234,35334,0.75,151,234,35334,0.6452991452991453,Large,416.5,186.0,0.5666666666666667,0.18979591836734694,top-center,720300,0.0490545605997501,Small (1-5%)
00002855.jpg,1080,720,392,59,787,371,False,395,312,123240,1.5,395,312,123240,1.266025641025641,Very Large,589.5,215.0,0.5458333333333333,0.2986111111111111,top-center,777600,0.15848765432098766,Large (15-30%)
00002855.jpg,1080,720,625,164,936,405,False,311,241,74951,1.5,311,241,74951,1.2904564315352698,Very Large,780.5,284.5,0.7226851851851852,0.3951388888888889,middle-right,777600,0.09638760288065844,Medium (5-15%)
00001384.jpg,710,1024,219,161,423,504,False,204,343,69972,0.693359375,204,343,69972,0.5947521865889213,Very Large,321.0,332.5,0.45211267605633804,0.32470703125,top-center,727040,0.09624229753521127,Medium (5-15%)
00000717.jpg,1600,1138,593,163,787,324,False,194,161,31234,1.40597539543058,194,161,31234,1.204968944099379,Large,690.0,243.5,0.43125,0.2139718804920914,top-center,1820800,0.017153998242530756,Small (1-5%)
00000717.jpg,1600,1138,916,194,1087,335,False,171,141,24111,1.40597539543058,171,141,24111,1.2127659574468086,Large,1001.5,264.5,0.6259375,0.23242530755711774,top-center,1820800,0.013241981546572934,Small (1-5%)
00000717.jpg,1600,1138,734,365,965,557,False,231,192,44352,1.40597539543058,231,192,44352,1.203125,Large,849.5,461.0,0.5309375,0.40509666080843587,middle-center,1820800,0.0243585237258348,Small (1-5%)
00001409.jpg,800,582,357,126,450,205,False,93,79,7347,1.3745704467353952,93,79,7347,1.1772151898734178,Medium,403.5,165.5,0.504375,0.28436426116838487,top-center,465600,0.015779639175257733,Small (1-5%)
00000703.jpg,1024,576,410,55,692,240,False,282,185,52170,1.7777777777777777,282,185,52170,1.5243243243243243,Very Large,551.0,147.5,0.5380859375,0.2560763888888889,top-center,589824,0.08845011393229167,Medium (5-15%)
00000703.jpg,1024,576,156,87,394,243,False,238,156,37128,1.7777777777777777,238,156,37128,1.5256410256410255,Large,275.0,165.0,0.2685546875,0.2864583333333333,top-left,589824,0.06294759114583333,Medium (5-15%)
00002114.jpg,500,625,283,42,387,194,False,104,152,15808,0.8,104,152,15808,0.6842105263157895,Medium,335.0,118.0,0.67,0.1888,top-right,312500,0.0505856,Medium (5-15%)
00002114.jpg,500,625,112,204,224,362,False,112,158,17696,0.8,112,158,17696,0.7088607594936709,Medium,168.0,283.0,0.336,0.4528,middle-center,312500,0.0566272,Medium (5-15%)
00002672.jpg,688,1024,235,246,376,490,False,141,244,34404,0.671875,141,244,34404,0.5778688524590164,Large,305.5,368.0,0.4440406976744186,0.359375,middle-center,704512,0.04883380268895349,Small (1-5%)
00001353.jpg,2000,1333,571,94,1318,673,False,747,579,432513,1.5003750937734435,747,579,432513,1.2901554404145077,Very Large,944.5,383.5,0.47225,0.28769692423105775,top-center,2666000,0.16223293323330834,Large (15-30%)
00001435.jpg,1300,821,186,1,1049,572,False,863,571,492773,1.5834348355663825,863,571,492773,1.5113835376532399,Very Large,617.5,286.5,0.475,0.3489646772228989,middle-center,1067300,0.4617005527967769,Very Large (>30%)
00003222.jpg,236,354,114,71,153,138,False,39,67,2613,0.6666666666666666,39,67,2613,0.582089552238806,Small,133.5,104.5,0.565677966101695,0.2951977401129944,top-center,83544,0.03127693191611606,Small (1-5%)
00002128.jpg,390,280,100,34,278,186,False,178,152,27056,1.3928571428571428,178,152,27056,1.1710526315789473,Large,189.0,110.0,0.4846153846153846,0.39285714285714285,middle-center,109200,0.24776556776556777,Large (15-30%)
00001421.jpg,1600,1090,781,144,1177,458,False,396,314,124344,1.4678899082568808,396,314,124344,1.2611464968152866,Very Large,979.0,301.0,0.611875,0.2761467889908257,top-center,1744000,0.07129816513761468,Medium (5-15%)
00001347.jpg,861,1300,389,76,519,304,False,130,228,29640,0.6623076923076923,130,228,29640,0.5701754385964912,Large,454.0,190.0,0.5272938443670151,0.14615384615384616,top-center,1119300,0.0264808362369338,Small (1-5%)
00002896.jpg,2000,1333,1081,311,1448,595,False,367,284,104228,1.5003750937734435,367,284,104228,1.2922535211267605,Very Large,1264.5,453.0,0.63225,0.33983495873968494,middle-center,2666000,0.039095273818454616,Small (1-5%)
00002896.jpg,2000,1333,503,390,894,693,False,391,303,118473,1.5003750937734435,391,303,118473,1.2904290429042904,Very Large,698.5,541.5,0.34925,0.4062265566391598,middle-center,2666000,0.04443848462115529,Small (1-5%)
00002909.jpg,960,444,127,108,336,218,False,209,110,22990,2.1621621621621623,209,110,22990,1.9,Large,231.5,163.0,0.24114583333333334,0.36711711711711714,middle-left,426240,0.05393674924924925,Medium (5-15%)
00003395.jpg,612,408,410,74,513,152,False,103,78,8034,1.5,103,78,8034,1.3205128205128205,Medium,461.5,113.0,0.7540849673202614,0.2769607843137255,top-right,249696,0.03217512495194156,Small (1-5%)
00003395.jpg,612,408,492,70,612,165,False,120,95,11400,1.5,120,95,11400,1.263157894736842,Medium,552.0,117.5,0.9019607843137255,0.28799019607843135,top-right,249696,0.045655517108804305,Small (1-5%)
00003395.jpg,612,408,342,111,416,169,False,74,58,4292,1.5,74,58,4292,1.2758620689655173,Small,379.0,140.0,0.619281045751634,0.3431372549019608,middle-center,249696,0.01718890170447264,Small (1-5%)
00003395.jpg,612,408,1,56,75,144,False,74,88,6512,1.5,74,88,6512,0.8409090909090909,Medium,38.0,100.0,0.06209150326797386,0.24509803921568626,top-left,249696,0.026079712930924003,Small (1-5%)
00003395.jpg,612,408,136,75,217,138,False,81,63,5103,1.5,81,63,5103,1.2857142857142858,Medium,176.5,106.5,0.2883986928104575,0.2610294117647059,top-left,249696,0.020436851211072665,Small (1-5%)
00003395.jpg,612,408,35,92,123,160,False,88,68,5984,1.5,88,68,5984,1.2941176470588236,Medium,79.0,126.0,0.12908496732026145,0.3088235294117647,top-left,249696,0.023965141612200435,Small (1-5%)
00000844.jpg,372,280,166,11,271,103,False,105,92,9660,1.3285714285714285,105,92,9660,1.141304347826087,Medium,218.5,57.0,0.5873655913978495,0.20357142857142857,top-center,104160,0.09274193548387097,Medium (5-15%)
00001582.jpg,957,1000,1,45,433,603,False,432,558,241056,0.957,432,558,241056,0.7741935483870968,Very Large,217.0,324.0,0.22675026123301986,0.324,top-left,957000,0.2518871473354232,Large (15-30%)
00001582.jpg,957,1000,539,57,957,587,False,418,530,221540,0.957,418,530,221540,0.7886792452830189,Very Large,748.0,322.0,0.7816091954022989,0.322,top-right,957000,0.2314942528735632,Large (15-30%)
00000850.jpg,600,400,98,107,303,267,False,205,160,32800,1.5,205,160,32800,1.28125,Large,200.5,187.0,0.33416666666666667,0.4675,middle-center,240000,0.13666666666666666,Medium (5-15%)
00003381.jpg,612,408,231,131,346,220,False,115,89,10235,1.5,115,89,10235,1.2921348314606742,Medium,288.5,175.5,0.4714052287581699,0.43014705882352944,middle-center,249696,0.04098984364987825,Small (1-5%)
00002921.jpg,870,580,325,99,429,181,False,104,82,8528,1.5,104,82,8528,1.2682926829268293,Medium,377.0,140.0,0.43333333333333335,0.2413793103448276,top-center,504600,0.016900515259611573,Small (1-5%)
00000105.jpg,1800,1200,689,102,1026,364,False,337,262,88294,1.5,337,262,88294,1.286259541984733,Very Large,857.5,233.0,0.47638888888888886,0.19416666666666665,top-center,2160000,0.04087685185185185,Small (1-5%)
00002712.jpg,500,334,285,88,340,130,False,55,42,2310,1.4970059880239521,55,42,2310,1.3095238095238095,Small,312.5,109.0,0.625,0.3263473053892216,top-center,167000,0.013832335329341318,Small (1-5%)
00002074.jpg,608,406,278,47,461,189,False,183,142,25986,1.4975369458128078,183,142,25986,1.2887323943661972,Large,369.5,118.0,0.6077302631578947,0.29064039408866993,top-center,246848,0.1052712600466684,Medium (5-15%)
00001569.jpg,600,900,243,83,444,434,False,201,351,70551,0.6666666666666666,201,351,70551,0.5726495726495726,Very Large,343.5,258.5,0.5725,0.2872222222222222,top-center,540000,0.13065,Medium (5-15%)
00000677.jpg,678,446,205,146,344,254,False,139,108,15012,1.5201793721973094,139,108,15012,1.287037037037037,Medium,274.5,200.0,0.40486725663716816,0.4484304932735426,middle-center,302388,0.049644827175681576,Small (1-5%)
00000677.jpg,678,446,383,158,537,276,False,154,118,18172,1.5201793721973094,154,118,18172,1.305084745762712,Medium,460.0,217.0,0.6784660766961652,0.48654708520179374,middle-right,302388,0.060094977313914576,Medium (5-15%)
00002060.jpg,640,640,42,109,297,406,False,255,297,75735,1.0,255,297,75735,0.8585858585858586,Very Large,169.5,257.5,0.26484375,0.40234375,middle-left,409600,0.18489990234375,Large (15-30%)
00002060.jpg,640,640,343,44,631,379,False,288,335,96480,1.0,288,335,96480,0.8597014925373134,Very Large,487.0,211.5,0.7609375,0.33046875,middle-right,409600,0.235546875,Large (15-30%)
00002706.jpg,612,408,163,123,291,222,False,128,99,12672,1.5,128,99,12672,1.292929292929293,Medium,227.0,172.5,0.3709150326797386,0.4227941176470588,middle-center,249696,0.05074971164936563,Medium (5-15%)
00002706.jpg,612,408,223,51,356,152,False,133,101,13433,1.5,133,101,13433,1.316831683168317,Medium,289.5,101.5,0.4730392156862745,0.24877450980392157,top-center,249696,0.053797417659874405,Medium (5-15%)
00002706.jpg,612,408,50,122,204,242,False,154,120,18480,1.5,154,120,18480,1.2833333333333334,Medium,127.0,182.0,0.20751633986928106,0.44607843137254904,middle-left,249696,0.07400999615532487,Medium (5-15%)
00002706.jpg,612,408,281,6,418,112,False,137,106,14522,1.5,137,106,14522,1.2924528301886793,Medium,349.5,59.0,0.571078431372549,0.14460784313725492,top-center,249696,0.058158721004741766,Medium (5-15%)
00002706.jpg,612,408,278,189,412,292,False,134,103,13802,1.5,134,103,13802,1.3009708737864079,Medium,345.0,240.5,0.5637254901960784,0.5894607843137255,middle-center,249696,0.05527521466102781,Medium (5-15%)
00003418.jpg,800,800,325,306,468,473,False,143,167,23881,1.0,143,167,23881,0.8562874251497006,Large,396.5,389.5,0.495625,0.486875,middle-center,640000,0.0373140625,Small (1-5%)
00003430.jpg,800,800,388,45,479,151,False,91,106,9646,1.0,91,106,9646,0.8584905660377359,Medium,433.5,98.0,0.541875,0.1225,top-center,640000,0.015071875,Small (1-5%)
00001541.jpg,408,544,148,20,252,180,False,104,160,16640,0.75,104,160,16640,0.65,Medium,200.0,100.0,0.49019607843137253,0.18382352941176472,top-center,221952,0.07497116493656286,Medium (5-15%)
00001541.jpg,408,544,158,207,268,378,False,110,171,18810,0.75,110,171,18810,0.6432748538011696,Medium,213.0,292.5,0.5220588235294118,0.5376838235294118,middle-center,221952,0.084748053633218,Medium (5-15%)
00002048.jpg,1300,867,585,120,862,335,False,277,215,59555,1.4994232987312572,277,215,59555,1.2883720930232558,Very Large,723.5,227.5,0.5565384615384615,0.26239907727797,top-center,1127100,0.05283914470765682,Medium (5-15%)
00003342.jpg,736,1103,250,365,366,563,False,116,198,22968,0.6672710788757933,116,198,22968,0.5858585858585859,Large,308.0,464.0,0.41847826086956524,0.42067089755213055,middle-center,811808,0.028292404115258782,Small (1-5%)
00003342.jpg,736,1103,411,479,519,669,False,108,190,20520,0.6672710788757933,108,190,20520,0.5684210526315789,Large,465.0,574.0,0.6317934782608695,0.5203989120580236,middle-center,811808,0.02527691276755095,Small (1-5%)
00000893.jpg,300,300,60,37,118,105,False,58,68,3944,1.0,58,68,3944,0.8529411764705882,Small,89.0,71.0,0.2966666666666667,0.23666666666666666,top-left,90000,0.04382222222222222,Small (1-5%)
00001555.jpg,1500,1500,414,122,1102,923,False,688,801,551088,1.0,688,801,551088,0.8589263420724095,Very Large,758.0,522.5,0.5053333333333333,0.34833333333333333,middle-center,2250000,0.244928,Large (15-30%)
00001233.jpg,667,1000,225,63,465,481,False,240,418,100320,0.667,240,418,100320,0.5741626794258373,Very Large,345.0,272.0,0.5172413793103449,0.272,top-center,667000,0.1504047976011994,Large (15-30%)
00003424.jpg,736,508,224,104,336,194,False,112,90,10080,1.4488188976377954,112,90,10080,1.2444444444444445,Medium,280.0,149.0,0.3804347826086957,0.2933070866141732,top-center,373888,0.026959945224238273,Small (1-5%)
00003424.jpg,736,508,474,3,581,88,False,107,85,9095,1.4488188976377954,107,85,9095,1.2588235294117647,Medium,527.5,45.5,0.7167119565217391,0.08956692913385826,top-right,373888,0.024325466449845942,Small (1-5%)
00003424.jpg,736,508,81,129,194,219,False,113,90,10170,1.4488188976377954,113,90,10170,1.2555555555555555,Medium,137.5,174.0,0.18682065217391305,0.3425196850393701,middle-left,373888,0.02720065902088326,Small (1-5%)
00003424.jpg,736,508,505,160,595,230,False,90,70,6300,1.4488188976377954,90,70,6300,1.2857142857142858,Medium,550.0,195.0,0.7472826086956522,0.3838582677165354,middle-right,373888,0.01684996576514892,Small (1-5%)
00001964.jpg,600,418,241,37,377,145,False,136,108,14688,1.4354066985645932,136,108,14688,1.2592592592592593,Medium,309.0,91.0,0.515,0.21770334928229665,top-center,250800,0.05856459330143541,Medium (5-15%)
00001964.jpg,600,418,147,31,290,144,False,143,113,16159,1.4354066985645932,143,113,16159,1.2654867256637168,Medium,218.5,87.5,0.3641666666666667,0.20933014354066987,top-center,250800,0.0644298245614035,Medium (5-15%)
00001958.jpg,400,326,101,16,272,182,False,171,166,28386,1.2269938650306749,171,166,28386,1.0301204819277108,Large,186.5,99.0,0.46625,0.30368098159509205,top-center,130400,0.2176840490797546,Large (15-30%)
00003197.jpg,1024,681,381,96,819,435,False,438,339,148482,1.5036710719530102,438,339,148482,1.2920353982300885,Very Large,600.0,265.5,0.5859375,0.3898678414096916,middle-center,697344,0.21292504129955947,Large (15-30%)
00003183.jpg,960,481,579,76,960,325,False,381,249,94869,1.995841995841996,381,249,94869,1.5301204819277108,Very Large,769.5,200.5,0.8015625,0.41683991683991684,middle-right,461760,0.20545088357588356,Large (15-30%)
00003183.jpg,960,481,41,82,499,354,False,458,272,124576,1.995841995841996,458,272,124576,1.6838235294117647,Very Large,270.0,218.0,0.28125,0.45322245322245325,middle-left,461760,0.2697851697851698,Large (15-30%)
00001794.jpg,866,1390,298,62,630,669,False,332,607,201524,0.6230215827338129,332,607,201524,0.5469522240527183,Very Large,464.0,365.5,0.535796766743649,0.2629496402877698,top-center,1203740,0.16741489025869374,Large (15-30%)
00002276.jpg,1326,1800,362,606,760,1236,False,398,630,250740,0.7366666666666667,398,630,250740,0.6317460317460317,Very Large,561.0,921.0,0.4230769230769231,0.5116666666666667,middle-center,2386800,0.105052790346908,Medium (5-15%)
00003168.jpg,1300,957,463,114,673,290,False,210,176,36960,1.3584117032392895,210,176,36960,1.1931818181818181,Large,568.0,202.0,0.4369230769230769,0.2110762800417973,top-center,1244100,0.029708222811671087,Small (1-5%)
00001019.jpg,640,761,307,52,446,246,False,139,194,26966,0.8409986859395532,139,194,26966,0.7164948453608248,Large,376.5,149.0,0.58828125,0.19579500657030224,top-center,487040,0.05536711563731932,Medium (5-15%)
00003154.jpg,612,408,313,45,509,198,False,196,153,29988,1.5,196,153,29988,1.2810457516339868,Large,411.0,121.5,0.6715686274509803,0.2977941176470588,top-right,249696,0.12009803921568628,Medium (5-15%)
00001743.jpg,600,900,252,28,462,394,False,210,366,76860,0.6666666666666666,210,366,76860,0.5737704918032787,Very Large,357.0,211.0,0.595,0.23444444444444446,top-center,540000,0.14233333333333334,Medium (5-15%)
00001025.jpg,867,1300,393,96,574,405,False,181,309,55929,0.666923076923077,181,309,55929,0.5857605177993528,Very Large,483.5,250.5,0.5576701268742791,0.1926923076923077,top-center,1127100,0.04962203886079319,Small (1-5%)
00002538.jpg,400,267,102,4,361,201,False,259,197,51023,1.4981273408239701,259,197,51023,1.3147208121827412,Very Large,231.5,102.5,0.57875,0.3838951310861423,middle-center,106800,0.4777434456928839,Very Large (>30%)
00001757.jpg,1300,1360,501,147,761,464,False,260,317,82420,0.9558823529411765,260,317,82420,0.8201892744479495,Very Large,631.0,305.5,0.48538461538461536,0.22463235294117648,top-center,1768000,0.04661764705882353,Small (1-5%)
00003140.jpg,630,354,124,9,630,354,False,506,345,174570,1.7796610169491525,506,345,174570,1.4666666666666666,Very Large,377.0,181.5,0.5984126984126984,0.5127118644067796,middle-center,223020,0.7827549098735539,Very Large (>30%)
00003178.jpg,2000,1333,1487,244,1776,469,False,289,225,65025,1.5003750937734435,289,225,65025,1.2844444444444445,Very Large,1631.5,356.5,0.81575,0.26744186046511625,top-right,2666000,0.024390472618154538,Small (1-5%)
00003178.jpg,2000,1333,1115,313,1353,498,False,238,185,44030,1.5003750937734435,238,185,44030,1.2864864864864864,Large,1234.0,405.5,0.617,0.30420105026256566,top-center,2666000,0.016515378844711177,Small (1-5%)
00003178.jpg,2000,1333,514,453,791,668,False,277,215,59555,1.5003750937734435,277,215,59555,1.2883720930232558,Very Large,652.5,560.5,0.32625,0.4204801200300075,middle-left,2666000,0.022338709677419355,Small (1-5%)
00000317.jpg,1001,1600,460,90,624,397,False,164,307,50348,0.625625,164,307,50348,0.5342019543973942,Very Large,542.0,243.5,0.5414585414585414,0.1521875,top-center,1601600,0.031436063936063935,Small (1-5%)
00000317.jpg,1001,1600,357,273,518,573,False,161,300,48300,0.625625,161,300,48300,0.5366666666666666,Large,437.5,423.0,0.4370629370629371,0.264375,top-center,1601600,0.030157342657342656,Small (1-5%)
00000303.jpg,389,280,102,103,238,219,False,136,116,15776,1.3892857142857142,136,116,15776,1.1724137931034482,Medium,170.0,161.0,0.4370179948586118,0.575,middle-center,108920,0.1448402497245685,Medium (5-15%)
00000303.jpg,389,280,205,51,347,170,False,142,119,16898,1.3892857142857142,142,119,16898,1.1932773109243697,Medium,276.0,110.5,0.7095115681233933,0.39464285714285713,middle-right,108920,0.1551413881748072,Large (15-30%)
00002514.jpg,716,996,286,226,402,412,False,116,186,21576,0.7188755020080321,116,186,21576,0.6236559139784946,Large,344.0,319.0,0.48044692737430167,0.32028112449799195,top-center,713136,0.030255098606717372,Small (1-5%)
00002272.jpg,1024,746,292,179,675,503,False,383,324,124092,1.3726541554959786,383,324,124092,1.1820987654320987,Very Large,483.5,341.0,0.47216796875,0.4571045576407507,middle-center,763904,0.16244449564343164,Large (15-30%)
00003144.jpg,481,323,26,87,168,198,False,142,111,15762,1.4891640866873066,142,111,15762,1.2792792792792793,Medium,97.0,142.5,0.20166320166320167,0.4411764705882353,middle-left,155363,0.10145272683972374,Medium (5-15%)
00001753.jpg,976,1300,532,97,651,281,False,119,184,21896,0.7507692307692307,119,184,21896,0.6467391304347826,Large,591.5,189.0,0.6060450819672131,0.1453846153846154,top-center,1268800,0.017257250945775536,Small (1-5%)
00001035.jpg,682,1023,154,1,359,282,False,205,281,57605,0.6666666666666666,205,281,57605,0.7295373665480427,Very Large,256.5,141.5,0.37609970674486803,0.13831867057673508,top-center,697686,0.08256579607445183,Medium (5-15%)
00001021.jpg,1012,1390,309,72,607,538,False,298,466,138868,0.7280575539568346,298,466,138868,0.6394849785407726,Very Large,458.0,305.0,0.4525691699604743,0.21942446043165467,top-center,1406680,0.09872039127591208,Medium (5-15%)
00001747.jpg,1600,1167,414,23,916,450,False,502,427,214354,1.3710368466152527,502,427,214354,1.1756440281030445,Very Large,665.0,236.5,0.415625,0.20265638389031707,top-center,1867200,0.11479970008568981,Medium (5-15%)
00000459.jpg,3024,4032,1235,1651,1766,2475,False,531,824,437544,0.75,531,824,437544,0.6444174757281553,Very Large,1500.5,2063.0,0.49619708994708994,0.511656746031746,middle-center,12192768,0.035885534769463344,Small (1-5%)
00003150.jpg,750,502,483,30,612,131,False,129,101,13029,1.4940239043824701,129,101,13029,1.2772277227722773,Medium,547.5,80.5,0.73,0.1603585657370518,top-right,376500,0.03460557768924303,Small (1-5%)
00003150.jpg,750,502,130,61,254,157,False,124,96,11904,1.4940239043824701,124,96,11904,1.2916666666666667,Medium,192.0,109.0,0.256,0.21713147410358566,top-left,376500,0.031617529880478085,Small (1-5%)
00001974.jpg,1050,700,405,84,614,247,False,209,163,34067,1.5,209,163,34067,1.2822085889570551,Large,509.5,165.5,0.48523809523809525,0.23642857142857143,top-center,735000,0.046349659863945576,Small (1-5%)
00001960.jpg,1300,861,661,159,1087,488,False,426,329,140154,1.5098722415795587,426,329,140154,1.2948328267477203,Very Large,874.0,323.5,0.6723076923076923,0.37572590011614404,middle-right,1119300,0.12521575984990618,Medium (5-15%)
00001948.jpg,1000,1500,285,151,561,632,False,276,481,132756,0.6666666666666666,276,481,132756,0.5738045738045738,Very Large,423.0,391.5,0.423,0.261,top-center,1500000,0.088504,Medium (5-15%)
00001790.jpg,800,533,234,60,644,377,False,410,317,129970,1.5009380863039399,410,317,129970,1.2933753943217665,Very Large,439.0,218.5,0.54875,0.4099437148217636,middle-center,426400,0.30480769230769234,Very Large (>30%)
00002299.jpg,375,500,83,106,193,277,False,110,171,18810,0.75,110,171,18810,0.6432748538011696,Medium,138.0,191.5,0.368,0.383,middle-center,187500,0.10032,Medium (5-15%)
00003187.jpg,510,340,97,62,186,132,False,89,70,6230,1.5,89,70,6230,1.2714285714285714,Medium,141.5,97.0,0.2774509803921569,0.2852941176470588,top-left,173400,0.03592848904267589,Small (1-5%)
00003187.jpg,510,340,390,118,444,160,False,54,42,2268,1.5,54,42,2268,1.2857142857142858,Small,417.0,139.0,0.8176470588235294,0.4088235294117647,middle-right,173400,0.013079584775086505,Small (1-5%)
00003187.jpg,510,340,257,193,331,250,False,74,57,4218,1.5,74,57,4218,1.2982456140350878,Small,294.0,221.5,0.5764705882352941,0.6514705882352941,middle-center,173400,0.024325259515570935,Small (1-5%)
00003193.jpg,1000,1000,222,609,340,747,False,118,138,16284,1.0,118,138,16284,0.855072463768116,Medium,281.0,678.0,0.281,0.678,bottom-left,1000000,0.016284,Small (1-5%)
00000115.jpg,1024,683,267,132,472,291,False,205,159,32595,1.499267935578331,205,159,32595,1.2893081761006289,Large,369.5,211.5,0.36083984375,0.3096632503660322,top-center,699392,0.046604765281844804,Small (1-5%)
00002702.jpg,1362,2048,442,343,931,1182,False,489,839,410271,0.6650390625,489,839,410271,0.5828367103694875,Very Large,686.5,762.5,0.5040381791483113,0.372314453125,middle-center,2789376,0.14708343371420704,Medium (5-15%)
00002064.jpg,1600,1167,605,99,918,365,False,313,266,83258,1.3710368466152527,313,266,83258,1.1766917293233083,Very Large,761.5,232.0,0.4759375,0.19880034275921166,top-center,1867200,0.044589760068551844,Small (1-5%)
00000667.jpg,2000,1125,749,421,1338,807,False,589,386,227354,1.7777777777777777,589,386,227354,1.5259067357512954,Very Large,1043.5,614.0,0.52175,0.5457777777777778,middle-center,2250000,0.10104622222222222,Medium (5-15%)
00000667.jpg,2000,1125,1196,27,1772,412,False,576,385,221760,1.7777777777777777,576,385,221760,1.4961038961038962,Very Large,1484.0,219.5,0.742,0.19511111111111112,top-right,2250000,0.09856,Medium (5-15%)
00000667.jpg,2000,1125,7,152,622,572,False,615,420,258300,1.7777777777777777,615,420,258300,1.4642857142857142,Very Large,314.5,362.0,0.15725,0.3217777777777778,top-left,2250000,0.1148,Medium (5-15%)
00000667.jpg,2000,1125,857,96,1224,331,False,367,235,86245,1.7777777777777777,367,235,86245,1.5617021276595744,Very Large,1040.5,213.5,0.52025,0.18977777777777777,top-center,2250000,0.038331111111111114,Small (1-5%)
00000667.jpg,2000,1125,973,94,1356,340,False,383,246,94218,1.7777777777777777,383,246,94218,1.556910569105691,Very Large,1164.5,217.0,0.58225,0.1928888888888889,top-center,2250000,0.041874666666666664,Small (1-5%)
00000667.jpg,2000,1125,412,80,976,449,False,564,369,208116,1.7777777777777777,564,369,208116,1.5284552845528456,Very Large,694.0,264.5,0.347,0.2351111111111111,top-center,2250000,0.092496,Medium (5-15%)
00001237.jpg,1300,731,532,65,804,239,False,272,174,47328,1.7783857729138166,272,174,47328,1.5632183908045978,Large,668.0,152.0,0.5138461538461538,0.2079343365253078,top-center,950300,0.049803220035778174,Small (1-5%)
00000129.jpg,1600,1156,695,231,893,398,False,198,167,33066,1.3840830449826989,198,167,33066,1.18562874251497,Large,794.0,314.5,0.49625,0.27205882352941174,top-center,1849600,0.017877378892733563,Small (1-5%)
00000897.jpg,1000,1777,291,295,707,1137,False,416,842,350272,0.5627462014631401,416,842,350272,0.49406175771971494,Very Large,499.0,716.0,0.499,0.40292628024760835,middle-center,1777000,0.19711423747889703,Large (15-30%)
00001551.jpg,800,558,382,52,633,251,False,251,199,49949,1.4336917562724014,251,199,49949,1.2613065326633166,Large,507.5,151.5,0.634375,0.271505376344086,top-center,446400,0.1118929211469534,Medium (5-15%)
00002058.jpg,800,533,556,103,685,203,False,129,100,12900,1.5009380863039399,129,100,12900,1.29,Medium,620.5,153.0,0.775625,0.2870544090056285,top-right,426400,0.03025328330206379,Small (1-5%)
00002058.jpg,800,533,336,51,483,164,False,147,113,16611,1.5009380863039399,147,113,16611,1.3008849557522124,Medium,409.5,107.5,0.511875,0.20168855534709193,top-center,426400,0.03895637898686679,Small (1-5%)
00002058.jpg,800,533,103,109,226,206,False,123,97,11931,1.5009380863039399,123,97,11931,1.268041237113402,Medium,164.5,157.5,0.205625,0.2954971857410882,top-left,426400,0.02798076923076923,Small (1-5%)
00001545.jpg,684,1024,284,385,388,565,False,104,180,18720,0.66796875,104,180,18720,0.5777777777777777,Medium,336.0,475.0,0.49122807017543857,0.4638671875,middle-center,700416,0.026726973684210526,Small (1-5%)
00001223.jpg,1300,1300,468,77,859,532,False,391,455,177905,1.0,391,455,177905,0.8593406593406593,Very Large,663.5,304.5,0.5103846153846154,0.23423076923076924,top-center,1690000,0.10526923076923077,Medium (5-15%)
00003434.jpg,447,497,109,235,213,367,False,104,132,13728,0.8993963782696177,104,132,13728,0.7878787878787878,Medium,161.0,301.0,0.36017897091722595,0.6056338028169014,middle-center,222159,0.061793580273587834,Medium (5-15%)
00002919.jpg,1000,600,124,32,362,199,False,238,167,39746,1.6666666666666667,238,167,39746,1.4251497005988023,Large,243.0,115.5,0.243,0.1925,top-left,600000,0.06624333333333333,Medium (5-15%)
00002919.jpg,1000,600,1,116,156,265,False,155,149,23095,1.6666666666666667,155,149,23095,1.0402684563758389,Large,78.5,190.5,0.0785,0.3175,top-left,600000,0.03849166666666667,Small (1-5%)
00002919.jpg,1000,600,836,64,1000,223,False,164,159,26076,1.6666666666666667,164,159,26076,1.0314465408805031,Large,918.0,143.5,0.918,0.23916666666666667,top-right,600000,0.04346,Small (1-5%)
00002919.jpg,1000,600,339,138,553,287,False,214,149,31886,1.6666666666666667,214,149,31886,1.436241610738255,Large,446.0,212.5,0.446,0.3541666666666667,middle-center,600000,0.053143333333333334,Medium (5-15%)
00002919.jpg,1000,600,494,99,752,279,False,258,180,46440,1.6666666666666667,258,180,46440,1.4333333333333333,Large,623.0,189.0,0.623,0.315,top-center,600000,0.0774,Medium (5-15%)
00003385.jpg,736,689,248,52,377,193,False,129,141,18189,1.0682148040638606,129,141,18189,0.9148936170212766,Medium,312.5,122.5,0.42459239130434784,0.17779390420899854,top-center,507104,0.03586838202814413,Small (1-5%)
00003385.jpg,736,689,307,185,436,323,False,129,138,17802,1.0682148040638606,129,138,17802,0.9347826086956522,Medium,371.5,254.0,0.5047554347826086,0.3686502177068215,middle-center,507104,0.03510522496371553,Small (1-5%)
00003385.jpg,736,689,366,421,484,550,False,118,129,15222,1.0682148040638606,118,129,15222,0.9147286821705426,Medium,425.0,485.5,0.5774456521739131,0.704644412191582,bottom-center,507104,0.030017511200858205,Small (1-5%)
00003385.jpg,736,689,235,226,337,337,False,102,111,11322,1.0682148040638606,102,111,11322,0.918918918918919,Medium,286.0,281.5,0.38858695652173914,0.4085631349782293,middle-center,507104,0.022326781094213415,Small (1-5%)
00003385.jpg,736,689,451,293,546,395,False,95,102,9690,1.0682148040638606,95,102,9690,0.9313725490196079,Medium,498.5,344.0,0.6773097826086957,0.49927431059506533,middle-right,507104,0.019108506341894364,Small (1-5%)
00000854.jpg,1358,1045,428,205,771,506,False,343,301,103243,1.2995215311004784,343,301,103243,1.1395348837209303,Very Large,599.5,355.5,0.4414580265095729,0.3401913875598086,middle-center,1419110,0.0727519360726089,Medium (5-15%)
00001592.jpg,2940,1960,1046,144,1822,746,False,776,602,467152,1.5,776,602,467152,1.2890365448504983,Very Large,1434.0,445.0,0.48775510204081635,0.22704081632653061,top-center,5762400,0.0810689990281827,Medium (5-15%)
00000840.jpg,1300,866,438,191,903,552,False,465,361,167865,1.5011547344110854,465,361,167865,1.2880886426592797,Very Large,670.5,371.5,0.5157692307692308,0.4289838337182448,middle-center,1125800,0.14910730147450701,Medium (5-15%)
00001586.jpg,800,533,309,70,503,224,False,194,154,29876,1.5009380863039399,194,154,29876,1.2597402597402598,Large,406.0,147.0,0.5075,0.275797373358349,top-center,426400,0.0700656660412758,Medium (5-15%)
00002931.jpg,800,800,89,509,224,665,False,135,156,21060,1.0,135,156,21060,0.8653846153846154,Large,156.5,587.0,0.195625,0.73375,bottom-left,640000,0.03290625,Small (1-5%)
00000061.jpg,339,508,194,97,239,176,False,45,79,3555,0.6673228346456693,45,79,3555,0.569620253164557,Small,216.5,136.5,0.6386430678466076,0.2687007874015748,top-center,172212,0.02064316075534806,Small (1-5%)
00002676.jpg,467,700,171,69,335,354,False,164,285,46740,0.6671428571428571,164,285,46740,0.5754385964912281,Large,253.0,211.5,0.5417558886509636,0.30214285714285716,top-center,326900,0.14297950443560722,Medium (5-15%)
00002110.jpg,2000,1125,444,203,941,521,False,497,318,158046,1.7777777777777777,497,318,158046,1.5628930817610063,Very Large,692.5,362.0,0.34625,0.3217777777777778,top-center,2250000,0.07024266666666666,Medium (5-15%)
00002110.jpg,2000,1125,1082,89,1577,413,False,495,324,160380,1.7777777777777777,495,324,160380,1.5277777777777777,Very Large,1329.5,251.0,0.66475,0.22311111111111112,top-center,2250000,0.07128,Medium (5-15%)
00001419.jpg,3005,1960,994,76,2365,1116,False,1371,1040,1425840,1.5331632653061225,1371,1040,1425840,1.3182692307692307,Very Large,1679.5,596.0,0.5589018302828619,0.3040816326530612,top-center,5889800,0.24208631872049985,Large (15-30%)
00000707.jpg,720,405,414,17,641,169,False,227,152,34504,1.7777777777777777,227,152,34504,1.493421052631579,Large,527.5,93.0,0.7326388888888888,0.22962962962962963,top-right,291600,0.11832647462277092,Medium (5-15%)
00000707.jpg,720,405,330,131,556,282,False,226,151,34126,1.7777777777777777,226,151,34126,1.4966887417218544,Large,443.0,206.5,0.6152777777777778,0.5098765432098765,middle-center,291600,0.11703017832647462,Medium (5-15%)
00000707.jpg,720,405,107,116,415,313,False,308,197,60676,1.7777777777777777,308,197,60676,1.5634517766497462,Very Large,261.0,214.5,0.3625,0.5296296296296297,middle-center,291600,0.208079561042524,Large (15-30%)
00000707.jpg,720,405,483,160,719,336,False,236,176,41536,1.7777777777777777,236,176,41536,1.3409090909090908,Large,601.0,248.0,0.8347222222222223,0.6123456790123457,middle-right,291600,0.1424417009602195,Medium (5-15%)
00000707.jpg,720,405,244,1,480,148,False,236,147,34692,1.7777777777777777,236,147,34692,1.6054421768707483,Large,362.0,74.5,0.5027777777777778,0.18395061728395062,top-center,291600,0.11897119341563786,Medium (5-15%)
00000713.jpg,1280,853,269,73,646,365,False,377,292,110084,1.5005861664712778,377,292,110084,1.2910958904109588,Very Large,457.5,219.0,0.357421875,0.2567409144196952,top-center,1091840,0.10082429660023447,Medium (5-15%)
00000713.jpg,1280,853,593,59,866,270,False,273,211,57603,1.5005861664712778,273,211,57603,1.2938388625592416,Very Large,729.5,164.5,0.569921875,0.19284876905041032,top-center,1091840,0.05275773007033998,Medium (5-15%)
00002662.jpg,650,433,228,108,462,285,False,234,177,41418,1.5011547344110854,234,177,41418,1.3220338983050848,Large,345.0,196.5,0.5307692307692308,0.45381062355658197,middle-center,281450,0.1471593533487298,Medium (5-15%)
00000075.jpg,1000,597,52,7,634,402,False,582,395,229890,1.6750418760469012,582,395,229890,1.4734177215189874,Very Large,343.0,204.5,0.343,0.3425460636515913,middle-center,597000,0.3850753768844221,Very Large (>30%)
00002892.jpg,1200,675,351,1,1165,517,False,814,516,420024,1.7777777777777777,814,516,420024,1.5775193798449612,Very Large,758.0,259.0,0.6316666666666667,0.3837037037037037,middle-center,810000,0.5185481481481482,Very Large (>30%)
00001343.jpg,892,1000,369,75,615,396,False,246,321,78966,0.892,246,321,78966,0.7663551401869159,Very Large,492.0,235.5,0.5515695067264574,0.2355,top-center,892000,0.08852690582959641,Medium (5-15%)
00001425.jpg,1280,853,891,204,1092,360,False,201,156,31356,1.5005861664712778,201,156,31356,1.2884615384615385,Large,991.5,282.0,0.774609375,0.3305978898007034,middle-right,1091840,0.028718493552168815,Small (1-5%)
00003232.jpg,960,641,140,17,454,257,False,314,240,75360,1.497659906396256,314,240,75360,1.3083333333333333,Very Large,297.0,137.0,0.309375,0.21372854914196568,top-left,615360,0.12246489859594384,Medium (5-15%)
00003232.jpg,960,641,346,1,648,210,False,302,209,63118,1.497659906396256,302,209,63118,1.444976076555024,Very Large,497.0,105.5,0.5177083333333333,0.16458658346333854,top-center,615360,0.10257085283411337,Medium (5-15%)
00003232.jpg,960,641,403,172,652,365,False,249,193,48057,1.497659906396256,249,193,48057,1.2901554404145077,Large,527.5,268.5,0.5494791666666666,0.41887675507020283,middle-center,615360,0.0780957488299532,Medium (5-15%)
00002138.jpg,1300,917,473,78,824,366,False,351,288,101088,1.4176663031624863,351,288,101088,1.21875,Very Large,648.5,222.0,0.49884615384615383,0.2420937840785169,top-center,1192100,0.08479825517993457,Medium (5-15%)
00001431.jpg,1000,667,428,153,661,334,False,233,181,42173,1.4992503748125936,233,181,42173,1.287292817679558,Large,544.5,243.5,0.5445,0.3650674662668666,middle-center,667000,0.06322788605697151,Medium (5-15%)
00001357.jpg,866,1300,188,266,280,428,False,92,162,14904,0.6661538461538462,92,162,14904,0.5679012345679012,Medium,234.0,347.0,0.2702078521939954,0.26692307692307693,top-left,1125800,0.01323858589447504,Small (1-5%)
00001357.jpg,866,1300,562,388,661,560,False,99,172,17028,0.6661538461538462,99,172,17028,0.5755813953488372,Medium,611.5,474.0,0.7061200923787528,0.3646153846153846,middle-right,1125800,0.015125244270740806,Small (1-5%)
00000908.jpg,1300,866,260,87,544,307,False,284,220,62480,1.5011547344110854,284,220,62480,1.290909090909091,Very Large,402.0,197.0,0.30923076923076925,0.22748267898383373,top-left,1125800,0.055498312311245336,Medium (5-15%)
00001380.jpg,1000,1500,449,433,649,782,False,200,349,69800,0.6666666666666666,200,349,69800,0.5730659025787965,Very Large,549.0,607.5,0.549,0.405,middle-center,1500000,0.046533333333333336,Small (1-5%)
00002851.jpg,1400,788,69,140,816,630,False,747,490,366030,1.7766497461928934,747,490,366030,1.5244897959183674,Very Large,442.5,385.0,0.31607142857142856,0.4885786802030457,middle-left,1103200,0.33178934010152283,Very Large (>30%)
00002689.jpg,500,751,126,264,206,405,False,80,141,11280,0.6657789613848203,80,141,11280,0.5673758865248227,Medium,166.0,334.5,0.332,0.44540612516644473,middle-center,375500,0.03003994673768309,Small (1-5%)
00002689.jpg,500,751,249,286,322,415,False,73,129,9417,0.6657789613848203,73,129,9417,0.5658914728682171,Medium,285.5,350.5,0.571,0.466711051930759,middle-center,375500,0.02507856191744341,Small (1-5%)
00002689.jpg,500,751,65,343,124,447,False,59,104,6136,0.6657789613848203,59,104,6136,0.5673076923076923,Medium,94.5,395.0,0.189,0.525965379494008,middle-left,375500,0.016340878828229027,Small (1-5%)
00000920.jpg,1600,1167,421,33,1109,629,False,688,596,410048,1.3710368466152527,688,596,410048,1.1543624161073827,Very Large,765.0,331.0,0.478125,0.28363324764353043,top-center,1867200,0.2196058269065981,Large (15-30%)
00002845.jpg,1000,1500,511,368,616,551,False,105,183,19215,0.6666666666666666,105,183,19215,0.5737704918032787,Medium,563.5,459.5,0.5635,0.30633333333333335,top-center,1500000,0.01281,Small (1-5%)
00002312.jpg,651,1024,283,125,361,264,False,78,139,10842,0.6357421875,78,139,10842,0.5611510791366906,Medium,322.0,194.5,0.4946236559139785,0.18994140625,top-center,666624,0.01626404089861751,Small (1-5%)
00002474.jpg,1023,716,1,41,575,558,False,574,517,296758,1.4287709497206704,574,517,296758,1.1102514506769825,Very Large,288.0,299.5,0.28152492668621704,0.41829608938547486,middle-left,732468,0.40514807472817926,Very Large (>30%)
00002474.jpg,1023,716,455,56,1023,585,False,568,529,300472,1.4287709497206704,568,529,300472,1.0737240075614367,Very Large,739.0,320.5,0.7223851417399805,0.4476256983240223,middle-right,732468,0.4102186034065652,Very Large (>30%)
00000263.jpg,960,864,732,112,846,231,False,114,119,13566,1.1111111111111112,114,119,13566,0.957983193277311,Medium,789.0,171.5,0.821875,0.19849537037037038,top-right,829440,0.016355613425925924,Small (1-5%)
00000263.jpg,960,864,412,142,506,240,False,94,98,9212,1.1111111111111112,94,98,9212,0.9591836734693877,Medium,459.0,191.0,0.478125,0.22106481481481483,top-center,829440,0.011106288580246914,Small (1-5%)
00000263.jpg,960,864,573,114,674,219,False,101,105,10605,1.1111111111111112,101,105,10605,0.9619047619047619,Medium,623.5,166.5,0.6494791666666667,0.19270833333333334,top-center,829440,0.012785734953703705,Small (1-5%)
00001169.jpg,1470,980,487,106,969,472,False,482,366,176412,1.5,482,366,176412,1.3169398907103824,Very Large,728.0,289.0,0.49523809523809526,0.29489795918367345,top-center,1440600,0.12245730945439401,Medium (5-15%)
00002306.jpg,700,933,345,69,538,368,False,193,299,57707,0.7502679528403001,193,299,57707,0.6454849498327759,Very Large,441.5,218.5,0.6307142857142857,0.2341907824222937,top-center,653100,0.08835859745827591,Medium (5-15%)
00003018.jpg,360,540,110,64,181,184,False,71,120,8520,0.6666666666666666,71,120,8520,0.5916666666666667,Medium,145.5,124.0,0.4041666666666667,0.22962962962962963,top-center,194400,0.043827160493827164,Small (1-5%)
00003018.jpg,360,540,193,72,249,169,False,56,97,5432,0.6666666666666666,56,97,5432,0.5773195876288659,Medium,221.0,120.5,0.6138888888888889,0.22314814814814815,top-center,194400,0.02794238683127572,Small (1-5%)
00003018.jpg,360,540,120,205,204,351,False,84,146,12264,0.6666666666666666,84,146,12264,0.5753424657534246,Medium,162.0,278.0,0.45,0.5148148148148148,middle-center,194400,0.06308641975308642,Medium (5-15%)
00003030.jpg,1023,697,194,48,670,426,False,476,378,179928,1.4677187948350072,476,378,179928,1.2592592592592593,Very Large,432.0,237.0,0.4222873900293255,0.3400286944045911,middle-center,713031,0.2523424647736213,Large (15-30%)
00000539.jpg,1125,750,854,4,1089,187,False,235,183,43005,1.5,235,183,43005,1.284153005464481,Large,971.5,95.5,0.8635555555555555,0.12733333333333333,top-right,843750,0.05096888888888889,Medium (5-15%)
00000539.jpg,1125,750,88,310,551,670,False,463,360,166680,1.5,463,360,166680,1.2861111111111112,Very Large,319.5,490.0,0.284,0.6533333333333333,middle-left,843750,0.19754666666666668,Large (15-30%)
00000539.jpg,1125,750,725,71,981,270,False,256,199,50944,1.5,256,199,50944,1.2864321608040201,Very Large,853.0,170.5,0.7582222222222222,0.22733333333333333,top-right,843750,0.06037807407407408,Medium (5-15%)
00000539.jpg,1125,750,9,1,378,261,False,369,260,95940,1.5,369,260,95940,1.4192307692307693,Very Large,193.5,131.0,0.172,0.17466666666666666,top-left,843750,0.11370666666666666,Medium (5-15%)
00000539.jpg,1125,750,579,126,876,352,False,297,226,67122,1.5,297,226,67122,1.3141592920353982,Very Large,727.5,239.0,0.6466666666666666,0.31866666666666665,top-center,843750,0.079552,Medium (5-15%)
00000539.jpg,1125,750,325,284,678,552,False,353,268,94604,1.5,353,268,94604,1.3171641791044777,Very Large,501.5,418.0,0.4457777777777778,0.5573333333333333,middle-center,843750,0.11212325925925926,Medium (5-15%)
00000539.jpg,1125,750,841,186,1125,711,False,284,525,149100,1.5,284,525,149100,0.540952380952381,Very Large,983.0,448.5,0.8737777777777778,0.598,middle-right,843750,0.17671111111111112,Large (15-30%)
00001627.jpg,333,519,160,78,252,241,False,92,163,14996,0.6416184971098265,92,163,14996,0.5644171779141104,Medium,206.0,159.5,0.6186186186186187,0.30732177263969174,top-center,172827,0.08676884977463012,Medium (5-15%)
00002448.jpg,1000,750,111,95,338,289,False,227,194,44038,1.3333333333333333,227,194,44038,1.1701030927835052,Large,224.5,192.0,0.2245,0.256,top-left,750000,0.05871733333333334,Medium (5-15%)
00002448.jpg,1000,750,463,33,808,334,False,345,301,103845,1.3333333333333333,345,301,103845,1.1461794019933556,Very Large,635.5,183.5,0.6355,0.24466666666666667,top-center,750000,0.13846,Medium (5-15%)
00001155.jpg,1300,956,464,220,823,520,False,359,300,107700,1.3598326359832635,359,300,107700,1.1966666666666668,Very Large,643.5,370.0,0.495,0.38702928870292885,middle-center,1242800,0.08665915674283875,Medium (5-15%)
00001633.jpg,1066,1689,321,138,670,769,False,349,631,220219,0.6311426879810539,349,631,220219,0.5530903328050714,Very Large,495.5,453.5,0.4648217636022514,0.26850207223209,top-center,1800474,0.12231168014645033,Medium (5-15%)
00001814.jpg,1000,667,666,293,787,385,False,121,92,11132,1.4992503748125936,121,92,11132,1.315217391304348,Medium,726.5,339.0,0.7265,0.5082458770614693,middle-right,667000,0.016689655172413793,Small (1-5%)
00001814.jpg,1000,667,346,228,470,325,False,124,97,12028,1.4992503748125936,124,97,12028,1.2783505154639174,Medium,408.0,276.5,0.408,0.41454272863568215,middle-center,667000,0.01803298350824588,Small (1-5%)
00001814.jpg,1000,667,466,150,593,249,False,127,99,12573,1.4992503748125936,127,99,12573,1.2828282828282829,Medium,529.5,199.5,0.5295,0.29910044977511246,top-center,667000,0.01885007496251874,Small (1-5%)
00001814.jpg,1000,667,449,344,556,427,False,107,83,8881,1.4992503748125936,107,83,8881,1.2891566265060241,Medium,502.5,385.5,0.5025,0.5779610194902549,middle-center,667000,0.013314842578710644,Small (1-5%)
00001182.jpg,866,1390,400,231,478,376,False,78,145,11310,0.6230215827338129,78,145,11310,0.5379310344827586,Medium,439.0,303.5,0.5069284064665127,0.2183453237410072,top-center,1203740,0.009395716683004636,Tiny (<1%)
00001196.jpg,1474,980,848,94,1101,290,False,253,196,49588,1.5040816326530613,253,196,49588,1.2908163265306123,Large,974.5,192.0,0.6611261872455902,0.19591836734693877,top-center,1444520,0.034328358208955224,Small (1-5%)
00001829.jpg,1024,684,344,51,639,280,False,295,229,67555,1.4970760233918128,295,229,67555,1.2882096069868996,Very Large,491.5,165.5,0.47998046875,0.24195906432748537,top-center,700416,0.09644982410453216,Medium (5-15%)
00001815.jpg,333,519,135,25,189,120,False,54,95,5130,0.6416184971098265,54,95,5130,0.5684210526315789,Medium,162.0,72.5,0.4864864864864865,0.1396917148362235,top-center,172827,0.029682862052804248,Small (1-5%)
00001801.jpg,612,408,307,142,465,265,False,158,123,19434,1.5,158,123,19434,1.2845528455284554,Medium,386.0,203.5,0.630718954248366,0.4987745098039216,middle-center,249696,0.07783064206074587,Medium (5-15%)
00001801.jpg,612,408,66,22,386,270,False,320,248,79360,1.5,320,248,79360,1.2903225806451613,Very Large,226.0,146.0,0.369281045751634,0.35784313725490197,middle-center,249696,0.3178264769960272,Very Large (>30%)
00001801.jpg,612,408,414,134,556,242,False,142,108,15336,1.5,142,108,15336,1.3148148148148149,Medium,485.0,188.0,0.7924836601307189,0.46078431372549017,middle-right,249696,0.061418685121107264,Medium (5-15%)
00001154.jpg,1024,684,185,37,850,553,False,665,516,343140,1.4970760233918128,665,516,343140,1.2887596899224807,Very Large,517.5,295.0,0.50537109375,0.43128654970760233,middle-center,700416,0.4899088541666667,Very Large (>30%)
00003025.jpg,480,480,273,16,365,121,False,92,105,9660,1.0,92,105,9660,0.8761904761904762,Medium,319.0,68.5,0.6645833333333333,0.14270833333333333,top-center,230400,0.04192708333333333,Small (1-5%)
00001632.jpg,390,280,174,16,299,121,False,125,105,13125,1.3928571428571428,125,105,13125,1.1904761904761905,Medium,236.5,68.5,0.6064102564102564,0.24464285714285713,top-center,109200,0.1201923076923077,Medium (5-15%)
00000538.jpg,650,434,475,196,626,313,False,151,117,17667,1.4976958525345623,151,117,17667,1.2905982905982907,Medium,550.5,254.5,0.8469230769230769,0.586405529953917,middle-right,282100,0.06262672811059908,Medium (5-15%)
00003031.jpg,500,384,258,113,317,164,False,59,51,3009,1.3020833333333333,59,51,3009,1.1568627450980393,Small,287.5,138.5,0.575,0.3606770833333333,middle-center,192000,0.015671875,Small (1-5%)
00002449.jpg,512,512,116,50,401,382,False,285,332,94620,1.0,285,332,94620,0.858433734939759,Very Large,258.5,216.0,0.5048828125,0.421875,middle-center,262144,0.3609466552734375,Very Large (>30%)
00001140.jpg,1000,667,434,81,652,251,False,218,170,37060,1.4992503748125936,218,170,37060,1.2823529411764707,Large,543.0,166.0,0.543,0.24887556221889057,top-center,667000,0.055562218890554724,Medium (5-15%)
00001168.jpg,866,1300,313,123,498,445,False,185,322,59570,0.6661538461538462,185,322,59570,0.5745341614906833,Very Large,405.5,284.0,0.4682448036951501,0.21846153846153846,top-center,1125800,0.05291348374489252,Medium (5-15%)
00000510.jpg,1300,867,417,74,707,299,False,290,225,65250,1.4994232987312572,290,225,65250,1.288888888888889,Very Large,562.0,186.5,0.4323076923076923,0.21510957324106114,top-center,1127100,0.05789193505456481,Medium (5-15%)
00000510.jpg,1300,867,570,153,842,360,False,272,207,56304,1.4994232987312572,272,207,56304,1.3140096618357489,Very Large,706.0,256.5,0.5430769230769231,0.2958477508650519,top-center,1127100,0.04995475113122172,Small (1-5%)
00000510.jpg,1300,867,799,105,1108,345,False,309,240,74160,1.4994232987312572,309,240,74160,1.2875,Very Large,953.5,225.0,0.7334615384615385,0.25951557093425603,top-right,1127100,0.06579717859994677,Medium (5-15%)
00000510.jpg,1300,867,702,217,986,437,False,284,220,62480,1.4994232987312572,284,220,62480,1.290909090909091,Very Large,844.0,327.0,0.6492307692307693,0.3771626297577855,middle-center,1127100,0.05543430041699938,Medium (5-15%)
00003019.jpg,800,534,75,100,512,439,False,437,339,148143,1.4981273408239701,437,339,148143,1.289085545722714,Very Large,293.5,269.5,0.366875,0.5046816479400749,middle-center,427200,0.3467766853932584,Very Large (>30%)
00002307.jpg,512,768,152,5,381,397,False,229,392,89768,0.6666666666666666,229,392,89768,0.5841836734693877,Very Large,266.5,201.0,0.5205078125,0.26171875,top-center,393216,0.22829182942708334,Large (15-30%)
00002313.jpg,680,1023,220,61,488,530,False,268,469,125692,0.6647116324535679,268,469,125692,0.5714285714285714,Very Large,354.0,295.5,0.5205882352941177,0.28885630498533726,top-center,695640,0.18068541199470992,Large (15-30%)
00000504.jpg,1500,1101,221,244,453,442,False,232,198,45936,1.3623978201634876,232,198,45936,1.1717171717171717,Large,337.0,343.0,0.22466666666666665,0.3115349682107175,top-left,1651500,0.027814713896457767,Small (1-5%)
00000504.jpg,1500,1101,399,384,680,619,False,281,235,66035,1.3623978201634876,281,235,66035,1.195744680851064,Very Large,539.5,501.5,0.3596666666666667,0.4554950045413261,middle-center,1651500,0.039984862246442626,Small (1-5%)
00000504.jpg,1500,1101,824,364,1087,584,False,263,220,57860,1.3623978201634876,263,220,57860,1.1954545454545455,Very Large,955.5,474.0,0.637,0.4305177111716621,middle-center,1651500,0.03503481683318196,Small (1-5%)
00000504.jpg,1500,1101,515,201,741,394,False,226,193,43618,1.3623978201634876,226,193,43618,1.1709844559585492,Large,628.0,297.5,0.4186666666666667,0.27020890099909173,top-center,1651500,0.026411141386618226,Small (1-5%)
00000504.jpg,1500,1101,579,379,854,609,False,275,230,63250,1.3623978201634876,275,230,63250,1.1956521739130435,Very Large,716.5,494.0,0.4776666666666667,0.44868301544050865,middle-center,1651500,0.038298516500151376,Small (1-5%)
00000504.jpg,1500,1101,739,238,933,404,False,194,166,32204,1.3623978201634876,194,166,32204,1.1686746987951808,Large,836.0,321.0,0.5573333333333333,0.29155313351498635,top-center,1651500,0.019499848622464427,Small (1-5%)
00000504.jpg,1500,1101,1008,241,1239,438,False,231,197,45507,1.3623978201634876,231,197,45507,1.1725888324873097,Large,1123.5,339.5,0.749,0.3083560399636694,top-right,1651500,0.02755495004541326,Small (1-5%)
00002475.jpg,540,349,210,175,264,215,False,54,40,2160,1.5472779369627507,54,40,2160,1.35,Small,237.0,195.0,0.4388888888888889,0.5587392550143266,middle-center,188460,0.011461318051575931,Small (1-5%)
00000935.jpg,1232,821,491,177,754,386,False,263,209,54967,1.5006090133982948,263,209,54967,1.2583732057416268,Very Large,622.5,281.5,0.505275974025974,0.34287454323995126,middle-center,1011472,0.05434357055855229,Medium (5-15%)
00001395.jpg,1000,667,189,1,1000,665,False,811,664,538504,1.4992503748125936,811,664,538504,1.2213855421686748,Very Large,594.5,333.0,0.5945,0.4992503748125937,middle-center,667000,0.807352323838081,Very Large (>30%)
00002850.jpg,1333,2000,479,180,694,555,False,215,375,80625,0.6665,215,375,80625,0.5733333333333334,Very Large,586.5,367.5,0.4399849962490623,0.18375,top-center,2666000,0.03024193548387097,Small (1-5%)
00001381.jpg,2000,1333,822,107,1308,484,False,486,377,183222,1.5003750937734435,486,377,183222,1.2891246684350133,Very Large,1065.0,295.5,0.5325,0.22168042010502625,top-center,2666000,0.06872543135783946,Medium (5-15%)
00000921.jpg,509,339,255,1,442,144,False,187,143,26741,1.5014749262536873,187,143,26741,1.3076923076923077,Large,348.5,72.5,0.6846758349705304,0.21386430678466076,top-right,172551,0.15497447131572695,Large (15-30%)
00002878.jpg,736,489,298,186,449,302,False,151,116,17516,1.5051124744376279,151,116,17516,1.3017241379310345,Medium,373.5,244.0,0.5074728260869565,0.49897750511247446,middle-center,359904,0.048668533831243886,Small (1-5%)
00001430.jpg,538,612,197,92,331,268,False,134,176,23584,0.8790849673202614,134,176,23584,0.7613636363636364,Large,264.0,180.0,0.49070631970260226,0.29411764705882354,top-center,329256,0.07162815559929052,Medium (5-15%)
00002139.jpg,1000,667,55,19,577,424,False,522,405,211410,1.4992503748125936,522,405,211410,1.288888888888889,Very Large,316.0,221.5,0.316,0.3320839580209895,middle-left,667000,0.3169565217391304,Very Large (>30%)
00002887.jpg,940,529,77,261,257,379,False,180,118,21240,1.776937618147448,180,118,21240,1.5254237288135593,Large,167.0,320.0,0.1776595744680851,0.6049149338374291,middle-left,497260,0.04271407312070145,Small (1-5%)
00002887.jpg,940,529,601,224,801,353,False,200,129,25800,1.776937618147448,200,129,25800,1.550387596899225,Large,701.0,288.5,0.7457446808510638,0.5453686200378072,middle-right,497260,0.051884326107066725,Medium (5-15%)
00002887.jpg,940,529,376,21,635,191,False,259,170,44030,1.776937618147448,259,170,44030,1.5235294117647058,Large,505.5,106.0,0.5377659574468086,0.2003780718336484,top-center,497260,0.08854522784861038,Medium (5-15%)
00002887.jpg,940,529,164,100,412,266,False,248,166,41168,1.776937618147448,248,166,41168,1.4939759036144578,Large,288.0,183.0,0.30638297872340425,0.34593572778827975,middle-left,497260,0.08278968748743112,Medium (5-15%)
00001356.jpg,800,533,259,47,521,251,False,262,204,53448,1.5009380863039399,262,204,53448,1.2843137254901962,Very Large,390.0,149.0,0.4875,0.2795497185741088,top-center,426400,0.1253470919324578,Medium (5-15%)
00002893.jpg,1300,960,236,194,779,661,False,543,467,253581,1.3541666666666667,543,467,253581,1.1627408993576016,Very Large,507.5,427.5,0.3903846153846154,0.4453125,middle-center,1248000,0.20318990384615385,Large (15-30%)
00002893.jpg,1300,960,588,139,1207,671,False,619,532,329308,1.3541666666666667,619,532,329308,1.163533834586466,Very Large,897.5,405.0,0.6903846153846154,0.421875,middle-right,1248000,0.26386858974358973,Large (15-30%)
00003233.jpg,800,800,337,197,475,357,False,138,160,22080,1.0,138,160,22080,0.8625,Large,406.0,277.0,0.5075,0.34625,middle-center,640000,0.0345,Small (1-5%)
00001424.jpg,1066,1600,457,739,739,1231,False,282,492,138744,0.66625,282,492,138744,0.573170731707317,Very Large,598.0,985.0,0.5609756097560976,0.615625,middle-center,1705600,0.08134615384615385,Medium (5-15%)
00002105.jpg,450,300,1,1,420,193,False,419,192,80448,1.5,419,192,80448,2.1822916666666665,Very Large,210.5,97.0,0.4677777777777778,0.3233333333333333,top-center,135000,0.5959111111111111,Very Large (>30%)
00000074.jpg,1300,945,471,112,755,347,False,284,235,66740,1.3756613756613756,284,235,66740,1.2085106382978723,Very Large,613.0,229.5,0.4715384615384615,0.24285714285714285,top-center,1228500,0.05432641432641433,Medium (5-15%)
00002663.jpg,650,488,79,83,275,254,False,196,171,33516,1.3319672131147542,196,171,33516,1.1461988304093567,Large,177.0,168.5,0.2723076923076923,0.3452868852459016,middle-left,317200,0.10566204287515762,Medium (5-15%)
00002663.jpg,650,488,342,78,638,337,False,296,259,76664,1.3319672131147542,296,259,76664,1.1428571428571428,Very Large,490.0,207.5,0.7538461538461538,0.42520491803278687,middle-right,317200,0.24168978562421187,Large (15-30%)
00002677.jpg,500,333,145,36,373,217,False,228,181,41268,1.5015015015015014,228,181,41268,1.2596685082872927,Large,259.0,126.5,0.518,0.37987987987987987,middle-center,166500,0.24785585585585584,Large (15-30%)
00000706.jpg,6000,4000,410,1034,1037,1531,False,627,497,311619,1.5,627,497,311619,1.261569416498994,Very Large,723.5,1282.5,0.12058333333333333,0.320625,top-left,24000000,0.012984125,Small (1-5%)
00001418.jpg,2825,4237,1327,402,1663,988,False,336,586,196896,0.6667453386830304,336,586,196896,0.5733788395904437,Very Large,1495.0,695.0,0.5292035398230088,0.16403115411848004,top-center,11969525,0.016449775575889603,Small (1-5%)
00002111.jpg,1024,683,315,93,873,536,False,558,443,247194,1.499267935578331,558,443,247194,1.2595936794582392,Very Large,594.0,314.5,0.580078125,0.46046852122986826,middle-center,699392,0.35344127470717424,Very Large (>30%)
00003390.jpg,1080,828,258,30,762,488,False,504,458,230832,1.3043478260869565,504,458,230832,1.1004366812227073,Very Large,510.0,259.0,0.4722222222222222,0.31280193236714976,top-center,894240,0.25813204508856685,Large (15-30%)
00000699.jpg,1000,1000,345,337,645,687,False,300,350,105000,1.0,300,350,105000,0.8571428571428571,Very Large,495.0,512.0,0.495,0.512,middle-center,1000000,0.105,Medium (5-15%)
00000699.jpg,1000,1000,678,439,960,767,False,282,328,92496,1.0,282,328,92496,0.8597560975609756,Very Large,819.0,603.0,0.819,0.603,middle-right,1000000,0.092496,Medium (5-15%)
00001587.jpg,2325,3500,1142,862,1516,1519,False,374,657,245718,0.6642857142857143,374,657,245718,0.5692541856925418,Very Large,1329.0,1190.5,0.5716129032258065,0.34014285714285714,middle-center,8137500,0.030195760368663595,Small (1-5%)
00000841.jpg,1500,1000,500,1,1372,621,False,872,620,540640,1.5,872,620,540640,1.4064516129032258,Very Large,936.0,311.0,0.624,0.311,top-center,1500000,0.3604266666666667,Very Large (>30%)
00002930.jpg,1068,1689,228,335,471,783,False,243,448,108864,0.6323268206039077,243,448,108864,0.5424107142857143,Very Large,349.5,559.0,0.32724719101123595,0.3309650680876258,middle-left,1803852,0.06035084918274892,Medium (5-15%)
00001593.jpg,334,500,93,53,167,180,False,74,127,9398,0.668,74,127,9398,0.5826771653543307,Medium,130.0,116.5,0.38922155688622756,0.233,top-center,167000,0.05627544910179641,Medium (5-15%)
00003384.jpg,1333,2000,539,550,759,933,False,220,383,84260,0.6665,220,383,84260,0.5744125326370757,Very Large,649.0,741.5,0.48687171792948236,0.37075,middle-center,2666000,0.031605401350337584,Small (1-5%)
00002918.jpg,2370,1350,1259,332,1666,602,False,407,270,109890,1.7555555555555555,407,270,109890,1.5074074074074073,Very Large,1462.5,467.0,0.6170886075949367,0.3459259259259259,middle-center,3199500,0.034345991561181434,Small (1-5%)
00000869.jpg,1300,956,501,56,918,413,False,417,357,148869,1.3598326359832635,417,357,148869,1.1680672268907564,Very Large,709.5,234.5,0.5457692307692308,0.2452928870292887,top-center,1242800,0.11978516253620856,Medium (5-15%)
00001544.jpg,1000,672,397,42,679,262,False,282,220,62040,1.4880952380952381,282,220,62040,1.2818181818181817,Very Large,538.0,152.0,0.538,0.2261904761904762,top-center,672000,0.09232142857142857,Medium (5-15%)
00000882.jpg,683,1023,359,184,434,317,False,75,133,9975,0.667644183773216,75,133,9975,0.5639097744360902,Medium,396.5,250.5,0.5805270863836017,0.24486803519061584,top-center,698709,0.0142763296307905,Small (1-5%)
00003353.jpg,390,280,171,108,214,145,False,43,37,1591,1.3928571428571428,43,37,1591,1.162162162162162,Small,192.5,126.5,0.4935897435897436,0.4517857142857143,middle-center,109200,0.01456959706959707,Small (1-5%)
00003435.jpg,640,960,143,117,309,406,False,166,289,47974,0.6666666666666666,166,289,47974,0.5743944636678201,Large,226.0,261.5,0.353125,0.27239583333333334,top-center,614400,0.07808268229166666,Medium (5-15%)
00003435.jpg,640,960,352,280,504,540,False,152,260,39520,0.6666666666666666,152,260,39520,0.5846153846153846,Large,428.0,410.0,0.66875,0.4270833333333333,middle-center,614400,0.06432291666666666,Medium (5-15%)
00001222.jpg,800,501,487,47,694,195,False,207,148,30636,1.596806387225549,207,148,30636,1.3986486486486487,Large,590.5,121.0,0.738125,0.24151696606786427,top-right,400800,0.07643712574850299,Medium (5-15%)
00000128.jpg,910,607,491,201,662,333,False,171,132,22572,1.4991762767710048,171,132,22572,1.2954545454545454,Large,576.5,267.0,0.6335164835164835,0.43986820428336076,middle-center,552370,0.04086391368104712,Small (1-5%)
00001236.jpg,600,900,179,18,356,326,False,177,308,54516,0.6666666666666666,177,308,54516,0.5746753246753247,Very Large,267.5,172.0,0.44583333333333336,0.19111111111111112,top-center,540000,0.10095555555555556,Medium (5-15%)
00003421.jpg,736,490,136,21,438,254,False,302,233,70366,1.5020408163265306,302,233,70366,1.296137339055794,Very Large,287.0,137.5,0.389945652173913,0.28061224489795916,top-center,360640,0.19511424134871339,Large (15-30%)
00003421.jpg,736,490,369,67,626,271,False,257,204,52428,1.5020408163265306,257,204,52428,1.2598039215686274,Very Large,497.5,169.0,0.6759510869565217,0.3448979591836735,middle-right,360640,0.14537488908606921,Medium (5-15%)
00002059.jpg,408,612,116,73,250,306,False,134,233,31222,0.6666666666666666,134,233,31222,0.575107296137339,Large,183.0,189.5,0.4485294117647059,0.309640522875817,top-center,249696,0.12504004869921825,Medium (5-15%)
00001550.jpg,683,1024,294,37,377,182,False,83,145,12035,0.6669921875,83,145,12035,0.5724137931034483,Medium,335.5,109.5,0.4912152269399707,0.10693359375,top-center,699392,0.01720780334919473,Small (1-5%)
00000896.jpg,1232,821,398,146,794,453,False,396,307,121572,1.5006090133982948,396,307,121572,1.289902280130293,Very Large,596.0,299.5,0.4837662337662338,0.36479902557856275,middle-center,1011472,0.12019314424917348,Medium (5-15%)
00002071.jpg,867,1390,336,103,473,363,False,137,260,35620,0.6237410071942446,137,260,35620,0.5269230769230769,Large,404.5,233.0,0.46655132641291813,0.16762589928057553,top-center,1205130,0.02955697725556579,Small (1-5%)
00001578.jpg,1307,1960,381,505,678,1024,False,297,519,154143,0.6668367346938775,297,519,154143,0.5722543352601156,Very Large,529.5,764.5,0.40512624330527924,0.39005102040816325,middle-center,2561720,0.0601716815264744,Medium (5-15%)
00000100.jpg,1333,2000,664,478,974,1008,False,310,530,164300,0.6665,310,530,164300,0.5849056603773585,Very Large,819.0,743.0,0.614403600900225,0.3715,middle-center,2666000,0.06162790697674419,Medium (5-15%)
00000114.jpg,600,900,127,29,267,268,False,140,239,33460,0.6666666666666666,140,239,33460,0.5857740585774058,Large,197.0,148.5,0.3283333333333333,0.165,top-left,540000,0.06196296296296296,Medium (5-15%)
00000672.jpg,800,583,517,144,779,371,False,262,227,59474,1.3722126929674099,262,227,59474,1.1541850220264318,Very Large,648.0,257.5,0.81,0.44168096054888506,middle-right,466400,0.1275171526586621,Medium (5-15%)
00000672.jpg,800,583,45,60,303,278,False,258,218,56244,1.3722126929674099,258,218,56244,1.18348623853211,Very Large,174.0,169.0,0.2175,0.28987993138936535,top-left,466400,0.1205917667238422,Medium (5-15%)
00000672.jpg,800,583,181,133,523,423,False,342,290,99180,1.3722126929674099,342,290,99180,1.1793103448275861,Very Large,352.0,278.0,0.44,0.47684391080617494,middle-center,466400,0.2126500857632933,Large (15-30%)
00000672.jpg,800,583,362,5,602,200,False,240,195,46800,1.3722126929674099,240,195,46800,1.2307692307692308,Large,482.0,102.5,0.6025,0.1758147512864494,top-center,466400,0.10034305317324185,Medium (5-15%)
00000672.jpg,800,583,234,1,437,162,False,203,161,32683,1.3722126929674099,203,161,32683,1.2608695652173914,Large,335.5,81.5,0.419375,0.13979416809605488,top-center,466400,0.07007504288164665,Medium (5-15%)
00002065.jpg,1024,830,444,51,624,217,False,180,166,29880,1.2337349397590363,180,166,29880,1.0843373493975903,Large,534.0,134.0,0.521484375,0.1614457831325301,top-center,849920,0.03515625,Small (1-5%)
00001785.jpg,1300,929,1,1,1053,498,False,1052,497,522844,1.3993541442411195,1052,497,522844,2.1167002012072436,Very Large,527.0,249.5,0.4053846153846154,0.26856835306781485,top-center,1207700,0.43292539537964725,Very Large (>30%)
00003192.jpg,800,533,382,60,633,254,False,251,194,48694,1.5009380863039399,251,194,48694,1.2938144329896908,Large,507.5,157.0,0.634375,0.2945590994371482,top-center,426400,0.11419793621013133,Medium (5-15%)
00003192.jpg,800,533,199,112,415,280,False,216,168,36288,1.5009380863039399,216,168,36288,1.2857142857142858,Large,307.0,196.0,0.38375,0.3677298311444653,middle-center,426400,0.0851031894934334,Medium (5-15%)
00001791.jpg,590,393,225,56,427,212,False,202,156,31512,1.5012722646310432,202,156,31512,1.294871794871795,Large,326.0,134.0,0.5525423728813559,0.34096692111959287,middle-center,231870,0.13590373916418683,Medium (5-15%)
00001961.jpg,1000,667,305,71,695,374,False,390,303,118170,1.4992503748125936,390,303,118170,1.2871287128712872,Very Large,500.0,222.5,0.5,0.3335832083958021,middle-center,667000,0.1771664167916042,Large (15-30%)
00001975.jpg,1000,667,381,57,657,271,False,276,214,59064,1.4992503748125936,276,214,59064,1.2897196261682242,Very Large,519.0,164.0,0.519,0.24587706146926536,top-center,667000,0.08855172413793104,Medium (5-15%)
00002529.jpg,420,512,187,1,260,74,False,73,73,5329,0.8203125,73,73,5329,1.0,Medium,223.5,37.5,0.5321428571428571,0.0732421875,top-center,215040,0.024781436011904762,Small (1-5%)
00003151.jpg,1024,664,354,137,522,264,False,168,127,21336,1.5421686746987953,168,127,21336,1.3228346456692914,Large,438.0,200.5,0.427734375,0.3019578313253012,top-center,679936,0.031379423945783136,Small (1-5%)
00003151.jpg,1024,664,254,184,430,313,False,176,129,22704,1.5421686746987953,176,129,22704,1.3643410852713178,Large,342.0,248.5,0.333984375,0.3742469879518072,middle-center,679936,0.033391378012048195,Small (1-5%)
00003151.jpg,1024,664,154,162,306,276,False,152,114,17328,1.5421686746987953,152,114,17328,1.3333333333333333,Medium,230.0,219.0,0.224609375,0.32981927710843373,top-left,679936,0.025484751506024098,Small (1-5%)
00001746.jpg,2000,1334,738,311,1340,778,False,602,467,281134,1.4992503748125936,602,467,281134,1.2890792291220556,Very Large,1039.0,544.5,0.5195,0.40817091454272864,middle-center,2668000,0.10537256371814092,Medium (5-15%)
00001752.jpg,1061,1300,414,92,600,352,False,186,260,48360,0.8161538461538461,186,260,48360,0.7153846153846154,Large,507.0,222.0,0.47785108388312914,0.17076923076923076,top-center,1379300,0.0350612629594722,Small (1-5%)
00003145.jpg,500,331,44,34,373,287,False,329,253,83237,1.5105740181268883,329,253,83237,1.300395256916996,Very Large,208.5,160.5,0.417,0.48489425981873113,middle-center,165500,0.5029425981873111,Very Large (>30%)
00001034.jpg,600,438,87,24,215,133,False,128,109,13952,1.36986301369863,128,109,13952,1.1743119266055047,Medium,151.0,78.5,0.25166666666666665,0.17922374429223745,top-left,262800,0.05308980213089802,Medium (5-15%)
00002273.jpg,1000,838,302,142,603,435,False,301,293,88193,1.1933174224343674,301,293,88193,1.0273037542662116,Very Large,452.5,288.5,0.4525,0.34427207637231505,middle-center,838000,0.10524224343675417,Medium (5-15%)
00002267.jpg,590,394,166,8,436,219,False,270,211,56970,1.49746192893401,270,211,56970,1.2796208530805686,Very Large,301.0,113.5,0.5101694915254237,0.2880710659898477,top-center,232460,0.24507442140583327,Large (15-30%)
00000470.jpg,1000,562,291,124,495,258,False,204,134,27336,1.7793594306049823,204,134,27336,1.5223880597014925,Large,393.0,191.0,0.393,0.3398576512455516,middle-center,562000,0.04864056939501779,Small (1-5%)
00001008.jpg,1000,667,364,34,611,226,False,247,192,47424,1.4992503748125936,247,192,47424,1.2864583333333333,Large,487.5,130.0,0.4875,0.19490254872563717,top-center,667000,0.07110044977511244,Medium (5-15%)
00002271.jpg,1800,1692,789,334,1354,939,False,565,605,341825,1.0638297872340425,565,605,341825,0.9338842975206612,Very Large,1071.5,636.5,0.5952777777777778,0.3761820330969267,middle-center,3045600,0.11223568426582611,Medium (5-15%)
00001778.jpg,866,1300,373,15,713,621,False,340,606,206040,0.6661538461538462,340,606,206040,0.5610561056105611,Very Large,543.0,318.0,0.6270207852193995,0.24461538461538462,top-center,1125800,0.18301652158465093,Large (15-30%)
00000466.jpg,600,400,318,129,392,188,False,74,59,4366,1.5,74,59,4366,1.2542372881355932,Small,355.0,158.5,0.5916666666666667,0.39625,middle-center,240000,0.018191666666666665,Small (1-5%)
00000300.jpg,1000,667,185,165,339,284,False,154,119,18326,1.4992503748125936,154,119,18326,1.2941176470588236,Medium,262.0,224.5,0.262,0.3365817091454273,middle-left,667000,0.027475262368815593,Small (1-5%)
00000300.jpg,1000,667,525,272,644,364,False,119,92,10948,1.4992503748125936,119,92,10948,1.2934782608695652,Medium,584.5,318.0,0.5845,0.4767616191904048,middle-center,667000,0.016413793103448277,Small (1-5%)
00002517.jpg,960,441,65,111,261,216,False,196,105,20580,2.17687074829932,196,105,20580,1.8666666666666667,Large,163.0,163.5,0.16979166666666667,0.3707482993197279,middle-left,423360,0.04861111111111111,Small (1-5%)
00002517.jpg,960,441,259,320,451,423,False,192,103,19776,2.17687074829932,192,103,19776,1.8640776699029127,Medium,355.0,371.5,0.3697916666666667,0.8424036281179138,bottom-center,423360,0.04671201814058957,Small (1-5%)
00002517.jpg,960,441,302,27,486,123,False,184,96,17664,2.17687074829932,184,96,17664,1.9166666666666667,Medium,394.0,75.0,0.41041666666666665,0.17006802721088435,top-center,423360,0.041723356009070296,Small (1-5%)
00002517.jpg,960,441,734,11,918,109,False,184,98,18032,2.17687074829932,184,98,18032,1.8775510204081634,Medium,826.0,60.0,0.8604166666666667,0.1360544217687075,top-right,423360,0.04259259259259259,Small (1-5%)
00002517.jpg,960,441,513,105,713,210,False,200,105,21000,2.17687074829932,200,105,21000,1.9047619047619047,Large,613.0,157.5,0.6385416666666667,0.35714285714285715,middle-center,423360,0.0496031746031746,Small (1-5%)
00002517.jpg,960,441,416,285,574,370,False,158,85,13430,2.17687074829932,158,85,13430,1.8588235294117648,Medium,495.0,327.5,0.515625,0.7426303854875284,bottom-center,423360,0.0317224111866969,Small (1-5%)
00002503.jpg,780,520,281,41,734,393,False,453,352,159456,1.5,453,352,159456,1.2869318181818181,Very Large,507.5,217.0,0.6506410256410257,0.4173076923076923,middle-center,405600,0.39313609467455624,Very Large (>30%)
00000472.jpg,1200,630,521,195,782,355,False,261,160,41760,1.9047619047619047,261,160,41760,1.63125,Large,651.5,275.0,0.5429166666666667,0.4365079365079365,middle-center,756000,0.05523809523809524,Medium (5-15%)
00002265.jpg,4248,3416,804,261,1635,1039,False,831,778,646518,1.243559718969555,831,778,646518,1.0681233933161953,Very Large,1219.5,650.0,0.2870762711864407,0.19028103044496486,top-left,14511168,0.04455313314545046,Small (1-5%)
00002265.jpg,4248,3416,2565,248,3311,946,False,746,698,520708,1.243559718969555,746,698,520708,1.0687679083094557,Very Large,2938.0,597.0,0.6916195856873822,0.17476580796252927,top-right,14511168,0.0358832590181576,Small (1-5%)
00002265.jpg,4248,3416,1962,506,2589,1093,False,627,587,368049,1.243559718969555,627,587,368049,1.0681431005110733,Very Large,2275.5,799.5,0.5356638418079096,0.2340456674473068,top-center,14511168,0.02536315477844375,Small (1-5%)
00001744.jpg,650,434,223,99,427,258,False,204,159,32436,1.4976958525345623,204,159,32436,1.2830188679245282,Large,325.0,178.5,0.5,0.4112903225806452,middle-center,282100,0.11498050336760014,Medium (5-15%)
00003153.jpg,612,408,275,90,380,171,False,105,81,8505,1.5,105,81,8505,1.2962962962962963,Medium,327.5,130.5,0.5351307189542484,0.31985294117647056,top-center,249696,0.03406141868512111,Small (1-5%)
00003153.jpg,612,408,48,76,149,155,False,101,79,7979,1.5,101,79,7979,1.2784810126582278,Medium,98.5,115.5,0.16094771241830066,0.28308823529411764,top-left,249696,0.03195485710624119,Small (1-5%)
00003153.jpg,612,408,481,84,578,159,False,97,75,7275,1.5,97,75,7275,1.2933333333333332,Medium,529.5,121.5,0.8651960784313726,0.2977941176470588,top-right,249696,0.029135428681276433,Small (1-5%)
00003153.jpg,612,408,385,111,477,183,False,92,72,6624,1.5,92,72,6624,1.2777777777777777,Medium,431.0,147.0,0.704248366013072,0.3602941176470588,middle-right,249696,0.0265282583621684,Small (1-5%)
00000328.jpg,1470,980,859,170,1106,362,False,247,192,47424,1.5,247,192,47424,1.2864583333333333,Large,982.5,266.0,0.6683673469387755,0.2714285714285714,top-center,1440600,0.03291961682632236,Small (1-5%)
00003147.jpg,640,960,338,229,421,374,False,83,145,12035,0.6666666666666666,83,145,12035,0.5724137931034483,Medium,379.5,301.5,0.59296875,0.3140625,top-center,614400,0.019588216145833334,Small (1-5%)
00002259.jpg,634,407,377,52,482,130,False,105,78,8190,1.5577395577395576,105,78,8190,1.3461538461538463,Medium,429.5,91.0,0.6774447949526814,0.22358722358722358,top-right,258038,0.031739511234779375,Small (1-5%)
00002259.jpg,634,407,248,40,352,118,False,104,78,8112,1.5577395577395576,104,78,8112,1.3333333333333333,Medium,300.0,79.0,0.47318611987381703,0.1941031941031941,top-center,258038,0.031437230175400524,Small (1-5%)
00001977.jpg,1300,861,401,59,957,487,False,556,428,237968,1.5098722415795587,556,428,237968,1.2990654205607477,Very Large,679.0,273.0,0.5223076923076924,0.3170731707317073,top-center,1119300,0.21260430626284285,Large (15-30%)
00001787.jpg,1024,683,136,99,406,309,False,270,210,56700,1.499267935578331,270,210,56700,1.2857142857142858,Very Large,271.0,204.0,0.2646484375,0.2986822840409956,top-left,699392,0.0810704154465593,Medium (5-15%)
00003184.jpg,612,408,320,59,379,105,False,59,46,2714,1.5,59,46,2714,1.2826086956521738,Small,349.5,82.0,0.571078431372549,0.20098039215686275,top-center,249696,0.010869216967832884,Small (1-5%)
00003184.jpg,612,408,95,83,157,132,False,62,49,3038,1.5,62,49,3038,1.2653061224489797,Small,126.0,107.5,0.20588235294117646,0.26348039215686275,top-left,249696,0.012166794822504165,Small (1-5%)
00003184.jpg,612,408,470,109,543,166,False,73,57,4161,1.5,73,57,4161,1.280701754385965,Small,506.5,137.5,0.8276143790849673,0.33700980392156865,middle-right,249696,0.01666426374471357,Small (1-5%)
00002715.jpg,1200,1200,744,244,880,403,False,136,159,21624,1.0,136,159,21624,0.8553459119496856,Large,812.0,323.5,0.6766666666666666,0.26958333333333334,top-right,1440000,0.015016666666666666,Small (1-5%)
00002715.jpg,1200,1200,619,101,800,308,False,181,207,37467,1.0,181,207,37467,0.8743961352657005,Large,709.5,204.5,0.59125,0.17041666666666666,top-center,1440000,0.02601875,Small (1-5%)
00002715.jpg,1200,1200,431,107,583,284,False,152,177,26904,1.0,152,177,26904,0.8587570621468926,Large,507.0,195.5,0.4225,0.16291666666666665,top-center,1440000,0.018683333333333333,Small (1-5%)
00002715.jpg,1200,1200,482,396,610,545,False,128,149,19072,1.0,128,149,19072,0.8590604026845637,Medium,546.0,470.5,0.455,0.39208333333333334,middle-center,1440000,0.013244444444444444,Small (1-5%)
00000664.jpg,600,400,249,117,367,209,False,118,92,10856,1.5,118,92,10856,1.2826086956521738,Medium,308.0,163.0,0.5133333333333333,0.4075,middle-center,240000,0.045233333333333334,Small (1-5%)
00000664.jpg,600,400,65,114,170,195,False,105,81,8505,1.5,105,81,8505,1.2962962962962963,Medium,117.5,154.5,0.19583333333333333,0.38625,middle-left,240000,0.0354375,Small (1-5%)
00000664.jpg,600,400,184,138,272,207,False,88,69,6072,1.5,88,69,6072,1.2753623188405796,Medium,228.0,172.5,0.38,0.43125,middle-center,240000,0.0253,Small (1-5%)
00000664.jpg,600,400,233,75,323,143,False,90,68,6120,1.5,90,68,6120,1.3235294117647058,Medium,278.0,109.0,0.4633333333333333,0.2725,top-center,240000,0.0255,Small (1-5%)
00002073.jpg,1000,662,297,49,625,296,False,328,247,81016,1.5105740181268883,328,247,81016,1.3279352226720649,Very Large,461.0,172.5,0.461,0.26057401812688824,top-center,662000,0.12238066465256797,Medium (5-15%)
00002067.jpg,1300,861,367,77,1003,578,False,636,501,318636,1.5098722415795587,636,501,318636,1.2694610778443114,Very Large,685.0,327.5,0.5269230769230769,0.3803716608594657,middle-center,1119300,0.2846743500402037,Large (15-30%)
00003379.jpg,612,408,93,255,226,358,False,133,103,13699,1.5,133,103,13699,1.2912621359223302,Medium,159.5,306.5,0.26062091503267976,0.7512254901960784,bottom-left,249696,0.05486271305907984,Medium (5-15%)
00003379.jpg,612,408,428,20,593,148,False,165,128,21120,1.5,165,128,21120,1.2890625,Large,510.5,84.0,0.8341503267973857,0.20588235294117646,top-right,249696,0.08458285274894271,Medium (5-15%)
00003379.jpg,612,408,232,111,375,219,False,143,108,15444,1.5,143,108,15444,1.3240740740740742,Medium,303.5,165.0,0.4959150326797386,0.40441176470588236,middle-center,249696,0.06185121107266436,Medium (5-15%)
00003379.jpg,612,408,239,215,375,323,False,136,108,14688,1.5,136,108,14688,1.2592592592592593,Medium,307.0,269.0,0.5016339869281046,0.6593137254901961,middle-center,249696,0.058823529411764705,Medium (5-15%)
00000670.jpg,1600,1155,403,173,737,454,False,334,281,93854,1.3852813852813852,334,281,93854,1.188612099644128,Very Large,570.0,313.5,0.35625,0.2714285714285714,top-center,1848000,0.05078679653679654,Medium (5-15%)
00000670.jpg,1600,1155,674,191,1015,478,False,341,287,97867,1.3852813852813852,341,287,97867,1.1881533101045296,Very Large,844.5,334.5,0.5278125,0.2896103896103896,top-center,1848000,0.052958333333333336,Medium (5-15%)
00000670.jpg,1600,1155,963,160,1327,460,False,364,300,109200,1.3852813852813852,364,300,109200,1.2133333333333334,Very Large,1145.0,310.0,0.715625,0.2683982683982684,top-right,1848000,0.05909090909090909,Medium (5-15%)
00001208.jpg,600,900,350,106,415,220,False,65,114,7410,0.6666666666666666,65,114,7410,0.5701754385964912,Medium,382.5,163.0,0.6375,0.1811111111111111,top-center,540000,0.013722222222222222,Small (1-5%)
00002701.jpg,1000,714,239,171,498,382,False,259,211,54649,1.4005602240896358,259,211,54649,1.2274881516587677,Very Large,368.5,276.5,0.3685,0.3872549019607843,middle-center,714000,0.0765392156862745,Medium (5-15%)
00002701.jpg,1000,714,353,147,606,357,False,253,210,53130,1.4005602240896358,253,210,53130,1.2047619047619047,Very Large,479.5,252.0,0.4795,0.35294117647058826,middle-center,714000,0.07441176470588236,Medium (5-15%)
00003437.jpg,236,354,103,63,141,131,False,38,68,2584,0.6666666666666666,38,68,2584,0.5588235294117647,Small,122.0,97.0,0.5169491525423728,0.2740112994350282,top-center,83544,0.030929809441731303,Small (1-5%)
00003351.jpg,236,354,94,86,132,156,False,38,70,2660,0.6666666666666666,38,70,2660,0.5428571428571428,Small,113.0,121.0,0.4788135593220339,0.3418079096045198,middle-center,83544,0.03183950971942928,Small (1-5%)
00000894.jpg,1428,2000,315,82,1165,1438,False,850,1356,1152600,0.714,850,1356,1152600,0.6268436578171092,Very Large,740.0,760.0,0.5182072829131653,0.38,middle-center,2856000,0.4035714285714286,Very Large (>30%)
00001552.jpg,683,1024,380,449,454,579,False,74,130,9620,0.6669921875,74,130,9620,0.5692307692307692,Medium,417.0,514.0,0.6105417276720352,0.501953125,middle-center,699392,0.013754804172767204,Small (1-5%)
00001234.jpg,800,582,256,124,518,341,False,262,217,56854,1.3745704467353952,262,217,56854,1.207373271889401,Very Large,387.0,232.5,0.48375,0.39948453608247425,middle-center,465600,0.12210910652920962,Medium (5-15%)
00002932.jpg,2000,1334,673,79,1081,403,False,408,324,132192,1.4992503748125936,408,324,132192,1.2592592592592593,Very Large,877.0,241.0,0.4385,0.18065967016491755,top-center,2668000,0.04954722638680659,Small (1-5%)
00002932.jpg,2000,1334,674,553,1074,863,False,400,310,124000,1.4992503748125936,400,310,124000,1.2903225806451613,Very Large,874.0,708.0,0.437,0.5307346326836582,middle-center,2668000,0.046476761619190406,Small (1-5%)
00000843.jpg,700,1055,482,84,560,220,False,78,136,10608,0.6635071090047393,78,136,10608,0.5735294117647058,Medium,521.0,152.0,0.7442857142857143,0.14407582938388624,top-right,738500,0.014364251861882194,Small (1-5%)
00001585.jpg,407,612,67,54,257,379,False,190,325,61750,0.6650326797385621,190,325,61750,0.5846153846153846,Very Large,162.0,216.5,0.39803439803439805,0.35375816993464054,middle-center,249084,0.24790833614363025,Large (15-30%)
00002098.jpg,281,519,109,4,167,131,False,58,127,7366,0.5414258188824663,58,127,7366,0.4566929133858268,Medium,138.0,67.5,0.49110320284697506,0.13005780346820808,top-center,145839,0.05050775169879113,Medium (5-15%)
00000857.jpg,1000,667,359,29,732,319,False,373,290,108170,1.4992503748125936,373,290,108170,1.2862068965517242,Very Large,545.5,174.0,0.5455,0.2608695652173913,top-center,667000,0.16217391304347825,Large (15-30%)
00001591.jpg,390,280,129,22,236,112,False,107,90,9630,1.3928571428571428,107,90,9630,1.1888888888888889,Medium,182.5,67.0,0.46794871794871795,0.2392857142857143,top-center,109200,0.08818681318681319,Medium (5-15%)
00002926.jpg,650,895,568,168,635,272,False,67,104,6968,0.7262569832402235,67,104,6968,0.6442307692307693,Medium,601.5,220.0,0.9253846153846154,0.24581005586592178,top-right,581750,0.011977653631284916,Small (1-5%)
00001368.jpg,1500,1120,687,99,956,333,False,269,234,62946,1.3392857142857142,269,234,62946,1.1495726495726495,Very Large,821.5,216.0,0.5476666666666666,0.19285714285714287,top-center,1680000,0.03746785714285714,Small (1-5%)
00003219.jpg,866,1390,302,281,657,943,False,355,662,235010,0.6230215827338129,355,662,235010,0.5362537764350453,Very Large,479.5,612.0,0.5536951501154734,0.44028776978417267,middle-center,1203740,0.19523318989150482,Large (15-30%)
00002113.jpg,800,533,108,37,500,341,False,392,304,119168,1.5009380863039399,392,304,119168,1.2894736842105263,Very Large,304.0,189.0,0.38,0.3545966228893058,middle-center,426400,0.2794746716697936,Large (15-30%)
00000704.jpg,612,387,114,87,276,203,False,162,116,18792,1.5813953488372092,162,116,18792,1.396551724137931,Medium,195.0,145.0,0.31862745098039214,0.37467700258397935,middle-left,236844,0.07934336525307797,Medium (5-15%)
00000704.jpg,612,387,278,110,507,278,False,229,168,38472,1.5813953488372092,229,168,38472,1.3630952380952381,Large,392.5,194.0,0.6413398692810458,0.5012919896640827,middle-center,236844,0.16243603384506258,Large (15-30%)
00000704.jpg,612,387,339,47,449,126,False,110,79,8690,1.5813953488372092,110,79,8690,1.3924050632911393,Medium,394.0,86.5,0.6437908496732027,0.2235142118863049,top-center,236844,0.036690817584570434,Small (1-5%)
00000704.jpg,612,387,113,42,206,110,False,93,68,6324,1.5813953488372092,93,68,6324,1.3676470588235294,Medium,159.5,76.0,0.26062091503267976,0.19638242894056848,top-left,236844,0.026701119724375538,Small (1-5%)
00000704.jpg,612,387,265,38,364,111,False,99,73,7227,1.5813953488372092,99,73,7227,1.356164383561644,Medium,314.5,74.5,0.5138888888888888,0.1925064599483204,top-center,236844,0.03051375588995288,Small (1-5%)
00002675.jpg,505,340,127,56,363,240,False,236,184,43424,1.4852941176470589,236,184,43424,1.2826086956521738,Large,245.0,148.0,0.48514851485148514,0.43529411764705883,middle-center,171700,0.25290623179965055,Large (15-30%)
00001354.jpg,2000,1333,871,102,1388,503,False,517,401,207317,1.5003750937734435,517,401,207317,1.2892768079800498,Very Large,1129.5,302.5,0.56475,0.22693173293323332,top-center,2666000,0.07776331582895724,Medium (5-15%)
00002885.jpg,504,370,307,167,369,219,False,62,52,3224,1.3621621621621622,62,52,3224,1.1923076923076923,Small,338.0,193.0,0.6706349206349206,0.5216216216216216,middle-right,186480,0.017288717288717288,Small (1-5%)
00002885.jpg,504,370,180,72,253,132,False,73,60,4380,1.3621621621621622,73,60,4380,1.2166666666666666,Small,216.5,102.0,0.42956349206349204,0.2756756756756757,top-center,186480,0.023487773487773488,Small (1-5%)
00002885.jpg,504,370,234,177,294,227,False,60,50,3000,1.3621621621621622,60,50,3000,1.2,Small,264.0,202.0,0.5238095238095238,0.5459459459459459,middle-center,186480,0.016087516087516088,Small (1-5%)
00002885.jpg,504,370,189,207,245,255,False,56,48,2688,1.3621621621621622,56,48,2688,1.1666666666666667,Small,217.0,231.0,0.4305555555555556,0.6243243243243243,middle-center,186480,0.014414414414414415,Small (1-5%)
00002885.jpg,504,370,267,95,330,149,False,63,54,3402,1.3621621621621622,63,54,3402,1.1666666666666667,Small,298.5,122.0,0.5922619047619048,0.32972972972972975,top-center,186480,0.018243243243243244,Small (1-5%)
00002885.jpg,504,370,141,161,205,215,False,64,54,3456,1.3621621621621622,64,54,3456,1.1851851851851851,Small,173.0,188.0,0.34325396825396826,0.5081081081081081,middle-center,186480,0.018532818532818532,Small (1-5%)
00003225.jpg,389,280,149,98,191,132,False,42,34,1428,1.3892857142857142,42,34,1428,1.2352941176470589,Small,170.0,115.0,0.4370179948586118,0.4107142857142857,middle-center,108920,0.013110539845758355,Small (1-5%)
00003225.jpg,389,280,251,112,291,146,False,40,34,1360,1.3892857142857142,40,34,1360,1.1764705882352942,Small,271.0,129.0,0.6966580976863753,0.4607142857142857,middle-right,108920,0.012486228424531766,Small (1-5%)
00001432.jpg,800,530,337,86,644,327,False,307,241,73987,1.509433962264151,307,241,73987,1.2738589211618256,Very Large,490.5,206.5,0.613125,0.389622641509434,middle-center,424000,0.17449764150943398,Large (15-30%)
00001426.jpg,500,750,197,243,289,403,False,92,160,14720,0.6666666666666666,92,160,14720,0.575,Medium,243.0,323.0,0.486,0.43066666666666664,middle-center,375000,0.039253333333333335,Small (1-5%)
00000738.jpg,750,500,447,67,576,167,False,129,100,12900,1.5,129,100,12900,1.29,Medium,511.5,117.0,0.682,0.234,top-right,375000,0.0344,Small (1-5%)
00000738.jpg,750,500,95,23,224,123,False,129,100,12900,1.5,129,100,12900,1.29,Medium,159.5,73.0,0.21266666666666667,0.146,top-left,375000,0.0344,Small (1-5%)
00000738.jpg,750,500,1,56,127,186,False,126,130,16380,1.5,126,130,16380,0.9692307692307692,Medium,64.0,121.0,0.08533333333333333,0.242,top-left,375000,0.04368,Small (1-5%)
00000738.jpg,750,500,305,111,418,199,False,113,88,9944,1.5,113,88,9944,1.2840909090909092,Medium,361.5,155.0,0.482,0.31,top-center,375000,0.026517333333333334,Small (1-5%)
00003231.jpg,1200,1200,429,357,554,500,False,125,143,17875,1.0,125,143,17875,0.8741258741258742,Medium,491.5,428.5,0.40958333333333335,0.3570833333333333,middle-center,1440000,0.012413194444444444,Small (1-5%)
00002891.jpg,390,280,162,48,263,132,False,101,84,8484,1.3928571428571428,101,84,8484,1.2023809523809523,Medium,212.5,90.0,0.5448717948717948,0.32142857142857145,top-center,109200,0.07769230769230769,Medium (5-15%)
00001340.jpg,3840,5760,1042,1127,2035,2860,False,993,1733,1720869,0.6666666666666666,993,1733,1720869,0.5729948066935949,Very Large,1538.5,1993.5,0.40065104166666665,0.34609375,middle-center,22118400,0.07780259874131945,Medium (5-15%)
00002846.jpg,236,354,77,47,129,136,False,52,89,4628,0.6666666666666666,52,89,4628,0.5842696629213483,Small,103.0,91.5,0.4364406779661017,0.2584745762711864,top-center,83544,0.055395959015608544,Medium (5-15%)
00001397.jpg,462,280,199,31,380,156,False,181,125,22625,1.65,181,125,22625,1.448,Large,289.5,93.5,0.6266233766233766,0.3339285714285714,middle-center,129360,0.1748995052566481,Large (15-30%)
00000089.jpg,1000,1500,374,295,550,602,False,176,307,54032,0.6666666666666666,176,307,54032,0.5732899022801303,Very Large,462.0,448.5,0.462,0.299,top-center,1500000,0.036021333333333336,Small (1-5%)
00000923.jpg,2888,2007,1346,169,1623,393,False,277,224,62048,1.4389636273044344,277,224,62048,1.2366071428571428,Very Large,1484.5,281.0,0.5140235457063712,0.14000996512207275,top-center,5796216,0.010704915068727597,Small (1-5%)
00001383.jpg,1000,1500,312,49,778,863,False,466,814,379324,0.6666666666666666,466,814,379324,0.5724815724815725,Very Large,545.0,456.0,0.545,0.304,top-center,1500000,0.25288266666666664,Large (15-30%)
00002852.jpg,800,531,178,108,578,417,False,400,309,123600,1.5065913370998116,400,309,123600,1.2944983818770226,Very Large,378.0,262.5,0.4725,0.4943502824858757,middle-center,424800,0.2909604519774011,Large (15-30%)
00002305.jpg,640,960,216,234,347,462,False,131,228,29868,0.6666666666666666,131,228,29868,0.5745614035087719,Large,281.5,348.0,0.43984375,0.3625,middle-center,614400,0.04861328125,Small (1-5%)
00002477.jpg,1000,1268,639,33,819,298,False,180,265,47700,0.7886435331230284,180,265,47700,0.6792452830188679,Large,729.0,165.5,0.729,0.1305205047318612,top-right,1268000,0.037618296529968454,Small (1-5%)
00002477.jpg,1000,1268,218,303,418,598,False,200,295,59000,0.7886435331230284,200,295,59000,0.6779661016949152,Very Large,318.0,450.5,0.318,0.3552839116719243,middle-left,1268000,0.04652996845425868,Small (1-5%)
00000506.jpg,1024,683,211,221,373,346,False,162,125,20250,1.499267935578331,162,125,20250,1.296,Large,292.0,283.5,0.28515625,0.4150805270863836,middle-left,699392,0.028953719802342605,Small (1-5%)
00000506.jpg,1024,683,661,153,819,276,False,158,123,19434,1.499267935578331,158,123,19434,1.2845528455284554,Medium,740.0,214.5,0.72265625,0.3140556368960469,top-right,699392,0.027786992130307466,Small (1-5%)
00000506.jpg,1024,683,479,189,717,374,False,238,185,44030,1.499267935578331,238,185,44030,1.2864864864864864,Large,598.0,281.5,0.583984375,0.41215226939970717,middle-center,699392,0.06295468063689605,Medium (5-15%)
00002311.jpg,559,800,181,183,364,482,False,183,299,54717,0.69875,183,299,54717,0.6120401337792643,Very Large,272.5,332.5,0.4874776386404293,0.415625,middle-center,447200,0.12235465116279069,Medium (5-15%)
00001630.jpg,1600,1132,41,8,1321,995,False,1280,987,1263360,1.4134275618374559,1280,987,1263360,1.2968591691995948,Very Large,681.0,501.5,0.425625,0.44302120141342755,middle-center,1811200,0.6975265017667844,Very Large (>30%)
00002339.jpg,450,300,114,8,359,194,False,245,186,45570,1.5,245,186,45570,1.3172043010752688,Large,236.5,101.0,0.5255555555555556,0.33666666666666667,middle-center,135000,0.33755555555555555,Very Large (>30%)
00003027.jpg,1470,980,954,335,1125,465,False,171,130,22230,1.5,171,130,22230,1.3153846153846154,Large,1039.5,400.0,0.7071428571428572,0.40816326530612246,middle-right,1440600,0.015431070387338609,Small (1-5%)
00001156.jpg,450,347,205,56,369,207,False,164,151,24764,1.2968299711815563,164,151,24764,1.086092715231788,Large,287.0,131.5,0.6377777777777778,0.37896253602305474,middle-center,156150,0.15859109830291387,Large (15-30%)
00003033.jpg,1024,688,246,265,547,506,False,301,241,72541,1.4883720930232558,301,241,72541,1.2489626556016598,Very Large,396.5,385.5,0.38720703125,0.5603197674418605,middle-center,704512,0.10296630859375,Medium (5-15%)
00003033.jpg,1024,688,467,176,775,416,False,308,240,73920,1.4883720930232558,308,240,73920,1.2833333333333334,Very Large,621.0,296.0,0.6064453125,0.43023255813953487,middle-center,704512,0.10492369186046512,Medium (5-15%)
00001624.jpg,1300,1390,505,135,904,632,False,399,497,198303,0.935251798561151,399,497,198303,0.8028169014084507,Very Large,704.5,383.5,0.541923076923077,0.2758992805755396,top-center,1807000,0.1097415605976757,Medium (5-15%)
00001817.jpg,626,417,143,23,387,216,False,244,193,47092,1.501199040767386,244,193,47092,1.2642487046632125,Large,265.0,119.5,0.4233226837060703,0.2865707434052758,top-center,261042,0.18040008887458722,Large (15-30%)
00001803.jpg,600,420,102,40,467,337,False,365,297,108405,1.4285714285714286,365,297,108405,1.228956228956229,Very Large,284.5,188.5,0.4741666666666667,0.4488095238095238,middle-center,252000,0.4301785714285714,Very Large (>30%)
00001195.jpg,1300,866,215,70,566,342,False,351,272,95472,1.5011547344110854,351,272,95472,1.2904411764705883,Very Large,390.5,206.0,0.30038461538461536,0.23787528868360278,top-left,1125800,0.08480369515011547,Medium (5-15%)
00001180.jpg,417,626,46,47,255,412,False,209,365,76285,0.6661341853035144,209,365,76285,0.5726027397260274,Very Large,150.5,229.5,0.3609112709832134,0.36661341853035145,middle-center,261042,0.2922326675400893,Large (15-30%)
00002489.jpg,400,267,95,23,208,111,False,113,88,9944,1.4981273408239701,113,88,9944,1.2840909090909092,Medium,151.5,67.0,0.37875,0.250936329588015,top-center,106800,0.09310861423220974,Medium (5-15%)
00001802.jpg,678,1024,252,148,376,362,False,124,214,26536,0.662109375,124,214,26536,0.5794392523364486,Large,314.0,255.0,0.4631268436578171,0.2490234375,top-center,694272,0.038221331120943954,Small (1-5%)
00001631.jpg,236,327,97,114,134,173,False,37,59,2183,0.7217125382262997,37,59,2183,0.6271186440677966,Small,115.5,143.5,0.4894067796610169,0.43883792048929665,middle-center,77172,0.028287461773700305,Small (1-5%)
00000249.jpg,600,420,369,52,468,130,False,99,78,7722,1.4285714285714286,99,78,7722,1.2692307692307692,Medium,418.5,91.0,0.6975,0.21666666666666667,top-right,252000,0.030642857142857142,Small (1-5%)
00002310.jpg,866,1300,400,257,593,595,False,193,338,65234,0.6661538461538462,193,338,65234,0.5710059171597633,Very Large,496.5,426.0,0.5733256351039261,0.32769230769230767,top-center,1125800,0.0579445727482679,Medium (5-15%)
00000507.jpg,2000,1333,1246,52,1702,405,False,456,353,160968,1.5003750937734435,456,353,160968,1.291784702549575,Very Large,1474.0,228.5,0.737,0.1714178544636159,top-right,2666000,0.06037809452363091,Medium (5-15%)
00000507.jpg,2000,1333,660,415,1200,834,False,540,419,226260,1.5003750937734435,540,419,226260,1.2887828162291168,Very Large,930.0,624.5,0.465,0.4684921230307577,middle-center,2666000,0.08486871717929483,Medium (5-15%)
00000507.jpg,2000,1333,945,327,1431,696,False,486,369,179334,1.5003750937734435,486,369,179334,1.3170731707317074,Very Large,1188.0,511.5,0.594,0.38372093023255816,middle-center,2666000,0.06726706676669167,Medium (5-15%)
00000507.jpg,2000,1333,1,134,473,632,False,472,498,235056,1.5003750937734435,472,498,235056,0.9477911646586346,Very Large,237.0,383.0,0.1185,0.2873218304576144,top-left,2666000,0.08816804201050263,Medium (5-15%)
00000507.jpg,2000,1333,814,373,1309,765,False,495,392,194040,1.5003750937734435,495,392,194040,1.2627551020408163,Very Large,1061.5,569.0,0.53075,0.42685671417854465,middle-center,2666000,0.07278319579894973,Medium (5-15%)
00002462.jpg,385,280,187,35,298,129,False,111,94,10434,1.375,111,94,10434,1.1808510638297873,Medium,242.5,82.0,0.6298701298701299,0.29285714285714287,top-center,107800,0.09679035250463822,Medium (5-15%)
00000275.jpg,600,600,229,70,342,199,False,113,129,14577,1.0,113,129,14577,0.875968992248062,Medium,285.5,134.5,0.47583333333333333,0.22416666666666665,top-center,360000,0.04049166666666667,Small (1-5%)
00002853.jpg,1030,693,318,170,443,268,False,125,98,12250,1.4862914862914862,125,98,12250,1.2755102040816326,Medium,380.5,219.0,0.36941747572815536,0.31601731601731603,top-center,713790,0.01716191036579386,Small (1-5%)
00002853.jpg,1030,693,438,176,569,278,False,131,102,13362,1.4862914862914862,131,102,13362,1.2843137254901962,Medium,503.5,227.0,0.4888349514563107,0.32756132756132755,top-center,713790,0.018719791535325516,Small (1-5%)
00002853.jpg,1030,693,600,185,733,290,False,133,105,13965,1.4862914862914862,133,105,13965,1.2666666666666666,Medium,666.5,237.5,0.6470873786407767,0.3427128427128427,middle-center,713790,0.019564577817005,Small (1-5%)
00001382.jpg,1066,1689,413,95,589,419,False,176,324,57024,0.6311426879810539,176,324,57024,0.5432098765432098,Very Large,501.0,257.0,0.4699812382739212,0.1521610420367081,top-center,1800474,0.03167165979625365,Small (1-5%)
00000088.jpg,3456,5184,1372,715,2048,1871,False,676,1156,781456,0.6666666666666666,676,1156,781456,0.5847750865051903,Very Large,1710.0,1293.0,0.4947916666666667,0.2494212962962963,top-center,17915904,0.04361800554412437,Small (1-5%)
00001396.jpg,612,494,314,52,587,315,False,273,263,71799,1.2388663967611335,273,263,71799,1.038022813688213,Very Large,450.5,183.5,0.7361111111111112,0.3714574898785425,middle-right,302328,0.23748710010319918,Large (15-30%)
00002847.jpg,350,350,113,76,225,204,False,112,128,14336,1.0,112,128,14336,0.875,Medium,169.0,140.0,0.4828571428571429,0.4,middle-center,122500,0.11702857142857143,Medium (5-15%)
00000936.jpg,1000,667,397,59,718,308,False,321,249,79929,1.4992503748125936,321,249,79929,1.2891566265060241,Very Large,557.5,183.5,0.5575,0.27511244377811095,top-center,667000,0.11983358320839581,Medium (5-15%)
00003230.jpg,2000,1331,1039,271,1466,601,False,427,330,140910,1.5026296018031555,427,330,140910,1.293939393939394,Very Large,1252.5,436.0,0.62625,0.3275732531930879,top-center,2662000,0.05293388429752066,Medium (5-15%)
00001427.jpg,390,280,136,25,237,109,False,101,84,8484,1.3928571428571428,101,84,8484,1.2023809523809523,Medium,186.5,67.0,0.4782051282051282,0.2392857142857143,top-center,109200,0.07769230769230769,Medium (5-15%)
00001341.jpg,1600,1157,627,129,868,332,False,241,203,48923,1.382886776145203,241,203,48923,1.187192118226601,Large,747.5,230.5,0.4671875,0.19922212618841834,top-center,1851200,0.026427722558340534,Small (1-5%)
00002890.jpg,735,1104,260,209,467,571,False,207,362,74934,0.6657608695652174,207,362,74934,0.5718232044198895,Very Large,363.5,390.0,0.49455782312925173,0.3532608695652174,middle-center,811440,0.0923469387755102,Medium (5-15%)
00002884.jpg,1500,1253,785,253,1085,545,False,300,292,87600,1.1971268954509178,300,292,87600,1.0273972602739727,Very Large,935.0,399.0,0.6233333333333333,0.31843575418994413,top-center,1879500,0.04660814046288907,Small (1-5%)
00002884.jpg,1500,1253,1049,274,1362,578,False,313,304,95152,1.1971268954509178,313,304,95152,1.0296052631578947,Very Large,1205.5,426.0,0.8036666666666666,0.3399840383080607,middle-right,1879500,0.05062623038042032,Medium (5-15%)
00002884.jpg,1500,1253,290,132,590,423,False,300,291,87300,1.1971268954509178,300,291,87300,1.0309278350515463,Very Large,440.0,277.5,0.29333333333333333,0.2214684756584198,top-left,1879500,0.04644852354349561,Small (1-5%)
00002884.jpg,1500,1253,467,231,748,511,False,281,280,78680,1.1971268954509178,281,280,78680,1.0035714285714286,Very Large,607.5,371.0,0.405,0.29608938547486036,top-center,1879500,0.04186219739292365,Small (1-5%)
00001355.jpg,1600,1167,335,1,1148,671,False,813,670,544710,1.3710368466152527,813,670,544710,1.2134328358208955,Very Large,741.5,336.0,0.4634375,0.2879177377892031,top-center,1867200,0.29172557840616964,Large (15-30%)
00001433.jpg,866,1300,341,111,510,407,False,169,296,50024,0.6661538461538462,169,296,50024,0.5709459459459459,Very Large,425.5,259.0,0.4913394919168591,0.19923076923076924,top-center,1125800,0.044434180138568126,Small (1-5%)
00003224.jpg,612,408,94,162,345,356,False,251,194,48694,1.5,251,194,48694,1.2938144329896908,Large,219.5,259.0,0.35866013071895425,0.6348039215686274,middle-center,249696,0.19501313597334358,Large (15-30%)
00003224.jpg,612,408,224,173,515,394,False,291,221,64311,1.5,291,221,64311,1.3167420814479638,Very Large,369.5,283.5,0.6037581699346405,0.6948529411764706,bottom-center,249696,0.25755718954248363,Large (15-30%)
00000705.jpg,2048,1365,788,242,1207,566,False,419,324,135756,1.5003663003663004,419,324,135756,1.2932098765432098,Very Large,997.5,404.0,0.487060546875,0.295970695970696,top-center,2795520,0.04856198489010989,Small (1-5%)
00000705.jpg,2048,1365,1292,527,1547,724,False,255,197,50235,1.5003663003663004,255,197,50235,1.2944162436548223,Very Large,1419.5,625.5,0.693115234375,0.4582417582417582,middle-right,2795520,0.017969823145604396,Small (1-5%)
00002674.jpg,612,405,42,112,210,242,False,168,130,21840,1.511111111111111,168,130,21840,1.2923076923076924,Large,126.0,177.0,0.20588235294117646,0.43703703703703706,middle-left,247860,0.08811425804889857,Medium (5-15%)
00002674.jpg,612,405,328,133,490,258,False,162,125,20250,1.511111111111111,162,125,20250,1.296,Large,409.0,195.5,0.6683006535947712,0.48271604938271606,middle-center,247860,0.08169934640522876,Medium (5-15%)
00002674.jpg,612,405,195,101,350,218,False,155,117,18135,1.511111111111111,155,117,18135,1.3247863247863247,Medium,272.5,159.5,0.4452614379084967,0.39382716049382716,middle-center,247860,0.07316630355846042,Medium (5-15%)
00001369.jpg,434,650,141,208,244,388,False,103,180,18540,0.6676923076923077,103,180,18540,0.5722222222222222,Medium,192.5,298.0,0.4435483870967742,0.4584615384615385,middle-center,282100,0.06572137539879476,Medium (5-15%)
00000077.jpg,667,1000,262,162,332,281,False,70,119,8330,0.667,70,119,8330,0.5882352941176471,Medium,297.0,221.5,0.4452773613193403,0.2215,top-center,667000,0.012488755622188905,Small (1-5%)
00002660.jpg,626,417,194,57,359,185,False,165,128,21120,1.501199040767386,165,128,21120,1.2890625,Large,276.5,121.0,0.4416932907348243,0.290167865707434,top-center,261042,0.08090652078975798,Medium (5-15%)
00002106.jpg,600,420,233,11,356,111,False,123,100,12300,1.4285714285714286,123,100,12300,1.23,Medium,294.5,61.0,0.49083333333333334,0.14523809523809525,top-center,252000,0.04880952380952381,Small (1-5%)
00003218.jpg,500,334,272,101,352,163,False,80,62,4960,1.4970059880239521,80,62,4960,1.2903225806451613,Small,312.0,132.0,0.624,0.39520958083832336,middle-center,167000,0.02970059880239521,Small (1-5%)
00000711.jpg,480,320,58,111,165,194,False,107,83,8881,1.5,107,83,8881,1.2891566265060241,Medium,111.5,152.5,0.23229166666666667,0.4765625,middle-left,153600,0.057819010416666664,Medium (5-15%)
00000711.jpg,480,320,258,91,358,169,False,100,78,7800,1.5,100,78,7800,1.2820512820512822,Medium,308.0,130.0,0.6416666666666667,0.40625,middle-center,153600,0.05078125,Medium (5-15%)
00000711.jpg,480,320,139,138,235,211,False,96,73,7008,1.5,96,73,7008,1.3150684931506849,Medium,187.0,174.5,0.38958333333333334,0.5453125,middle-center,153600,0.045625,Small (1-5%)
00001590.jpg,1200,1800,130,474,569,1240,False,439,766,336274,0.6666666666666666,439,766,336274,0.5731070496083551,Very Large,349.5,857.0,0.29125,0.4761111111111111,middle-left,2160000,0.1556824074074074,Large (15-30%)
00001590.jpg,1200,1800,725,476,1193,1348,False,468,872,408096,0.6666666666666666,468,872,408096,0.536697247706422,Very Large,959.0,912.0,0.7991666666666667,0.5066666666666667,middle-right,2160000,0.18893333333333334,Large (15-30%)
00000856.jpg,683,1023,257,193,324,307,False,67,114,7638,0.667644183773216,67,114,7638,0.5877192982456141,Medium,290.5,250.0,0.4253294289897511,0.24437927663734116,top-center,698709,0.01093158954586244,Small (1-5%)
00002099.jpg,1024,886,513,76,689,249,False,176,173,30448,1.1557562076749435,176,173,30448,1.0173410404624277,Large,601.0,162.5,0.5869140625,0.18340857787810383,top-center,907264,0.03356024266365688,Small (1-5%)
00002099.jpg,1024,886,617,135,793,312,False,176,177,31152,1.1557562076749435,176,177,31152,0.9943502824858758,Large,705.0,223.5,0.6884765625,0.25225733634311515,top-right,907264,0.03433620203160271,Small (1-5%)
00003393.jpg,800,800,250,103,376,250,False,126,147,18522,1.0,126,147,18522,0.8571428571428571,Medium,313.0,176.5,0.39125,0.220625,top-center,640000,0.028940625,Small (1-5%)
00001584.jpg,319,450,164,91,221,185,False,57,94,5358,0.7088888888888889,57,94,5358,0.6063829787234043,Medium,192.5,138.0,0.603448275862069,0.30666666666666664,top-center,143550,0.03732497387669802,Small (1-5%)
00000842.jpg,750,1124,250,186,330,326,False,80,140,11200,0.6672597864768683,80,140,11200,0.5714285714285714,Medium,290.0,256.0,0.38666666666666666,0.2277580071174377,top-center,843000,0.0132858837485172,Small (1-5%)
00000842.jpg,750,1124,397,251,466,371,False,69,120,8280,0.6672597864768683,69,120,8280,0.575,Medium,431.5,311.0,0.5753333333333334,0.27669039145907476,top-center,843000,0.009822064056939502,Tiny (<1%)
00003344.jpg,1182,1208,506,495,647,662,False,141,167,23547,0.9784768211920529,141,167,23547,0.844311377245509,Large,576.5,578.5,0.4877326565143824,0.4788907284768212,middle-center,1427856,0.016491158772313174,Small (1-5%)
00003344.jpg,1182,1208,845,456,971,606,False,126,150,18900,0.9784768211920529,126,150,18900,0.84,Medium,908.0,531.0,0.7681895093062606,0.43956953642384106,middle-right,1427856,0.013236628903755,Small (1-5%)
00003344.jpg,1182,1208,339,535,477,698,False,138,163,22494,0.9784768211920529,138,163,22494,0.8466257668711656,Large,408.0,616.5,0.34517766497461927,0.5103476821192053,middle-center,1427856,0.015753689447675395,Small (1-5%)
00003344.jpg,1182,1208,197,477,323,627,False,126,150,18900,0.9784768211920529,126,150,18900,0.84,Medium,260.0,552.0,0.21996615905245348,0.45695364238410596,middle-left,1427856,0.013236628903755,Small (1-5%)
00003344.jpg,1182,1208,783,626,901,767,False,118,141,16638,0.9784768211920529,118,141,16638,0.8368794326241135,Medium,842.0,696.5,0.7123519458544839,0.5765728476821192,middle-right,1427856,0.01165243553971829,Small (1-5%)
00003344.jpg,1182,1208,694,504,803,630,False,109,126,13734,0.9784768211920529,109,126,13734,0.8650793650793651,Medium,748.5,567.0,0.633248730964467,0.4693708609271523,middle-center,1427856,0.0096186170033953,Tiny (<1%)
00000895.jpg,512,704,59,68,370,566,False,311,498,154878,0.7272727272727273,311,498,154878,0.6244979919678715,Very Large,214.5,317.0,0.4189453125,0.4502840909090909,middle-center,360448,0.4296819513494318,Very Large (>30%)
00001235.jpg,600,419,187,1,593,250,False,406,249,101094,1.431980906921241,406,249,101094,1.6305220883534137,Very Large,390.0,125.5,0.65,0.29952267303102625,top-center,251400,0.4021241050119332,Very Large (>30%)
00002728.jpg,866,1390,274,62,599,657,False,325,595,193375,0.6230215827338129,325,595,193375,0.5462184873949579,Very Large,436.5,359.5,0.504041570438799,0.2586330935251799,top-center,1203740,0.1606451559306827,Large (15-30%)
00003436.jpg,612,408,249,95,394,208,False,145,113,16385,1.5,145,113,16385,1.2831858407079646,Medium,321.5,151.5,0.5253267973856209,0.3713235294117647,middle-center,249696,0.06561979366910163,Medium (5-15%)
00001221.jpg,867,1000,381,90,544,308,False,163,218,35534,0.867,163,218,35534,0.7477064220183486,Large,462.5,199.0,0.5334486735870819,0.199,top-center,867000,0.04098500576701269,Small (1-5%)
00001547.jpg,1300,956,606,77,942,364,False,336,287,96432,1.3598326359832635,336,287,96432,1.170731707317073,Very Large,774.0,220.5,0.5953846153846154,0.23064853556485357,top-center,1242800,0.07759253299002253,Medium (5-15%)
00000881.jpg,1500,1000,558,97,1000,440,False,442,343,151606,1.5,442,343,151606,1.2886297376093294,Very Large,779.0,268.5,0.5193333333333333,0.2685,top-center,1500000,0.10107066666666667,Medium (5-15%)
00003378.jpg,600,400,267,122,358,191,False,91,69,6279,1.5,91,69,6279,1.318840579710145,Medium,312.5,156.5,0.5208333333333334,0.39125,middle-center,240000,0.0261625,Small (1-5%)
00003378.jpg,600,400,171,78,274,158,False,103,80,8240,1.5,103,80,8240,1.2875,Medium,222.5,118.0,0.37083333333333335,0.295,top-center,240000,0.034333333333333334,Small (1-5%)
00003378.jpg,600,400,336,76,439,155,False,103,79,8137,1.5,103,79,8137,1.3037974683544304,Medium,387.5,115.5,0.6458333333333334,0.28875,top-center,240000,0.033904166666666666,Small (1-5%)
00003378.jpg,600,400,90,119,177,184,False,87,65,5655,1.5,87,65,5655,1.3384615384615384,Medium,133.5,151.5,0.2225,0.37875,middle-left,240000,0.0235625,Small (1-5%)
00003378.jpg,600,400,183,162,258,220,False,75,58,4350,1.5,75,58,4350,1.293103448275862,Small,220.5,191.0,0.3675,0.4775,middle-center,240000,0.018125,Small (1-5%)
00003378.jpg,600,400,394,130,475,194,False,81,64,5184,1.5,81,64,5184,1.265625,Medium,434.5,162.0,0.7241666666666666,0.405,middle-right,240000,0.0216,Small (1-5%)
00002066.jpg,1500,1120,509,16,897,353,False,388,337,130756,1.3392857142857142,388,337,130756,1.1513353115727003,Very Large,703.0,184.5,0.4686666666666667,0.16473214285714285,top-center,1680000,0.07783095238095238,Medium (5-15%)
00001209.jpg,800,582,266,71,548,309,False,282,238,67116,1.3745704467353952,282,238,67116,1.184873949579832,Very Large,407.0,190.0,0.50875,0.32646048109965636,top-center,465600,0.14414948453608248,Medium (5-15%)
00000103.jpg,1264,1500,576,418,957,943,False,381,525,200025,0.8426666666666667,381,525,200025,0.7257142857142858,Very Large,766.5,680.5,0.6064082278481012,0.45366666666666666,middle-center,1896000,0.10549841772151898,Medium (5-15%)
00002714.jpg,390,280,97,26,292,189,False,195,163,31785,1.3928571428571428,195,163,31785,1.196319018404908,Large,194.5,107.5,0.4987179487179487,0.38392857142857145,middle-center,109200,0.2910714285714286,Large (15-30%)
00000665.jpg,2940,1960,1184,459,2191,1241,False,1007,782,787474,1.5,1007,782,787474,1.2877237851662404,Very Large,1687.5,850.0,0.5739795918367347,0.4336734693877551,middle-center,5762400,0.13665729557128975,Medium (5-15%)
00000665.jpg,2940,1960,674,583,1539,1254,False,865,671,580415,1.5,865,671,580415,1.2891207153502235,Very Large,1106.5,918.5,0.37636054421768705,0.4686224489795918,middle-center,5762400,0.10072452450367902,Medium (5-15%)
00003185.jpg,640,457,371,53,617,257,False,246,204,50184,1.400437636761488,246,204,50184,1.2058823529411764,Very Large,494.0,155.0,0.771875,0.33916849015317285,middle-right,292480,0.1715809628008753,Large (15-30%)
00003185.jpg,640,457,186,1,464,232,False,278,231,64218,1.400437636761488,278,231,64218,1.2034632034632036,Very Large,325.0,116.5,0.5078125,0.2549234135667396,top-center,292480,0.21956373085339168,Large (15-30%)
00001792.jpg,1335,2000,622,184,767,437,False,145,253,36685,0.6675,145,253,36685,0.5731225296442688,Large,694.5,310.5,0.5202247191011236,0.15525,top-center,2670000,0.013739700374531835,Small (1-5%)
00001786.jpg,1300,956,316,170,823,614,False,507,444,225108,1.3598326359832635,507,444,225108,1.1418918918918919,Very Large,569.5,392.0,0.4380769230769231,0.4100418410041841,middle-center,1242800,0.18112970711297072,Large (15-30%)
00003191.jpg,500,333,174,69,331,191,False,157,122,19154,1.5015015015015014,157,122,19154,1.2868852459016393,Medium,252.5,130.0,0.505,0.39039039039039036,middle-center,166500,0.11503903903903905,Medium (5-15%)
00001976.jpg,350,263,58,40,141,113,False,83,73,6059,1.3307984790874525,83,73,6059,1.1369863013698631,Medium,99.5,76.5,0.2842857142857143,0.2908745247148289,top-left,92050,0.06582292232482347,Medium (5-15%)
00001962.jpg,632,420,190,11,406,179,False,216,168,36288,1.5047619047619047,216,168,36288,1.2857142857142858,Large,298.0,95.0,0.47151898734177217,0.2261904761904762,top-center,265440,0.13670886075949368,Medium (5-15%)
00001989.jpg,1000,710,411,1,725,244,False,314,243,76302,1.408450704225352,314,243,76302,1.2921810699588476,Very Large,568.0,122.5,0.568,0.17253521126760563,top-center,710000,0.10746760563380282,Medium (5-15%)
00001751.jpg,1136,1300,504,185,768,537,False,264,352,92928,0.8738461538461538,264,352,92928,0.75,Very Large,636.0,361.0,0.5598591549295775,0.2776923076923077,top-center,1476800,0.0629252437703142,Medium (5-15%)
00002258.jpg,910,607,6,1,910,594,False,904,593,536072,1.4991762767710048,904,593,536072,1.5244519392917368,Very Large,458.0,297.5,0.5032967032967033,0.4901153212520593,middle-center,552370,0.9704944149754693,Very Large (>30%)
00003146.jpg,626,418,495,124,600,206,False,105,82,8610,1.4976076555023923,105,82,8610,1.2804878048780488,Medium,547.5,165.0,0.8746006389776357,0.39473684210526316,middle-right,261668,0.032904290933549386,Small (1-5%)
00003146.jpg,626,418,271,83,378,166,False,107,83,8881,1.4976076555023923,107,83,8881,1.2891566265060241,Medium,324.5,124.5,0.518370607028754,0.29784688995215314,top-center,261668,0.03393995444609199,Small (1-5%)
00003146.jpg,626,418,143,150,253,235,False,110,85,9350,1.4976076555023923,110,85,9350,1.2941176470588236,Medium,198.0,192.5,0.31629392971246006,0.4605263157894737,middle-left,261668,0.03573230200100891,Small (1-5%)
00003146.jpg,626,418,348,167,458,252,False,110,85,9350,1.4976076555023923,110,85,9350,1.2941176470588236,Medium,403.0,209.5,0.6437699680511182,0.5011961722488039,middle-center,261668,0.03573230200100891,Small (1-5%)
00003146.jpg,626,418,37,149,140,229,False,103,80,8240,1.4976076555023923,103,80,8240,1.2875,Medium,88.5,189.0,0.1413738019169329,0.45215311004784686,middle-left,261668,0.03149028539981962,Small (1-5%)
00003152.jpg,800,533,382,60,633,254,False,251,194,48694,1.5009380863039399,251,194,48694,1.2938144329896908,Large,507.5,157.0,0.634375,0.2945590994371482,top-center,426400,0.11419793621013133,Medium (5-15%)
00003152.jpg,800,533,199,112,415,280,False,216,168,36288,1.5009380863039399,216,168,36288,1.2857142857142858,Large,307.0,196.0,0.38375,0.3677298311444653,middle-center,426400,0.0851031894934334,Medium (5-15%)
00001745.jpg,1300,866,514,110,905,413,False,391,303,118473,1.5011547344110854,391,303,118473,1.2904290429042904,Very Large,709.5,261.5,0.5457692307692308,0.30196304849884525,top-center,1125800,0.10523449991117427,Medium (5-15%)
00001023.jpg,364,500,146,44,216,155,False,70,111,7770,0.728,70,111,7770,0.6306306306306306,Medium,181.0,99.5,0.49725274725274726,0.199,top-center,182000,0.04269230769230769,Small (1-5%)
00000315.jpg,335,254,83,31,195,130,False,112,99,11088,1.3188976377952757,112,99,11088,1.1313131313131313,Medium,139.0,80.5,0.41492537313432837,0.3169291338582677,top-center,85090,0.13030908449876602,Medium (5-15%)
00002264.jpg,718,1024,205,105,492,582,False,287,477,136899,0.701171875,287,477,136899,0.6016771488469602,Very Large,348.5,343.5,0.4853760445682451,0.33544921875,middle-center,735232,0.18619837003830084,Large (15-30%)
00001779.jpg,667,1000,282,158,391,346,False,109,188,20492,0.667,109,188,20492,0.5797872340425532,Large,336.5,252.0,0.5044977511244377,0.252,top-center,667000,0.03072263868065967,Small (1-5%)
00002516.jpg,2946,1960,874,264,1687,893,False,813,629,511377,1.5030612244897958,813,629,511377,1.2925278219395866,Very Large,1280.5,578.5,0.4346571622539036,0.2951530612244898,top-center,5774160,0.0885630117627499,Medium (5-15%)
00000301.jpg,867,1300,437,392,599,670,False,162,278,45036,0.666923076923077,162,278,45036,0.5827338129496403,Large,518.0,531.0,0.5974625144175317,0.4084615384615385,middle-center,1127100,0.03995741282938515,Small (1-5%)
00001006.jpg,450,321,11,14,297,257,False,286,243,69498,1.4018691588785046,286,243,69498,1.176954732510288,Very Large,154.0,135.5,0.3422222222222222,0.4221183800623053,middle-center,144450,0.4811214953271028,Very Large (>30%)
00003177.jpg,150,150,48,1,98,48,False,50,47,2350,1.0,50,47,2350,1.0638297872340425,Small,73.0,24.5,0.4866666666666667,0.16333333333333333,top-center,22500,0.10444444444444445,Medium (5-15%)
00002269.jpg,1280,720,515,19,1276,625,False,761,606,461166,1.7777777777777777,761,606,461166,1.2557755775577557,Very Large,895.5,322.0,0.699609375,0.44722222222222224,middle-right,921600,0.5003971354166666,Very Large (>30%)
00001760.jpg,1024,684,178,37,857,553,False,679,516,350364,1.4970760233918128,679,516,350364,1.315891472868217,Very Large,517.5,295.0,0.50537109375,0.43128654970760233,middle-center,700416,0.5002227247807017,Very Large (>30%)
00003163.jpg,682,1023,415,360,532,565,False,117,205,23985,0.6666666666666666,117,205,23985,0.5707317073170731,Large,473.5,462.5,0.6942815249266863,0.4521016617790811,middle-right,697686,0.03437792932637318,Small (1-5%)
00001012.jpg,1000,1500,431,435,627,784,False,196,349,68404,0.6666666666666666,196,349,68404,0.5616045845272206,Very Large,529.0,609.5,0.529,0.4063333333333333,middle-center,1500000,0.045602666666666666,Small (1-5%)
00000442.jpg,768,1151,278,239,457,551,False,179,312,55848,0.6672458731537794,179,312,55848,0.5737179487179487,Very Large,367.5,395.0,0.478515625,0.34317984361424847,middle-center,883968,0.06317875760208515,Medium (5-15%)
00001984.jpg,509,339,240,54,453,222,False,213,168,35784,1.5014749262536873,213,168,35784,1.2678571428571428,Large,346.5,138.0,0.6807465618860511,0.40707964601769914,middle-right,172551,0.20738216527287584,Large (15-30%)
00001990.jpg,350,525,115,1,185,120,False,70,119,8330,0.6666666666666666,70,119,8330,0.5882352941176471,Medium,150.0,60.5,0.42857142857142855,0.11523809523809524,top-center,183750,0.04533333333333334,Small (1-5%)
00002296.jpg,1000,667,449,39,877,378,False,428,339,145092,1.4992503748125936,428,339,145092,1.2625368731563422,Very Large,663.0,208.5,0.663,0.31259370314842577,top-center,667000,0.21752923538230884,Large (15-30%)
00003188.jpg,1000,1000,227,225,410,443,False,183,218,39894,1.0,183,218,39894,0.8394495412844036,Large,318.5,334.0,0.3185,0.334,middle-left,1000000,0.039894,Small (1-5%)
00002282.jpg,800,600,85,67,301,255,False,216,188,40608,1.3333333333333333,216,188,40608,1.148936170212766,Large,193.0,161.0,0.24125,0.2683333333333333,top-left,480000,0.0846,Medium (5-15%)
00002282.jpg,800,600,580,77,734,211,False,154,134,20636,1.3333333333333333,154,134,20636,1.1492537313432836,Large,657.0,144.0,0.82125,0.24,top-right,480000,0.042991666666666664,Small (1-5%)
00002282.jpg,800,600,460,239,560,325,False,100,86,8600,1.3333333333333333,100,86,8600,1.1627906976744187,Medium,510.0,282.0,0.6375,0.47,middle-center,480000,0.017916666666666668,Small (1-5%)
00001562.jpg,735,946,415,51,499,174,False,84,123,10332,0.7769556025369979,84,123,10332,0.6829268292682927,Medium,457.0,112.5,0.6217687074829932,0.11892177589852009,top-center,695310,0.014859559045605557,Small (1-5%)
00001562.jpg,735,946,299,25,392,161,False,93,136,12648,0.7769556025369979,93,136,12648,0.6838235294117647,Medium,345.5,93.0,0.47006802721088436,0.09830866807610994,top-center,695310,0.018190447426327826,Small (1-5%)
00003413.jpg,626,445,126,126,241,221,False,115,95,10925,1.4067415730337078,115,95,10925,1.2105263157894737,Medium,183.5,173.5,0.29313099041533547,0.3898876404494382,middle-left,278570,0.03921814983666583,Small (1-5%)
00003413.jpg,626,445,254,133,361,222,False,107,89,9523,1.4067415730337078,107,89,9523,1.202247191011236,Medium,307.5,177.5,0.49121405750798725,0.398876404494382,middle-center,278570,0.034185303514377,Small (1-5%)
00003413.jpg,626,445,196,57,306,148,False,110,91,10010,1.4067415730337078,110,91,10010,1.2087912087912087,Medium,251.0,102.5,0.4009584664536741,0.2303370786516854,top-center,278570,0.03593351760778261,Small (1-5%)
00003413.jpg,626,445,315,72,432,169,False,117,97,11349,1.4067415730337078,117,97,11349,1.2061855670103092,Medium,373.5,120.5,0.5966453674121406,0.27078651685393257,top-center,278570,0.04074020892414833,Small (1-5%)
00003413.jpg,626,445,460,159,574,254,False,114,95,10830,1.4067415730337078,114,95,10830,1.2,Medium,517.0,206.5,0.8258785942492013,0.4640449438202247,middle-right,278570,0.03887712244678178,Small (1-5%)
00001204.jpg,1000,667,370,2,752,285,False,382,283,108106,1.4992503748125936,382,283,108106,1.3498233215547704,Very Large,561.0,143.5,0.561,0.2151424287856072,top-center,667000,0.16207796101949026,Large (15-30%)
00001210.jpg,450,300,174,9,277,89,False,103,80,8240,1.5,103,80,8240,1.2875,Medium,225.5,49.0,0.5011111111111111,0.16333333333333333,top-center,135000,0.061037037037037035,Medium (5-15%)
00003407.jpg,612,459,384,158,453,219,False,69,61,4209,1.3333333333333333,69,61,4209,1.1311475409836065,Small,418.5,188.5,0.6838235294117647,0.4106753812636166,middle-right,280908,0.014983553334187705,Small (1-5%)
00003407.jpg,612,459,280,164,351,226,False,71,62,4402,1.3333333333333333,71,62,4402,1.1451612903225807,Small,315.5,195.0,0.5155228758169934,0.42483660130718953,middle-center,280908,0.015670611018554118,Small (1-5%)
00003407.jpg,612,459,108,158,175,215,False,67,57,3819,1.3333333333333333,67,57,3819,1.1754385964912282,Small,141.5,186.5,0.2312091503267974,0.40631808278867104,middle-left,280908,0.01359519842795506,Small (1-5%)
00003361.jpg,1024,683,241,378,464,551,False,223,173,38579,1.499267935578331,223,173,38579,1.2890173410404624,Large,352.5,464.5,0.34423828125,0.6800878477306003,bottom-center,699392,0.05516076821010249,Medium (5-15%)
00003361.jpg,1024,683,639,115,839,268,False,200,153,30600,1.499267935578331,200,153,30600,1.3071895424836601,Large,739.0,191.5,0.7216796875,0.28038067349926793,top-right,699392,0.04375228770131771,Small (1-5%)
00003361.jpg,1024,683,779,158,975,310,False,196,152,29792,1.499267935578331,196,152,29792,1.2894736842105263,Large,877.0,234.0,0.8564453125,0.34260614934114203,middle-right,699392,0.04259699853587116,Small (1-5%)
00003361.jpg,1024,683,474,333,684,495,False,210,162,34020,1.499267935578331,210,162,34020,1.2962962962962963,Large,579.0,414.0,0.5654296875,0.6061493411420205,middle-center,699392,0.048642249267935575,Small (1-5%)
00003361.jpg,1024,683,476,145,660,284,False,184,139,25576,1.499267935578331,184,139,25576,1.3237410071942446,Large,568.0,214.5,0.5546875,0.3140556368960469,top-center,699392,0.03656890556368961,Small (1-5%)
00003361.jpg,1024,683,211,207,407,360,False,196,153,29988,1.499267935578331,196,153,29988,1.2810457516339868,Large,309.0,283.5,0.3017578125,0.4150805270863836,middle-left,699392,0.04287724194729136,Small (1-5%)
00003361.jpg,1024,683,305,160,497,309,False,192,149,28608,1.499267935578331,192,149,28608,1.2885906040268456,Large,401.0,234.5,0.3916015625,0.34333821376281115,middle-center,699392,0.040904099560761346,Small (1-5%)
00003361.jpg,1024,683,826,312,1022,493,False,196,181,35476,1.499267935578331,196,181,35476,1.0828729281767955,Large,924.0,402.5,0.90234375,0.5893118594436311,middle-right,699392,0.050724057467057104,Medium (5-15%)
00003361.jpg,1024,683,1,348,192,514,False,191,166,31706,1.499267935578331,191,166,31706,1.1506024096385543,Large,96.5,431.0,0.09423828125,0.6310395314787701,middle-left,699392,0.04533366123718887,Small (1-5%)
00001576.jpg,1500,1138,674,111,1288,653,False,614,542,332788,1.3181019332161688,614,542,332788,1.132841328413284,Very Large,981.0,382.0,0.654,0.335676625659051,middle-center,1707000,0.19495489162272994,Large (15-30%)
00002057.jpg,683,1024,387,97,513,311,False,126,214,26964,0.6669921875,126,214,26964,0.5887850467289719,Large,450.0,204.0,0.6588579795021962,0.19921875,top-center,699392,0.0385534864568082,Small (1-5%)
00000640.jpg,1500,1101,154,254,550,599,False,396,345,136620,1.3623978201634876,396,345,136620,1.1478260869565218,Very Large,352.0,426.5,0.23466666666666666,0.3873751135331517,middle-left,1651500,0.08272479564032698,Medium (5-15%)
00000640.jpg,1500,1101,517,290,968,667,False,451,377,170027,1.3623978201634876,451,377,170027,1.1962864721485411,Very Large,742.5,478.5,0.495,0.43460490463215257,middle-center,1651500,0.10295307296397214,Medium (5-15%)
00000640.jpg,1500,1101,1035,295,1423,619,False,388,324,125712,1.3623978201634876,388,324,125712,1.1975308641975309,Very Large,1229.0,457.0,0.8193333333333334,0.4150772025431426,middle-right,1651500,0.07611989100817439,Medium (5-15%)
00000640.jpg,1500,1101,789,73,1168,398,False,379,325,123175,1.3623978201634876,379,325,123175,1.166153846153846,Very Large,978.5,235.5,0.6523333333333333,0.21389645776566757,top-center,1651500,0.07458371177717227,Medium (5-15%)
00000640.jpg,1500,1101,372,68,768,406,False,396,338,133848,1.3623978201634876,396,338,133848,1.1715976331360947,Very Large,570.0,237.0,0.38,0.21525885558583105,top-center,1651500,0.08104632152588556,Medium (5-15%)
00000898.jpg,675,900,265,56,403,275,False,138,219,30222,0.75,138,219,30222,0.6301369863013698,Large,334.0,165.5,0.4948148148148148,0.18388888888888888,top-center,607500,0.049748148148148146,Small (1-5%)
00001238.jpg,1024,683,33,22,492,379,False,459,357,163863,1.499267935578331,459,357,163863,1.2857142857142858,Very Large,262.5,200.5,0.25634765625,0.2935578330893119,top-left,699392,0.23429350064055637,Large (15-30%)
00002725.jpg,640,960,222,156,411,478,False,189,322,60858,0.6666666666666666,189,322,60858,0.5869565217391305,Very Large,316.5,317.0,0.49453125,0.3302083333333333,middle-center,614400,0.099052734375,Medium (5-15%)
00002043.jpg,626,417,195,37,332,142,False,137,105,14385,1.501199040767386,137,105,14385,1.3047619047619048,Medium,263.5,89.5,0.420926517571885,0.2146282973621103,top-center,261042,0.055106074884501345,Medium (5-15%)
00002916.jpg,866,1390,434,308,539,509,False,105,201,21105,0.6230215827338129,105,201,21105,0.5223880597014925,Large,486.5,408.5,0.5617782909930716,0.29388489208633095,top-center,1203740,0.017532855932344195,Small (1-5%)
00002916.jpg,866,1390,288,238,396,435,False,108,197,21276,0.6230215827338129,108,197,21276,0.5482233502538071,Large,342.0,336.5,0.394919168591224,0.2420863309352518,top-center,1203740,0.017674913187233122,Small (1-5%)
00002902.jpg,1080,1080,268,96,870,796,False,602,700,421400,1.0,602,700,421400,0.86,Very Large,569.0,446.0,0.5268518518518519,0.412962962962963,middle-center,1166400,0.36128257887517146,Very Large (>30%)
00002094.jpg,662,1000,284,66,463,380,False,179,314,56206,0.662,179,314,56206,0.5700636942675159,Very Large,373.5,223.0,0.5641993957703928,0.223,top-center,662000,0.08490332326283988,Medium (5-15%)
00002080.jpg,682,1023,46,1,638,409,False,592,408,241536,0.6666666666666666,592,408,241536,1.4509803921568627,Very Large,342.0,205.0,0.501466275659824,0.20039100684261973,top-center,697686,0.3461958531488377,Very Large (>30%)
00001589.jpg,867,1300,408,196,509,372,False,101,176,17776,0.666923076923077,101,176,17776,0.5738636363636364,Medium,458.5,284.0,0.5288350634371396,0.21846153846153846,top-center,1127100,0.015771448851033626,Small (1-5%)
00000697.jpg,1500,1000,656,44,1118,402,False,462,358,165396,1.5,462,358,165396,1.2905027932960893,Very Large,887.0,223.0,0.5913333333333334,0.223,top-center,1500000,0.110264,Medium (5-15%)
00000697.jpg,1500,1000,145,234,559,555,False,414,321,132894,1.5,414,321,132894,1.2897196261682242,Very Large,352.0,394.5,0.23466666666666666,0.3945,middle-left,1500000,0.088596,Medium (5-15%)
00000697.jpg,1500,1000,950,1,1475,346,False,525,345,181125,1.5,525,345,181125,1.5217391304347827,Very Large,1212.5,173.5,0.8083333333333333,0.1735,top-right,1500000,0.12075,Medium (5-15%)
00000697.jpg,1500,1000,348,210,735,511,False,387,301,116487,1.5,387,301,116487,1.2857142857142858,Very Large,541.5,360.5,0.361,0.3605,middle-center,1500000,0.077658,Medium (5-15%)
00001416.jpg,333,519,86,26,156,152,False,70,126,8820,0.6416184971098265,70,126,8820,0.5555555555555556,Medium,121.0,89.0,0.3633633633633634,0.17148362235067438,top-center,172827,0.05103369265218976,Medium (5-15%)
00002679.jpg,866,1390,321,61,644,665,False,323,604,195092,0.6230215827338129,323,604,195092,0.5347682119205298,Very Large,482.5,363.0,0.5571593533487298,0.26115107913669067,top-center,1203740,0.16207154368883647,Large (15-30%)
00001370.jpg,333,519,151,17,226,151,False,75,134,10050,0.6416184971098265,75,134,10050,0.5597014925373134,Medium,188.5,84.0,0.566066066066066,0.16184971098265896,top-center,172827,0.058150636185318266,Medium (5-15%)
00001364.jpg,1000,678,384,169,593,334,False,209,165,34485,1.4749262536873156,209,165,34485,1.2666666666666666,Large,488.5,251.5,0.4885,0.37094395280235987,middle-center,678000,0.05086283185840708,Medium (5-15%)
00001402.jpg,2940,1960,1012,103,1319,336,False,307,233,71531,1.5,307,233,71531,1.3175965665236051,Very Large,1165.5,219.5,0.3964285714285714,0.11198979591836734,top-center,5762400,0.01241340413716507,Small (1-5%)
00001402.jpg,2940,1960,1546,184,1828,402,False,282,218,61476,1.5,282,218,61476,1.2935779816513762,Very Large,1687.0,293.0,0.5738095238095238,0.14948979591836734,top-center,5762400,0.010668471470220741,Small (1-5%)
00002123.jpg,682,1024,167,86,573,780,False,406,694,281764,0.666015625,406,694,281764,0.5850144092219021,Very Large,370.0,433.0,0.5425219941348973,0.4228515625,middle-center,698368,0.4034606396627566,Very Large (>30%)
00000734.jpg,1900,1068,376,63,773,317,False,397,254,100838,1.7790262172284643,397,254,100838,1.562992125984252,Very Large,574.5,190.0,0.30236842105263156,0.17790262172284643,top-left,2029200,0.04969347526118668,Small (1-5%)
00000734.jpg,1900,1068,1341,212,1729,466,False,388,254,98552,1.7790262172284643,388,254,98552,1.5275590551181102,Very Large,1535.0,339.0,0.8078947368421052,0.31741573033707865,top-right,2029200,0.04856692292529075,Small (1-5%)
00000734.jpg,1900,1068,601,156,989,410,False,388,254,98552,1.7790262172284643,388,254,98552,1.5275590551181102,Very Large,795.0,283.0,0.41842105263157897,0.2649812734082397,top-center,2029200,0.04856692292529075,Small (1-5%)
00002645.jpg,325,280,38,69,102,133,False,64,64,4096,1.1607142857142858,64,64,4096,1.0,Small,70.0,101.0,0.2153846153846154,0.3607142857142857,middle-left,91000,0.04501098901098901,Small (1-5%)
00002645.jpg,325,280,173,70,235,132,False,62,62,3844,1.1607142857142858,62,62,3844,1.0,Small,204.0,101.0,0.6276923076923077,0.3607142857142857,middle-center,91000,0.04224175824175824,Small (1-5%)
00002651.jpg,750,500,287,198,447,320,False,160,122,19520,1.5,160,122,19520,1.3114754098360655,Medium,367.0,259.0,0.48933333333333334,0.518,middle-center,375000,0.05205333333333333,Medium (5-15%)
00002651.jpg,750,500,187,169,370,311,False,183,142,25986,1.5,183,142,25986,1.2887323943661972,Large,278.5,240.0,0.37133333333333335,0.48,middle-center,375000,0.069296,Medium (5-15%)
00002889.jpg,1024,683,86,1,811,499,False,725,498,361050,1.499267935578331,725,498,361050,1.4558232931726907,Very Large,448.5,250.0,0.43798828125,0.36603221083455345,middle-center,699392,0.5162341004758418,Very Large (>30%)
00001358.jpg,1300,956,406,84,861,473,False,455,389,176995,1.3598326359832635,455,389,176995,1.1696658097686374,Very Large,633.5,278.5,0.48730769230769233,0.29131799163179917,top-center,1242800,0.1424163179916318,Medium (5-15%)
00002137.jpg,407,612,122,66,247,280,False,125,214,26750,0.6650326797385621,125,214,26750,0.5841121495327103,Large,184.5,173.0,0.4533169533169533,0.2826797385620915,top-center,249084,0.10739348974643093,Medium (5-15%)
00000913.jpg,1500,1353,590,53,807,281,False,217,228,49476,1.1086474501108647,217,228,49476,0.9517543859649122,Large,698.5,167.0,0.4656666666666667,0.12342941611234294,top-center,2029500,0.02437841832963784,Small (1-5%)
00002876.jpg,700,467,309,163,440,265,False,131,102,13362,1.4989293361884368,131,102,13362,1.2843137254901962,Medium,374.5,214.0,0.535,0.4582441113490364,middle-center,326900,0.040874885286020186,Small (1-5%)
00002876.jpg,700,467,352,39,449,114,False,97,75,7275,1.4989293361884368,97,75,7275,1.2933333333333332,Medium,400.5,76.5,0.5721428571428572,0.16381156316916487,top-center,326900,0.022254512083205873,Small (1-5%)
00000091.jpg,400,600,98,79,347,505,False,249,426,106074,0.6666666666666666,249,426,106074,0.5845070422535211,Very Large,222.5,292.0,0.55625,0.4866666666666667,middle-center,240000,0.441975,Very Large (>30%)
00000085.jpg,467,700,147,83,276,308,False,129,225,29025,0.6671428571428571,129,225,29025,0.5733333333333334,Large,211.5,195.5,0.45289079229122053,0.2792857142857143,top-center,326900,0.08878862037320281,Medium (5-15%)
00002692.jpg,970,646,446,104,911,464,False,465,360,167400,1.501547987616099,465,360,167400,1.2916666666666667,Very Large,678.5,284.0,0.6994845360824742,0.43962848297213625,middle-right,626620,0.26714755354122116,Large (15-30%)
00002692.jpg,970,646,69,64,575,448,False,506,384,194304,1.501547987616099,506,384,194304,1.3177083333333333,Very Large,322.0,256.0,0.3319587628865979,0.39628482972136225,middle-center,626620,0.31008266573042675,Very Large (>30%)
00003003.jpg,2000,1333,995,289,1912,1000,False,917,711,651987,1.5003750937734435,917,711,651987,1.289732770745429,Very Large,1453.5,644.5,0.72675,0.48349587396849214,middle-right,2666000,0.2445562640660165,Large (15-30%)
00003003.jpg,2000,1333,544,210,1345,832,False,801,622,498222,1.5003750937734435,801,622,498222,1.287781350482315,Very Large,944.5,521.0,0.47225,0.390847711927982,middle-center,2666000,0.18687996999249812,Large (15-30%)
00003003.jpg,2000,1333,89,197,1001,904,False,912,707,644784,1.5003750937734435,912,707,644784,1.2899575671852899,Very Large,545.0,550.5,0.2725,0.4129782445611403,middle-left,2666000,0.241854463615904,Large (15-30%)
00001600.jpg,1333,2000,322,42,1097,1396,False,775,1354,1049350,0.6665,775,1354,1049350,0.5723781388478582,Very Large,709.5,719.0,0.532258064516129,0.3595,middle-center,2666000,0.3936046511627907,Very Large (>30%)
00003017.jpg,1300,806,440,113,917,458,False,477,345,164565,1.6129032258064515,477,345,164565,1.382608695652174,Very Large,678.5,285.5,0.5219230769230769,0.3542183622828784,middle-center,1047800,0.15705764458866195,Large (15-30%)
00000536.jpg,1232,821,105,288,501,595,False,396,307,121572,1.5006090133982948,396,307,121572,1.289902280130293,Very Large,303.0,441.5,0.24594155844155843,0.5377588306942753,middle-left,1011472,0.12019314424917348,Medium (5-15%)
00000536.jpg,1232,821,366,221,770,541,False,404,320,129280,1.5006090133982948,404,320,129280,1.2625,Very Large,568.0,381.0,0.461038961038961,0.464068209500609,middle-center,1011472,0.12781372099277094,Medium (5-15%)
00000536.jpg,1232,821,538,160,962,488,False,424,328,139072,1.5006090133982948,424,328,139072,1.2926829268292683,Very Large,750.0,324.0,0.6087662337662337,0.3946406820950061,middle-center,1011472,0.13749466124618379,Medium (5-15%)
00001628.jpg,2000,1333,884,121,1390,514,False,506,393,198858,1.5003750937734435,506,393,198858,1.2875318066157762,Very Large,1137.0,317.5,0.5685,0.23818454613653414,top-center,2666000,0.07459039759939985,Medium (5-15%)
00000522.jpg,612,408,58,106,250,255,False,192,149,28608,1.5,192,149,28608,1.2885906040268456,Large,154.0,180.5,0.25163398692810457,0.4424019607843137,middle-left,249696,0.11457131872356786,Medium (5-15%)
00000522.jpg,612,408,25,32,133,115,False,108,83,8964,1.5,108,83,8964,1.3012048192771084,Medium,79.0,73.5,0.12908496732026145,0.1801470588235294,top-left,249696,0.035899653979238756,Small (1-5%)
00000522.jpg,612,408,305,109,420,196,False,115,87,10005,1.5,115,87,10005,1.3218390804597702,Medium,362.5,152.5,0.5923202614379085,0.3737745098039216,middle-center,249696,0.04006872356785852,Small (1-5%)
00000522.jpg,612,408,236,143,394,266,False,158,123,19434,1.5,158,123,19434,1.2845528455284554,Medium,315.0,204.5,0.5147058823529411,0.5012254901960784,middle-center,249696,0.07783064206074587,Medium (5-15%)
00000522.jpg,612,408,365,22,475,107,False,110,85,9350,1.5,110,85,9350,1.2941176470588236,Medium,420.0,64.5,0.6862745098039216,0.15808823529411764,top-right,249696,0.037445533769063184,Small (1-5%)
00000522.jpg,612,408,423,84,575,201,False,152,117,17784,1.5,152,117,17784,1.2991452991452992,Medium,499.0,142.5,0.815359477124183,0.3492647058823529,middle-right,249696,0.07122260668973472,Medium (5-15%)
00002484.jpg,1600,900,514,229,894,473,False,380,244,92720,1.7777777777777777,380,244,92720,1.5573770491803278,Very Large,704.0,351.0,0.44,0.39,middle-center,1440000,0.06438888888888888,Medium (5-15%)
00001833.jpg,1300,957,406,97,1012,616,False,606,519,314514,1.3584117032392895,606,519,314514,1.1676300578034682,Very Large,709.0,356.5,0.5453846153846154,0.3725182863113898,middle-center,1244100,0.252804436942368,Large (15-30%)
00001827.jpg,1500,1120,604,70,924,355,False,320,285,91200,1.3392857142857142,320,285,91200,1.1228070175438596,Very Large,764.0,212.5,0.5093333333333333,0.18973214285714285,top-center,1680000,0.054285714285714284,Medium (5-15%)
00002490.jpg,572,380,228,44,467,225,False,239,181,43259,1.5052631578947369,239,181,43259,1.3204419889502763,Large,347.5,134.5,0.6075174825174825,0.3539473684210526,middle-center,217360,0.19902005888847993,Large (15-30%)
00002490.jpg,572,380,111,66,340,243,False,229,177,40533,1.5052631578947369,229,177,40533,1.2937853107344632,Large,225.5,154.5,0.3942307692307692,0.40657894736842104,middle-center,217360,0.18647865292602134,Large (15-30%)
00001199.jpg,390,280,129,31,289,167,False,160,136,21760,1.3928571428571428,160,136,21760,1.1764705882352942,Large,209.0,99.0,0.5358974358974359,0.3535714285714286,middle-center,109200,0.19926739926739928,Large (15-30%)
00001826.jpg,1600,1167,622,42,942,313,False,320,271,86720,1.3710368466152527,320,271,86720,1.1808118081180812,Very Large,782.0,177.5,0.48875,0.1520994001713796,top-center,1867200,0.04644387317909169,Small (1-5%)
00001198.jpg,682,1024,307,63,388,205,False,81,142,11502,0.666015625,81,142,11502,0.5704225352112676,Medium,347.5,134.0,0.5095307917888563,0.130859375,top-center,698368,0.01646982679618768,Small (1-5%)
00002491.jpg,1200,940,558,83,832,327,False,274,244,66856,1.2765957446808511,274,244,66856,1.1229508196721312,Very Large,695.0,205.0,0.5791666666666667,0.21808510638297873,top-center,1128000,0.05926950354609929,Medium (5-15%)
00002491.jpg,1200,940,302,144,564,378,False,262,234,61308,1.2765957446808511,262,234,61308,1.1196581196581197,Very Large,433.0,261.0,0.36083333333333334,0.2776595744680851,top-center,1128000,0.05435106382978724,Medium (5-15%)
00002485.jpg,1072,1549,242,259,351,443,False,109,184,20056,0.6920593931568754,109,184,20056,0.592391304347826,Large,296.5,351.0,0.27658582089552236,0.22659780503550678,top-left,1660528,0.012078086006378694,Small (1-5%)
00002485.jpg,1072,1549,706,416,811,593,False,105,177,18585,0.6920593931568754,105,177,18585,0.5932203389830508,Medium,758.5,504.5,0.7075559701492538,0.32569399612653327,top-right,1660528,0.011192223196477264,Small (1-5%)
00002485.jpg,1072,1549,510,544,615,721,False,105,177,18585,0.6920593931568754,105,177,18585,0.5932203389830508,Medium,562.5,632.5,0.5247201492537313,0.40832795351839896,middle-center,1660528,0.011192223196477264,Small (1-5%)
00001832.jpg,1024,682,174,50,824,543,False,650,493,320450,1.501466275659824,650,493,320450,1.3184584178498986,Very Large,499.0,296.5,0.4873046875,0.4347507331378299,middle-center,698368,0.4588555031158358,Very Large (>30%)
00000523.jpg,1500,1004,826,377,1062,561,False,236,184,43424,1.4940239043824701,236,184,43424,1.2826086956521738,Large,944.0,469.0,0.6293333333333333,0.46713147410358563,middle-center,1506000,0.028833997343957505,Small (1-5%)
00000523.jpg,1500,1004,1061,385,1277,554,False,216,169,36504,1.4940239043824701,216,169,36504,1.2781065088757397,Large,1169.0,469.5,0.7793333333333333,0.4676294820717131,middle-right,1506000,0.024239043824701195,Small (1-5%)
00000523.jpg,1500,1004,457,273,631,412,False,174,139,24186,1.4940239043824701,174,139,24186,1.2517985611510791,Large,544.0,342.5,0.3626666666666667,0.34113545816733065,middle-center,1506000,0.016059760956175298,Small (1-5%)
00000523.jpg,1500,1004,94,327,335,511,False,241,184,44344,1.4940239043824701,241,184,44344,1.309782608695652,Large,214.5,419.0,0.143,0.41733067729083667,middle-left,1506000,0.02944488711819389,Small (1-5%)
00000523.jpg,1500,1004,387,554,628,743,False,241,189,45549,1.4940239043824701,241,189,45549,1.2751322751322751,Large,507.5,648.5,0.3383333333333333,0.6459163346613546,middle-center,1506000,0.030245019920318725,Small (1-5%)
00002334.jpg,736,1104,251,48,408,317,False,157,269,42233,0.6666666666666666,157,269,42233,0.5836431226765799,Large,329.5,182.5,0.4476902173913043,0.16530797101449277,top-center,812544,0.05197626220856963,Medium (5-15%)
00002452.jpg,660,373,91,92,511,368,False,420,276,115920,1.769436997319035,420,276,115920,1.5217391304347827,Very Large,301.0,230.0,0.45606060606060606,0.6166219839142091,middle-center,246180,0.470874969534487,Very Large (>30%)
00002446.jpg,900,602,499,80,611,167,False,112,87,9744,1.495016611295681,112,87,9744,1.2873563218390804,Medium,555.0,123.5,0.6166666666666667,0.20514950166112958,top-center,541800,0.017984496124031007,Small (1-5%)
00001629.jpg,450,319,188,46,269,112,False,81,66,5346,1.4106583072100314,81,66,5346,1.2272727272727273,Medium,228.5,79.0,0.5077777777777778,0.2476489028213166,top-center,143550,0.037241379310344824,Small (1-5%)
00003016.jpg,1960,1634,1007,326,1525,817,False,518,491,254338,1.1995104039167688,518,491,254338,1.054989816700611,Very Large,1266.0,571.5,0.6459183673469387,0.34975520195838433,middle-center,3202640,0.07941510753628257,Medium (5-15%)
00001601.jpg,800,534,504,107,638,212,False,134,105,14070,1.4981273408239701,134,105,14070,1.276190476190476,Medium,571.0,159.5,0.71375,0.29868913857677903,top-right,427200,0.03293539325842697,Small (1-5%)
00001167.jpg,626,417,277,56,458,196,False,181,140,25340,1.501199040767386,181,140,25340,1.292857142857143,Large,367.5,126.0,0.5870607028753994,0.302158273381295,top-center,261042,0.09707250174301453,Medium (5-15%)
00001615.jpg,2000,1331,772,95,1503,661,False,731,566,413746,1.5026296018031555,731,566,413746,1.2915194346289753,Very Large,1137.5,378.0,0.56875,0.28399699474079637,top-center,2662000,0.1554267468069121,Large (15-30%)
00003002.jpg,1300,957,455,471,751,724,False,296,253,74888,1.3584117032392895,296,253,74888,1.1699604743083003,Very Large,603.0,597.5,0.46384615384615385,0.6243469174503657,middle-center,1244100,0.060194518125552605,Medium (5-15%)
00003002.jpg,1300,957,189,142,491,401,False,302,259,78218,1.3584117032392895,302,259,78218,1.166023166023166,Very Large,340.0,271.5,0.26153846153846155,0.2836990595611285,top-left,1244100,0.06287115183666908,Medium (5-15%)
00003002.jpg,1300,957,703,342,1005,601,False,302,259,78218,1.3584117032392895,302,259,78218,1.166023166023166,Very Large,854.0,471.5,0.6569230769230769,0.49268547544409613,middle-center,1244100,0.06287115183666908,Medium (5-15%)
00003002.jpg,1300,957,253,557,549,806,False,296,249,73704,1.3584117032392895,296,249,73704,1.1887550200803212,Very Large,401.0,681.5,0.30846153846153845,0.7121212121212122,bottom-left,1244100,0.05924282613937786,Medium (5-15%)
00003002.jpg,1300,957,457,62,773,333,False,316,271,85636,1.3584117032392895,316,271,85636,1.1660516605166051,Very Large,615.0,197.5,0.47307692307692306,0.20637408568443052,top-center,1244100,0.06883369504059159,Medium (5-15%)
00002687.jpg,504,330,85,137,176,206,False,91,69,6279,1.5272727272727273,91,69,6279,1.318840579710145,Medium,130.5,171.5,0.25892857142857145,0.5196969696969697,middle-left,166320,0.03775252525252525,Small (1-5%)
00002687.jpg,504,330,246,144,331,209,False,85,65,5525,1.5272727272727273,85,65,5525,1.3076923076923077,Medium,288.5,176.5,0.5724206349206349,0.5348484848484848,middle-center,166320,0.03321909571909572,Small (1-5%)
00002687.jpg,504,330,183,69,261,128,False,78,59,4602,1.5272727272727273,78,59,4602,1.3220338983050848,Small,222.0,98.5,0.44047619047619047,0.29848484848484846,top-center,166320,0.02766955266955267,Small (1-5%)
00002687.jpg,504,330,333,147,417,211,False,84,64,5376,1.5272727272727273,84,64,5376,1.3125,Medium,375.0,179.0,0.7440476190476191,0.5424242424242425,middle-right,166320,0.03232323232323232,Small (1-5%)
00002687.jpg,504,330,288,77,369,139,False,81,62,5022,1.5272727272727273,81,62,5022,1.3064516129032258,Medium,328.5,108.0,0.6517857142857143,0.32727272727272727,top-center,166320,0.030194805194805194,Small (1-5%)
00002877.jpg,2500,3745,736,226,1215,1061,False,479,835,399965,0.6675567423230975,479,835,399965,0.5736526946107784,Very Large,975.5,643.5,0.3902,0.1718291054739653,top-center,9362500,0.042719893190921225,Small (1-5%)
00002877.jpg,2500,3745,1022,886,1490,1685,False,468,799,373932,0.6675567423230975,468,799,373932,0.5857321652065082,Very Large,1256.0,1285.5,0.5024,0.3432576769025367,middle-center,9362500,0.039939332443257675,Small (1-5%)
00002863.jpg,1200,1185,811,426,923,555,False,112,129,14448,1.0126582278481013,112,129,14448,0.8682170542635659,Medium,867.0,490.5,0.7225,0.4139240506329114,middle-right,1422000,0.010160337552742616,Small (1-5%)
00001359.jpg,626,417,141,105,293,223,False,152,118,17936,1.501199040767386,152,118,17936,1.2881355932203389,Medium,217.0,164.0,0.3466453674121406,0.3932853717026379,middle-center,261042,0.06870924985251416,Medium (5-15%)
00000047.jpg,1300,891,819,93,1057,283,False,238,190,45220,1.4590347923681257,238,190,45220,1.2526315789473683,Large,938.0,188.0,0.7215384615384616,0.21099887766554434,top-right,1158300,0.039039972373305705,Small (1-5%)
00000047.jpg,1300,891,641,279,845,443,False,204,164,33456,1.4590347923681257,204,164,33456,1.2439024390243902,Large,743.0,361.0,0.5715384615384616,0.4051627384960718,middle-center,1158300,0.028883708883708885,Small (1-5%)
00002650.jpg,1200,630,484,102,1031,436,False,547,334,182698,1.9047619047619047,547,334,182698,1.6377245508982037,Very Large,757.5,269.0,0.63125,0.42698412698412697,middle-center,756000,0.24166402116402116,Large (15-30%)
00002136.jpg,480,320,89,5,201,90,False,112,85,9520,1.5,112,85,9520,1.3176470588235294,Medium,145.0,47.5,0.3020833333333333,0.1484375,top-left,153600,0.06197916666666667,Medium (5-15%)
00002136.jpg,480,320,283,107,399,198,False,116,91,10556,1.5,116,91,10556,1.2747252747252746,Medium,341.0,152.5,0.7104166666666667,0.4765625,middle-right,153600,0.06872395833333333,Medium (5-15%)
00003228.jpg,960,640,1,1,960,633,False,959,632,606088,1.5,959,632,606088,1.5174050632911393,Very Large,480.5,317.0,0.5005208333333333,0.4953125,middle-center,614400,0.9864713541666666,Very Large (>30%)
00000735.jpg,1098,732,497,187,622,284,False,125,97,12125,1.5,125,97,12125,1.288659793814433,Medium,559.5,235.5,0.5095628415300546,0.32172131147540983,top-center,803736,0.015085799317188729,Small (1-5%)
00002122.jpg,1400,1130,434,257,636,447,False,202,190,38380,1.238938053097345,202,190,38380,1.063157894736842,Large,535.0,352.0,0.3821428571428571,0.31150442477876106,top-center,1582000,0.024260429835651076,Small (1-5%)
00002122.jpg,1400,1130,637,343,771,469,False,134,126,16884,1.238938053097345,134,126,16884,1.0634920634920635,Medium,704.0,406.0,0.5028571428571429,0.35929203539823007,middle-center,1582000,0.010672566371681416,Small (1-5%)
00001365.jpg,600,419,237,80,360,178,False,123,98,12054,1.431980906921241,123,98,12054,1.2551020408163265,Medium,298.5,129.0,0.4975,0.30787589498806683,top-center,251400,0.04794749403341289,Small (1-5%)
00001403.jpg,700,1050,263,189,419,461,False,156,272,42432,0.6666666666666666,156,272,42432,0.5735294117647058,Large,341.0,325.0,0.48714285714285716,0.30952380952380953,top-center,735000,0.05773061224489796,Medium (5-15%)
00003200.jpg,495,639,287,182,346,270,False,59,88,5192,0.7746478873239436,59,88,5192,0.6704545454545454,Medium,316.5,226.0,0.6393939393939394,0.3536776212832551,middle-center,316305,0.01641453660233003,Small (1-5%)
00001417.jpg,608,406,138,11,423,232,False,285,221,62985,1.4975369458128078,285,221,62985,1.2895927601809956,Very Large,280.5,121.5,0.4613486842105263,0.29926108374384236,top-center,246848,0.2551570197044335,Large (15-30%)
00001371.jpg,910,1213,154,70,715,941,False,561,871,488631,0.7502061005770816,561,871,488631,0.6440872560275546,Very Large,434.5,505.5,0.4774725274725275,0.4167353668590272,middle-center,1103830,0.4426687080438111,Very Large (>30%)
00002678.jpg,800,533,206,111,452,306,False,246,195,47970,1.5009380863039399,246,195,47970,1.2615384615384615,Large,329.0,208.5,0.41125,0.39118198874296434,middle-center,426400,0.1125,Medium (5-15%)
00002678.jpg,800,533,342,90,622,302,False,280,212,59360,1.5009380863039399,280,212,59360,1.320754716981132,Very Large,482.0,196.0,0.6025,0.3677298311444653,middle-center,426400,0.13921200750469043,Medium (5-15%)
00001588.jpg,509,339,196,2,423,182,False,227,180,40860,1.5014749262536873,227,180,40860,1.261111111111111,Large,309.5,92.0,0.6080550098231827,0.2713864306784661,top-center,172551,0.23679955491419927,Large (15-30%)
00002081.jpg,1500,2123,641,146,887,553,False,246,407,100122,0.706547338671691,246,407,100122,0.6044226044226044,Very Large,764.0,349.5,0.5093333333333333,0.164625529910504,top-center,3184500,0.03144041450777202,Small (1-5%)
00002095.jpg,1500,1120,491,42,1028,508,False,537,466,250242,1.3392857142857142,537,466,250242,1.1523605150214593,Very Large,759.5,275.0,0.5063333333333333,0.24553571428571427,top-center,1680000,0.14895357142857144,Medium (5-15%)
00000682.jpg,640,860,301,220,413,396,False,112,176,19712,0.7441860465116279,112,176,19712,0.6363636363636364,Medium,357.0,308.0,0.5578125,0.3581395348837209,middle-center,550400,0.035813953488372095,Small (1-5%)
00000682.jpg,640,860,477,387,587,559,False,110,172,18920,0.7441860465116279,110,172,18920,0.6395348837209303,Medium,532.0,473.0,0.83125,0.55,middle-right,550400,0.034375,Small (1-5%)
00000682.jpg,640,860,285,401,400,580,False,115,179,20585,0.7441860465116279,115,179,20585,0.6424581005586593,Large,342.5,490.5,0.53515625,0.5703488372093023,middle-center,550400,0.037400072674418604,Small (1-5%)
00000682.jpg,640,860,55,221,192,439,False,137,218,29866,0.7441860465116279,137,218,29866,0.6284403669724771,Large,123.5,330.0,0.19296875,0.38372093023255816,middle-left,550400,0.05426235465116279,Medium (5-15%)
00002903.jpg,3024,4032,1028,409,1504,1149,False,476,740,352240,0.75,476,740,352240,0.6432432432432432,Very Large,1266.0,779.0,0.41865079365079366,0.1932043650793651,top-center,12192768,0.028889256319811877,Small (1-5%)
00000872.jpg,390,280,153,22,246,100,False,93,78,7254,1.3928571428571428,93,78,7254,1.1923076923076923,Medium,199.5,61.0,0.5115384615384615,0.21785714285714286,top-center,109200,0.06642857142857143,Medium (5-15%)
00000866.jpg,2037,1274,819,4,2032,1199,False,1213,1195,1449535,1.598901098901099,1213,1195,1449535,1.0150627615062762,Very Large,1425.5,601.5,0.6998036327933235,0.4721350078492936,middle-right,2595138,0.558557964932886,Very Large (>30%)
00002042.jpg,1050,700,404,21,628,195,False,224,174,38976,1.5,224,174,38976,1.2873563218390804,Large,516.0,108.0,0.49142857142857144,0.15428571428571428,top-center,735000,0.05302857142857143,Medium (5-15%)
00000899.jpg,1000,667,185,61,641,423,False,456,362,165072,1.4992503748125936,456,362,165072,1.2596685082872927,Very Large,413.0,242.0,0.413,0.36281859070464767,middle-center,667000,0.24748425787106446,Large (15-30%)
00000641.jpg,1000,667,489,314,660,448,False,171,134,22914,1.4992503748125936,171,134,22914,1.2761194029850746,Large,574.5,381.0,0.5745,0.5712143928035982,middle-center,667000,0.03435382308845577,Small (1-5%)
00000641.jpg,1000,667,77,324,241,452,False,164,128,20992,1.4992503748125936,164,128,20992,1.28125,Large,159.0,388.0,0.159,0.5817091454272864,middle-left,667000,0.03147226386806597,Small (1-5%)
00000641.jpg,1000,667,329,272,501,406,False,172,134,23048,1.4992503748125936,172,134,23048,1.2835820895522387,Large,415.0,339.0,0.415,0.5082458770614693,middle-center,667000,0.03455472263868066,Small (1-5%)
00000641.jpg,1000,667,296,161,438,271,False,142,110,15620,1.4992503748125936,142,110,15620,1.290909090909091,Medium,367.0,216.0,0.367,0.3238380809595202,top-center,667000,0.023418290854572713,Small (1-5%)
00000641.jpg,1000,667,635,144,742,227,False,107,83,8881,1.4992503748125936,107,83,8881,1.2891566265060241,Medium,688.5,185.5,0.6885,0.27811094452773616,top-right,667000,0.013314842578710644,Small (1-5%)
00000641.jpg,1000,667,639,216,800,344,False,161,128,20608,1.4992503748125936,161,128,20608,1.2578125,Large,719.5,280.0,0.7195,0.4197901049475262,middle-right,667000,0.03089655172413793,Small (1-5%)
00000641.jpg,1000,667,225,229,346,324,False,121,95,11495,1.4992503748125936,121,95,11495,1.2736842105263158,Medium,285.5,276.5,0.2855,0.41454272863568215,middle-left,667000,0.017233883058470765,Small (1-5%)
00000641.jpg,1000,667,492,142,636,252,False,144,110,15840,1.4992503748125936,144,110,15840,1.309090909090909,Medium,564.0,197.0,0.564,0.29535232383808097,top-center,667000,0.023748125937031486,Small (1-5%)
00003348.jpg,612,408,363,176,535,309,False,172,133,22876,1.5,172,133,22876,1.2932330827067668,Large,449.0,242.5,0.7336601307189542,0.5943627450980392,middle-right,249696,0.0916154043316673,Medium (5-15%)
00003348.jpg,612,408,104,237,284,377,False,180,140,25200,1.5,180,140,25200,1.2857142857142858,Large,194.0,307.0,0.31699346405228757,0.7524509803921569,bottom-left,249696,0.10092272202998846,Medium (5-15%)
00003348.jpg,612,408,182,98,391,265,False,209,167,34903,1.5,209,167,34903,1.251497005988024,Large,286.5,181.5,0.4681372549019608,0.44485294117647056,middle-center,249696,0.13978197488145586,Medium (5-15%)
00002730.jpg,1024,681,567,137,795,313,False,228,176,40128,1.5036710719530102,228,176,40128,1.2954545454545454,Large,681.0,225.0,0.6650390625,0.3303964757709251,middle-center,697344,0.057544052863436126,Medium (5-15%)
00000127.jpg,458,700,192,325,238,408,False,46,83,3818,0.6542857142857142,46,83,3818,0.5542168674698795,Small,215.0,366.5,0.46943231441048033,0.5235714285714286,middle-center,320600,0.011908920773549594,Small (1-5%)
00001239.jpg,866,1390,413,293,507,473,False,94,180,16920,0.6230215827338129,94,180,16920,0.5222222222222223,Medium,460.0,383.0,0.5311778290993071,0.2755395683453237,top-center,1203740,0.014056191536378288,Small (1-5%)
00002718.jpg,720,576,354,73,526,236,False,172,163,28036,1.25,172,163,28036,1.0552147239263803,Large,440.0,154.5,0.6111111111111112,0.2682291666666667,top-center,414720,0.06760223765432098,Medium (5-15%)
00003406.jpg,800,800,518,510,671,688,False,153,178,27234,1.0,153,178,27234,0.8595505617977528,Large,594.5,599.0,0.743125,0.74875,bottom-right,640000,0.042553125,Small (1-5%)
00003406.jpg,800,800,151,68,329,276,False,178,208,37024,1.0,178,208,37024,0.8557692307692307,Large,240.0,172.0,0.3,0.215,top-left,640000,0.05785,Medium (5-15%)
00003406.jpg,800,800,544,53,700,236,False,156,183,28548,1.0,156,183,28548,0.8524590163934426,Large,622.0,144.5,0.7775,0.180625,top-right,640000,0.04460625,Small (1-5%)
00003406.jpg,800,800,135,473,295,660,False,160,187,29920,1.0,160,187,29920,0.8556149732620321,Large,215.0,566.5,0.26875,0.708125,bottom-left,640000,0.04675,Small (1-5%)
00001577.jpg,735,492,156,24,309,144,False,153,120,18360,1.4939024390243902,153,120,18360,1.275,Medium,232.5,84.0,0.3163265306122449,0.17073170731707318,top-left,361620,0.0507715281234445,Medium (5-15%)
00003374.jpg,587,600,139,327,234,437,False,95,110,10450,0.9783333333333334,95,110,10450,0.8636363636363636,Medium,186.5,382.0,0.31771720613287907,0.6366666666666667,middle-left,352200,0.029670641680863145,Small (1-5%)
00003374.jpg,587,600,356,324,446,432,False,90,108,9720,0.9783333333333334,90,108,9720,0.8333333333333334,Medium,401.0,378.0,0.6831345826235093,0.63,middle-right,352200,0.02759795570698467,Small (1-5%)
00003374.jpg,587,600,251,290,348,403,False,97,113,10961,0.9783333333333334,97,113,10961,0.8584070796460177,Medium,299.5,346.5,0.510221465076661,0.5775,middle-center,352200,0.03112152186257808,Small (1-5%)
00001563.jpg,612,408,270,68,485,235,False,215,167,35905,1.5,215,167,35905,1.2874251497005988,Large,377.5,151.5,0.6168300653594772,0.3713235294117647,middle-center,249696,0.14379485454312443,Medium (5-15%)
00001205.jpg,1000,1500,336,232,772,994,False,436,762,332232,0.6666666666666666,436,762,332232,0.5721784776902887,Very Large,554.0,613.0,0.554,0.4086666666666667,middle-center,1500000,0.221488,Large (15-30%)
00002283.jpg,500,508,167,53,335,247,False,168,194,32592,0.984251968503937,168,194,32592,0.865979381443299,Large,251.0,150.0,0.502,0.2952755905511811,top-center,254000,0.12831496062992126,Medium (5-15%)
00000480.jpg,800,600,330,132,592,361,False,262,229,59998,1.3333333333333333,262,229,59998,1.1441048034934498,Very Large,461.0,246.5,0.57625,0.41083333333333333,middle-center,480000,0.12499583333333333,Medium (5-15%)
00002297.jpg,441,600,287,58,352,161,False,65,103,6695,0.735,65,103,6695,0.6310679611650486,Medium,319.5,109.5,0.7244897959183674,0.1825,top-right,264600,0.025302343159486016,Small (1-5%)
00002297.jpg,441,600,91,65,155,166,False,64,101,6464,0.735,64,101,6464,0.6336633663366337,Medium,123.0,115.5,0.2789115646258503,0.1925,top-left,264600,0.024429327286470143,Small (1-5%)
00001991.jpg,1116,1600,220,1,883,993,False,663,992,657696,0.6975,663,992,657696,0.6683467741935484,Very Large,551.5,497.0,0.49417562724014336,0.310625,top-center,1785600,0.36833333333333335,Very Large (>30%)
00002240.jpg,2000,1333,405,188,933,598,False,528,410,216480,1.5003750937734435,528,410,216480,1.2878048780487805,Very Large,669.0,393.0,0.3345,0.2948237059264816,top-center,2666000,0.08120030007501876,Medium (5-15%)
00000331.jpg,667,1000,301,427,382,568,False,81,141,11421,0.667,81,141,11421,0.574468085106383,Medium,341.5,497.5,0.5119940029985007,0.4975,middle-center,667000,0.017122938530734634,Small (1-5%)
00000325.jpg,1000,667,320,58,590,263,False,270,205,55350,1.4992503748125936,270,205,55350,1.3170731707317074,Very Large,455.0,160.5,0.455,0.24062968515742128,top-center,667000,0.08298350824587707,Medium (5-15%)
00002254.jpg,427,640,186,67,259,195,False,73,128,9344,0.6671875,73,128,9344,0.5703125,Medium,222.5,131.0,0.5210772833723654,0.2046875,top-center,273280,0.034192037470725994,Small (1-5%)
00001985.jpg,493,280,179,1,327,94,False,148,93,13764,1.7607142857142857,148,93,13764,1.5913978494623655,Medium,253.0,47.5,0.513184584178499,0.16964285714285715,top-center,138040,0.09971022891915386,Medium (5-15%)
00003162.jpg,1000,1000,227,225,410,443,False,183,218,39894,1.0,183,218,39894,0.8394495412844036,Large,318.5,334.0,0.3185,0.334,middle-left,1000000,0.039894,Small (1-5%)
00001775.jpg,1000,667,194,14,740,428,False,546,414,226044,1.4992503748125936,546,414,226044,1.318840579710145,Very Large,467.0,221.0,0.467,0.3313343328335832,middle-center,667000,0.3388965517241379,Very Large (>30%)
00001013.jpg,1162,1700,406,184,727,730,False,321,546,175266,0.6835294117647058,321,546,175266,0.5879120879120879,Very Large,566.5,457.0,0.48752151462994836,0.2688235294117647,top-center,1975400,0.08872430900070871,Medium (5-15%)
00001007.jpg,683,1024,276,168,393,373,False,117,205,23985,0.6669921875,117,205,23985,0.5707317073170731,Large,334.5,270.5,0.48975109809663253,0.26416015625,top-center,699392,0.0342940725658858,Small (1-5%)
00001761.jpg,800,582,270,75,522,283,False,252,208,52416,1.3745704467353952,252,208,52416,1.2115384615384615,Very Large,396.0,179.0,0.495,0.3075601374570447,top-center,465600,0.11257731958762887,Medium (5-15%)
00002518.jpg,350,200,21,8,207,132,False,186,124,23064,1.75,186,124,23064,1.5,Large,114.0,70.0,0.32571428571428573,0.35,middle-left,70000,0.32948571428571427,Very Large (>30%)
00001011.jpg,390,280,132,23,269,139,False,137,116,15892,1.3928571428571428,137,116,15892,1.1810344827586208,Medium,200.5,81.0,0.514102564102564,0.2892857142857143,top-center,109200,0.14553113553113553,Medium (5-15%)
00000469.jpg,735,494,107,217,199,287,False,92,70,6440,1.4878542510121457,92,70,6440,1.3142857142857143,Medium,153.0,252.0,0.20816326530612245,0.5101214574898786,middle-left,363090,0.017736649315596684,Small (1-5%)
00003160.jpg,1280,720,259,28,869,436,False,610,408,248880,1.7777777777777777,610,408,248880,1.4950980392156863,Very Large,564.0,232.0,0.440625,0.32222222222222224,top-center,921600,0.27005208333333336,Large (15-30%)
00001763.jpg,699,1050,150,1,699,1050,False,549,1049,575901,0.6657142857142857,549,1049,575901,0.5233555767397522,Very Large,424.5,525.5,0.6072961373390557,0.5004761904761905,middle-center,733950,0.784659717964439,Very Large (>30%)
00000333.jpg,700,467,216,53,477,256,False,261,203,52983,1.4989293361884368,261,203,52983,1.2857142857142858,Very Large,346.5,154.5,0.495,0.33083511777301927,middle-center,326900,0.16207708779443256,Large (15-30%)
00002524.jpg,700,906,141,27,648,791,False,507,764,387348,0.7726269315673289,507,764,387348,0.6636125654450262,Very Large,394.5,409.0,0.5635714285714286,0.45143487858719644,middle-center,634200,0.6107663197729423,Very Large (>30%)
00002242.jpg,1600,1143,523,208,1207,777,False,684,569,389196,1.3998250218722659,684,569,389196,1.2021089630931459,Very Large,865.0,492.5,0.540625,0.4308836395450569,middle-center,1828800,0.21281496062992125,Large (15-30%)
00002242.jpg,1600,1143,227,344,730,753,False,503,409,205727,1.3998250218722659,503,409,205727,1.2298288508557458,Very Large,478.5,548.5,0.2990625,0.4798775153105862,middle-left,1828800,0.1124928915135608,Medium (5-15%)
00001993.jpg,450,378,217,19,303,103,False,86,84,7224,1.1904761904761905,86,84,7224,1.0238095238095237,Medium,260.0,61.0,0.5777777777777777,0.16137566137566137,top-center,170100,0.04246913580246914,Small (1-5%)
00000441.jpg,1600,1168,373,4,1191,683,False,818,679,555422,1.36986301369863,818,679,555422,1.2047128129602356,Very Large,782.0,343.5,0.48875,0.2940924657534247,top-center,1868800,0.2972078339041096,Large (15-30%)
00001987.jpg,1300,1066,286,2,1291,961,False,1005,959,963795,1.2195121951219512,1005,959,963795,1.0479666319082377,Very Large,788.5,481.5,0.6065384615384616,0.45168855534709196,middle-center,1385800,0.6954791456198586,Very Large (>30%)
00003148.jpg,390,280,125,25,299,170,False,174,145,25230,1.3928571428571428,174,145,25230,1.2,Large,212.0,97.5,0.5435897435897435,0.3482142857142857,middle-center,109200,0.23104395604395606,Large (15-30%)
00002530.jpg,612,408,241,32,422,171,False,181,139,25159,1.5,181,139,25159,1.3021582733812949,Large,331.5,101.5,0.5416666666666666,0.24877450980392157,top-center,249696,0.10075852236319364,Medium (5-15%)
00001039.jpg,1200,1800,367,118,684,672,False,317,554,175618,0.6666666666666666,317,554,175618,0.572202166064982,Very Large,525.5,395.0,0.4379166666666667,0.21944444444444444,top-center,2160000,0.08130462962962963,Medium (5-15%)
00001978.jpg,1104,1300,402,138,531,314,False,129,176,22704,0.8492307692307692,129,176,22704,0.7329545454545454,Large,466.5,226.0,0.422554347826087,0.17384615384615384,top-center,1435200,0.015819397993311037,Small (1-5%)
00000496.jpg,682,1023,312,132,445,365,False,133,233,30989,0.6666666666666666,133,233,30989,0.5708154506437768,Large,378.5,248.5,0.5549853372434017,0.2429130009775171,top-center,697686,0.0444168293472995,Small (1-5%)
00001788.jpg,509,339,182,38,349,167,False,167,129,21543,1.5014749262536873,167,129,21543,1.2945736434108528,Large,265.5,102.5,0.5216110019646365,0.3023598820058997,top-center,172551,0.12485004433471843,Medium (5-15%)
00002281.jpg,504,650,183,93,328,307,False,145,214,31030,0.7753846153846153,145,214,31030,0.677570093457944,Large,255.5,200.0,0.5069444444444444,0.3076923076923077,top-center,327600,0.09471916971916972,Medium (5-15%)
00002295.jpg,408,612,99,68,308,424,False,209,356,74404,0.6666666666666666,209,356,74404,0.5870786516853933,Very Large,203.5,246.0,0.4987745098039216,0.4019607843137255,middle-center,249696,0.29797834166346276,Large (15-30%)
00001944.jpg,1024,683,354,65,901,490,False,547,425,232475,1.499267935578331,547,425,232475,1.2870588235294118,Very Large,627.5,277.5,0.61279296875,0.4062957540263543,middle-center,699392,0.33239585239751096,Very Large (>30%)
00003362.jpg,424,490,106,94,158,164,False,52,70,3640,0.8653061224489796,52,70,3640,0.7428571428571429,Small,132.0,129.0,0.3113207547169811,0.26326530612244897,top-left,207760,0.01752021563342318,Small (1-5%)
00003362.jpg,424,490,275,118,323,183,False,48,65,3120,0.8653061224489796,48,65,3120,0.7384615384615385,Small,299.0,150.5,0.7051886792452831,0.30714285714285716,top-right,207760,0.015017327685791297,Small (1-5%)
00003362.jpg,424,490,194,41,251,117,False,57,76,4332,0.8653061224489796,57,76,4332,0.75,Small,222.5,79.0,0.5247641509433962,0.16122448979591836,top-center,207760,0.02085098190219484,Small (1-5%)
00003362.jpg,424,490,195,264,237,320,False,42,56,2352,0.8653061224489796,42,56,2352,0.75,Small,216.0,292.0,0.5094339622641509,0.5959183673469388,middle-center,207760,0.011320754716981131,Small (1-5%)
00003404.jpg,682,1024,271,73,376,257,False,105,184,19320,0.666015625,105,184,19320,0.5706521739130435,Medium,323.5,165.0,0.4743401759530792,0.1611328125,top-center,698368,0.02766449780058651,Small (1-5%)
00003410.jpg,338,508,156,59,240,205,False,84,146,12264,0.6653543307086615,84,146,12264,0.5753424657534246,Medium,198.0,132.0,0.5857988165680473,0.25984251968503935,top-center,171704,0.07142524344220286,Medium (5-15%)
00000119.jpg,698,1050,270,192,348,325,False,78,133,10374,0.6647619047619048,78,133,10374,0.5864661654135338,Medium,309.0,258.5,0.44269340974212035,0.24619047619047618,top-center,732900,0.014154727793696274,Small (1-5%)
00001561.jpg,361,254,125,1,321,143,False,196,142,27832,1.421259842519685,196,142,27832,1.380281690140845,Large,223.0,72.0,0.6177285318559557,0.28346456692913385,top-center,91694,0.30353131066372935,Very Large (>30%)
00002068.jpg,2000,1204,715,121,1141,420,False,426,299,127374,1.6611295681063123,426,299,127374,1.4247491638795986,Very Large,928.0,270.5,0.464,0.22466777408637872,top-center,2408000,0.05289617940199336,Medium (5-15%)
00000657.jpg,600,450,407,204,466,255,False,59,51,3009,1.3333333333333333,59,51,3009,1.1568627450980393,Small,436.5,229.5,0.7275,0.51,middle-right,270000,0.011144444444444445,Small (1-5%)
00000657.jpg,600,450,154,55,212,105,False,58,50,2900,1.3333333333333333,58,50,2900,1.16,Small,183.0,80.0,0.305,0.17777777777777778,top-left,270000,0.01074074074074074,Small (1-5%)
00000657.jpg,600,450,234,158,291,208,False,57,50,2850,1.3333333333333333,57,50,2850,1.14,Small,262.5,183.0,0.4375,0.4066666666666667,middle-center,270000,0.010555555555555556,Small (1-5%)
00000657.jpg,600,450,131,204,198,261,False,67,57,3819,1.3333333333333333,67,57,3819,1.1754385964912282,Small,164.5,232.5,0.27416666666666667,0.5166666666666667,middle-left,270000,0.014144444444444444,Small (1-5%)
00000657.jpg,600,450,167,134,223,184,False,56,50,2800,1.3333333333333333,56,50,2800,1.12,Small,195.0,159.0,0.325,0.35333333333333333,middle-left,270000,0.01037037037037037,Small (1-5%)
00000657.jpg,600,450,323,200,379,249,False,56,49,2744,1.3333333333333333,56,49,2744,1.1428571428571428,Small,351.0,224.5,0.585,0.4988888888888889,middle-center,270000,0.010162962962962962,Small (1-5%)
00000657.jpg,600,450,237,241,294,292,False,57,51,2907,1.3333333333333333,57,51,2907,1.1176470588235294,Small,265.5,266.5,0.4425,0.5922222222222222,middle-center,270000,0.010766666666666667,Small (1-5%)
00000657.jpg,600,450,290,250,347,299,False,57,49,2793,1.3333333333333333,57,49,2793,1.163265306122449,Small,318.5,274.5,0.5308333333333334,0.61,middle-center,270000,0.010344444444444444,Small (1-5%)
00000657.jpg,600,450,368,267,429,321,False,61,54,3294,1.3333333333333333,61,54,3294,1.1296296296296295,Small,398.5,294.0,0.6641666666666667,0.6533333333333333,middle-center,270000,0.0122,Small (1-5%)
00000657.jpg,600,450,471,271,532,326,False,61,55,3355,1.3333333333333333,61,55,3355,1.1090909090909091,Small,501.5,298.5,0.8358333333333333,0.6633333333333333,middle-right,270000,0.012425925925925925,Small (1-5%)
00000657.jpg,600,450,453,323,510,373,False,57,50,2850,1.3333333333333333,57,50,2850,1.14,Small,481.5,348.0,0.8025,0.7733333333333333,bottom-right,270000,0.010555555555555556,Small (1-5%)
00000657.jpg,600,450,341,342,396,390,False,55,48,2640,1.3333333333333333,55,48,2640,1.1458333333333333,Small,368.5,366.0,0.6141666666666666,0.8133333333333334,bottom-center,270000,0.009777777777777778,Tiny (<1%)
00001549.jpg,319,450,134,102,205,221,False,71,119,8449,0.7088888888888889,71,119,8449,0.5966386554621849,Medium,169.5,161.5,0.5313479623824452,0.35888888888888887,middle-center,143550,0.05885754092650644,Medium (5-15%)
00002040.jpg,332,519,150,39,215,157,False,65,118,7670,0.6396917148362236,65,118,7670,0.5508474576271186,Medium,182.5,98.0,0.5496987951807228,0.18882466281310212,top-center,172308,0.04451331336908327,Small (1-5%)
00003438.jpg,800,800,179,429,272,537,False,93,108,10044,1.0,93,108,10044,0.8611111111111112,Medium,225.5,483.0,0.281875,0.60375,middle-left,640000,0.01569375,Small (1-5%)
00002726.jpg,650,969,507,159,575,276,False,68,117,7956,0.6707946336429309,68,117,7956,0.5811965811965812,Medium,541.0,217.5,0.8323076923076923,0.22445820433436534,top-right,629850,0.01263157894736842,Small (1-5%)
00002726.jpg,650,969,406,81,476,198,False,70,117,8190,0.6707946336429309,70,117,8190,0.5982905982905983,Medium,441.0,139.5,0.6784615384615384,0.14396284829721362,top-right,629850,0.013003095975232198,Small (1-5%)
00002726.jpg,650,969,470,277,531,385,False,61,108,6588,0.6707946336429309,61,108,6588,0.5648148148148148,Medium,500.5,331.0,0.77,0.3415892672858617,middle-right,629850,0.010459633246010956,Small (1-5%)
00000643.jpg,2121,1414,388,249,1039,755,False,651,506,329406,1.5,651,506,329406,1.2865612648221343,Very Large,713.5,502.0,0.3363979255068364,0.355021216407355,middle-center,2999094,0.10983517022140686,Medium (5-15%)
00000643.jpg,2121,1414,835,208,1561,759,False,726,551,400026,1.5,726,551,400026,1.3176043557168784,Very Large,1198.0,483.5,0.5648279113625648,0.34193776520509195,middle-center,2999094,0.1333822814489976,Medium (5-15%)
00000643.jpg,2121,1414,1211,407,1986,1008,False,775,601,465775,1.5,775,601,465775,1.2895174708818635,Very Large,1598.5,707.5,0.7536539368222537,0.5003536067892503,middle-right,2999094,0.1553052355144587,Large (15-30%)
00000870.jpg,1000,1500,401,331,551,594,False,150,263,39450,0.6666666666666666,150,263,39450,0.5703422053231939,Large,476.0,462.5,0.476,0.30833333333333335,top-center,1500000,0.0263,Small (1-5%)
00000864.jpg,970,776,155,104,487,407,False,332,303,100596,1.25,332,303,100596,1.0957095709570956,Very Large,321.0,255.5,0.3309278350515464,0.3292525773195876,top-center,752720,0.1336433202253162,Medium (5-15%)
00000858.jpg,1600,1157,369,183,689,452,False,320,269,86080,1.382886776145203,320,269,86080,1.1895910780669146,Very Large,529.0,317.5,0.330625,0.27441659464131374,top-center,1851200,0.04649956784788246,Small (1-5%)
00003389.jpg,626,418,79,82,248,213,False,169,131,22139,1.4976076555023923,169,131,22139,1.2900763358778626,Large,163.5,147.5,0.26118210862619806,0.35287081339712917,middle-left,261668,0.08460721219254934,Medium (5-15%)
00003389.jpg,626,418,276,106,435,229,False,159,123,19557,1.4976076555023923,159,123,19557,1.2926829268292683,Medium,355.5,167.5,0.5678913738019169,0.4007177033492823,middle-center,261668,0.07473974654906217,Medium (5-15%)
00003216.jpg,600,400,159,86,351,236,False,192,150,28800,1.5,192,150,28800,1.28,Large,255.0,161.0,0.425,0.4025,middle-center,240000,0.12,Medium (5-15%)
00001401.jpg,480,720,209,299,260,389,False,51,90,4590,0.6666666666666666,51,90,4590,0.5666666666666667,Small,234.5,344.0,0.48854166666666665,0.4777777777777778,middle-center,345600,0.01328125,Small (1-5%)
00001373.jpg,601,900,251,88,321,212,False,70,124,8680,0.6677777777777778,70,124,8680,0.5645161290322581,Medium,286.0,150.0,0.47587354409317806,0.16666666666666666,top-center,540900,0.016047328526529858,Small (1-5%)
00001415.jpg,850,1280,331,238,603,716,False,272,478,130016,0.6640625,272,478,130016,0.5690376569037657,Very Large,467.0,477.0,0.5494117647058824,0.37265625,middle-center,1088000,0.1195,Medium (5-15%)
00003202.jpg,1068,1600,243,309,777,1220,False,534,911,486474,0.6675,534,911,486474,0.5861690450054885,Very Large,510.0,764.5,0.47752808988764045,0.4778125,middle-center,1708800,0.2846875,Large (15-30%)
00000723.jpg,1240,828,725,239,1020,469,False,295,230,67850,1.497584541062802,295,230,67850,1.2826086956521738,Very Large,872.5,354.0,0.7036290322580645,0.427536231884058,middle-right,1026720,0.06608422939068101,Medium (5-15%)
00000723.jpg,1240,828,387,167,700,405,False,313,238,74494,1.497584541062802,313,238,74494,1.315126050420168,Very Large,543.5,286.0,0.4383064516129032,0.34541062801932365,middle-center,1026720,0.07255532180146486,Medium (5-15%)
00000723.jpg,1240,828,925,115,1239,386,False,314,271,85094,1.497584541062802,314,271,85094,1.1586715867158672,Very Large,1082.0,250.5,0.8725806451612903,0.302536231884058,top-right,1026720,0.0828794608072308,Medium (5-15%)
00000723.jpg,1240,828,238,138,492,331,False,254,193,49022,1.497584541062802,254,193,49022,1.3160621761658031,Large,365.0,234.5,0.29435483870967744,0.2832125603864734,top-left,1026720,0.047746220975533736,Small (1-5%)
00002134.jpg,1500,1089,708,77,1179,466,False,471,389,183219,1.3774104683195592,471,389,183219,1.2107969151670952,Very Large,943.5,271.5,0.629,0.2493112947658402,top-center,1633500,0.11216345270890725,Medium (5-15%)
00002652.jpg,632,994,414,129,505,297,False,91,168,15288,0.635814889336016,91,168,15288,0.5416666666666666,Medium,459.5,213.0,0.7270569620253164,0.21428571428571427,top-right,628208,0.024335888750222856,Small (1-5%)
00000045.jpg,1600,1167,193,140,654,540,False,461,400,184400,1.3710368466152527,461,400,184400,1.1525,Very Large,423.5,340.0,0.2646875,0.2913453299057412,top-left,1867200,0.09875749785775492,Medium (5-15%)
00000051.jpg,700,375,42,14,377,223,False,335,209,70015,1.8666666666666667,335,209,70015,1.6028708133971292,Very Large,209.5,118.5,0.29928571428571427,0.316,top-left,262500,0.26672380952380953,Large (15-30%)
00002120.jpg,700,1050,302,367,387,515,False,85,148,12580,0.6666666666666666,85,148,12580,0.5743243243243243,Medium,344.5,441.0,0.49214285714285716,0.42,middle-center,735000,0.0171156462585034,Small (1-5%)
00000737.jpg,662,576,147,25,221,99,False,74,74,5476,1.1493055555555556,74,74,5476,1.0,Medium,184.0,62.0,0.27794561933534745,0.1076388888888889,top-left,381312,0.014360943269553542,Small (1-5%)
00000737.jpg,662,576,138,118,220,201,False,82,83,6806,1.1493055555555556,82,83,6806,0.9879518072289156,Medium,179.0,159.5,0.270392749244713,0.2769097222222222,top-left,381312,0.01784890063779792,Small (1-5%)
00000737.jpg,662,576,511,137,580,206,False,69,69,4761,1.1493055555555556,69,69,4761,1.0,Small,545.5,171.5,0.8240181268882175,0.2977430555555556,top-right,381312,0.01248583836858006,Small (1-5%)
00000737.jpg,662,576,537,220,602,286,False,65,66,4290,1.1493055555555556,65,66,4290,0.9848484848484849,Small,569.5,253.0,0.8602719033232629,0.4392361111111111,middle-right,381312,0.011250629405840887,Small (1-5%)
00000737.jpg,662,576,6,48,75,118,False,69,70,4830,1.1493055555555556,69,70,4830,0.9857142857142858,Small,40.5,83.0,0.06117824773413897,0.1440972222222222,top-left,381312,0.012666792547834843,Small (1-5%)
00000737.jpg,662,576,43,106,113,179,False,70,73,5110,1.1493055555555556,70,73,5110,0.958904109589041,Medium,78.0,142.5,0.11782477341389729,0.24739583333333334,top-left,381312,0.01340109936220208,Small (1-5%)
00000737.jpg,662,576,277,56,340,121,False,63,65,4095,1.1493055555555556,63,65,4095,0.9692307692307692,Small,308.5,88.5,0.466012084592145,0.15364583333333334,top-center,381312,0.010739237160120846,Small (1-5%)
00000737.jpg,662,576,377,88,438,149,False,61,61,3721,1.1493055555555556,61,61,3721,1.0,Small,407.5,118.5,0.6155589123867069,0.20572916666666666,top-center,381312,0.009758413058073179,Tiny (<1%)
00000737.jpg,662,576,433,98,501,166,False,68,68,4624,1.1493055555555556,68,68,4624,1.0,Small,467.0,132.0,0.7054380664652568,0.22916666666666666,top-right,381312,0.012126552534407519,Small (1-5%)
00002875.jpg,360,254,128,31,228,112,False,100,81,8100,1.4173228346456692,100,81,8100,1.2345679012345678,Medium,178.0,71.5,0.49444444444444446,0.281496062992126,top-center,91440,0.08858267716535433,Medium (5-15%)
00000910.jpg,2000,1333,498,250,1588,1096,False,1090,846,922140,1.5003750937734435,1090,846,922140,1.2884160756501182,Very Large,1043.0,673.0,0.5215,0.5048762190547637,middle-center,2666000,0.34588897224306075,Very Large (>30%)
00001398.jpg,1300,1062,272,49,1013,737,False,741,688,509808,1.2241054613935969,741,688,509808,1.0770348837209303,Very Large,642.5,393.0,0.49423076923076925,0.3700564971751412,middle-center,1380600,0.36926553672316387,Very Large (>30%)
00000086.jpg,1300,867,446,52,650,211,False,204,159,32436,1.4994232987312572,204,159,32436,1.2830188679245282,Large,548.0,131.5,0.42153846153846153,0.1516724336793541,top-center,1127100,0.028778280542986426,Small (1-5%)
00002691.jpg,650,650,94,78,575,637,False,481,559,268879,1.0,481,559,268879,0.8604651162790697,Very Large,334.5,357.5,0.5146153846153846,0.55,middle-center,422500,0.6364,Very Large (>30%)
00002685.jpg,823,576,240,117,412,257,False,172,140,24080,1.4288194444444444,172,140,24080,1.2285714285714286,Large,326.0,187.0,0.39611178614823817,0.3246527777777778,top-center,474048,0.05079654380990954,Medium (5-15%)
00002685.jpg,823,576,444,121,609,256,False,165,135,22275,1.4288194444444444,165,135,22275,1.2222222222222223,Large,526.5,188.5,0.6397326852976913,0.3272569444444444,top-center,474048,0.04698891251518834,Small (1-5%)
00001165.jpg,1100,824,127,312,237,407,False,110,95,10450,1.3349514563106797,110,95,10450,1.1578947368421053,Medium,182.0,359.5,0.16545454545454547,0.4362864077669903,middle-left,906400,0.011529126213592233,Small (1-5%)
00001165.jpg,1100,824,516,42,633,145,False,117,103,12051,1.3349514563106797,117,103,12051,1.1359223300970873,Medium,574.5,93.5,0.5222727272727272,0.11347087378640777,top-center,906400,0.013295454545454546,Small (1-5%)
00001165.jpg,1100,824,313,4,446,124,False,133,120,15960,1.3349514563106797,133,120,15960,1.1083333333333334,Medium,379.5,64.0,0.345,0.07766990291262135,top-center,906400,0.0176081200353045,Small (1-5%)
00001165.jpg,1100,824,651,281,759,375,False,108,94,10152,1.3349514563106797,108,94,10152,1.148936170212766,Medium,705.0,328.0,0.6409090909090909,0.39805825242718446,middle-center,906400,0.01120035304501324,Small (1-5%)
00001165.jpg,1100,824,862,307,969,401,False,107,94,10058,1.3349514563106797,107,94,10058,1.1382978723404256,Medium,915.5,354.0,0.8322727272727273,0.42961165048543687,middle-right,906400,0.011096646072374228,Small (1-5%)
00001165.jpg,1100,824,394,536,495,624,False,101,88,8888,1.3349514563106797,101,88,8888,1.1477272727272727,Medium,444.5,580.0,0.4040909090909091,0.7038834951456311,bottom-center,906400,0.009805825242718447,Tiny (<1%)
00001603.jpg,390,280,46,65,126,132,False,80,67,5360,1.3928571428571428,80,67,5360,1.1940298507462686,Medium,86.0,98.5,0.2205128205128205,0.3517857142857143,middle-left,109200,0.04908424908424908,Small (1-5%)
00003000.jpg,600,338,351,1,561,113,False,210,112,23520,1.7751479289940828,210,112,23520,1.875,Large,456.0,57.0,0.76,0.16863905325443787,top-right,202800,0.11597633136094675,Medium (5-15%)
00000509.jpg,612,408,273,157,407,258,False,134,101,13534,1.5,134,101,13534,1.3267326732673268,Medium,340.0,207.5,0.5555555555555556,0.508578431372549,middle-center,249696,0.054201909521978724,Medium (5-15%)
00000509.jpg,612,408,382,165,518,270,False,136,105,14280,1.5,136,105,14280,1.2952380952380953,Medium,450.0,217.5,0.7352941176470589,0.5330882352941176,middle-right,249696,0.05718954248366013,Medium (5-15%)
00000509.jpg,612,408,176,200,309,304,False,133,104,13832,1.5,133,104,13832,1.2788461538461537,Medium,242.5,252.0,0.39624183006535946,0.6176470588235294,middle-center,249696,0.05539536075868256,Medium (5-15%)
00000509.jpg,612,408,36,209,188,327,False,152,118,17936,1.5,152,118,17936,1.2881355932203389,Medium,112.0,268.0,0.1830065359477124,0.6568627450980392,middle-left,249696,0.0718313469178521,Medium (5-15%)
00000509.jpg,612,408,102,187,235,289,False,133,102,13566,1.5,133,102,13566,1.303921568627451,Medium,168.5,238.0,0.27532679738562094,0.5833333333333334,middle-left,249696,0.054330065359477125,Medium (5-15%)
00001617.jpg,390,280,63,63,234,206,False,171,143,24453,1.3928571428571428,171,143,24453,1.1958041958041958,Large,148.5,134.5,0.38076923076923075,0.48035714285714287,middle-center,109200,0.22392857142857142,Large (15-30%)
00001171.jpg,682,1024,223,253,356,481,False,133,228,30324,0.666015625,133,228,30324,0.5833333333333334,Large,289.5,367.0,0.4244868035190616,0.3583984375,middle-center,698368,0.043421233504398825,Small (1-5%)
00002478.jpg,600,412,45,48,193,167,False,148,119,17612,1.4563106796116505,148,119,17612,1.2436974789915967,Medium,119.0,107.5,0.19833333333333333,0.2609223300970874,top-left,247200,0.07124595469255664,Medium (5-15%)
00002478.jpg,600,412,364,43,512,162,False,148,119,17612,1.4563106796116505,148,119,17612,1.2436974789915967,Medium,438.0,102.5,0.73,0.2487864077669903,top-right,247200,0.07124595469255664,Medium (5-15%)
00001159.jpg,1024,682,419,92,771,360,False,352,268,94336,1.501466275659824,352,268,94336,1.3134328358208955,Very Large,595.0,226.0,0.5810546875,0.3313782991202346,middle-center,698368,0.1350806451612903,Medium (5-15%)
00002336.jpg,250,326,100,42,145,110,False,45,68,3060,0.7668711656441718,45,68,3060,0.6617647058823529,Small,122.5,76.0,0.49,0.2331288343558282,top-center,81500,0.03754601226993865,Small (1-5%)
00000521.jpg,1184,790,684,112,1145,470,False,461,358,165038,1.4987341772151899,461,358,165038,1.2877094972067038,Very Large,914.5,291.0,0.7723817567567568,0.36835443037974686,middle-right,935360,0.17644329456038316,Large (15-30%)
00000521.jpg,1184,790,330,234,744,562,False,414,328,135792,1.4987341772151899,414,328,135792,1.2621951219512195,Very Large,537.0,398.0,0.4535472972972973,0.5037974683544304,middle-center,935360,0.14517618884707492,Medium (5-15%)
00000521.jpg,1184,790,456,51,756,283,False,300,232,69600,1.4987341772151899,300,232,69600,1.293103448275862,Very Large,606.0,167.0,0.5118243243243243,0.21139240506329113,top-center,935360,0.07440985289086555,Medium (5-15%)
00000521.jpg,1184,790,9,136,461,494,False,452,358,161816,1.4987341772151899,452,358,161816,1.2625698324022345,Very Large,235.0,315.0,0.19847972972972974,0.3987341772151899,middle-left,935360,0.17299863154293535,Large (15-30%)
00000521.jpg,1184,790,226,1,539,223,False,313,222,69486,1.4987341772151899,313,222,69486,1.40990990990991,Very Large,382.5,112.0,0.32305743243243246,0.14177215189873418,top-left,935360,0.0742879746835443,Medium (5-15%)
00000535.jpg,1600,1167,1039,108,1481,483,False,442,375,165750,1.3710368466152527,442,375,165750,1.1786666666666668,Very Large,1260.0,295.5,0.7875,0.2532133676092545,top-right,1867200,0.08876928020565553,Medium (5-15%)
00000535.jpg,1600,1167,192,111,581,441,False,389,330,128370,1.3710368466152527,389,330,128370,1.1787878787878787,Very Large,386.5,276.0,0.2415625,0.2365038560411311,top-left,1867200,0.06875,Medium (5-15%)
00000535.jpg,1600,1167,443,278,875,644,False,432,366,158112,1.3710368466152527,432,366,158112,1.180327868852459,Very Large,659.0,461.0,0.411875,0.3950299914310197,middle-center,1867200,0.08467866323907455,Medium (5-15%)
00000535.jpg,1600,1167,733,185,1184,560,False,451,375,169125,1.3710368466152527,451,375,169125,1.2026666666666668,Very Large,958.5,372.5,0.5990625,0.31919451585261355,top-center,1867200,0.09057679948586118,Medium (5-15%)
00000535.jpg,1600,1167,15,340,428,691,False,413,351,144963,1.3710368466152527,413,351,144963,1.1766381766381766,Very Large,221.5,515.5,0.1384375,0.4417309340188518,middle-left,1867200,0.07763656812339331,Medium (5-15%)
00002322.jpg,700,350,1,12,566,345,False,565,333,188145,2.0,565,333,188145,1.6966966966966968,Very Large,283.5,178.5,0.405,0.51,middle-center,245000,0.7679387755102041,Very Large (>30%)
00002493.jpg,715,536,317,208,483,350,False,166,142,23572,1.333955223880597,166,142,23572,1.1690140845070423,Large,400.0,279.0,0.5594405594405595,0.5205223880597015,middle-center,383240,0.061507149566851056,Medium (5-15%)
00001824.jpg,600,495,309,31,398,116,False,89,85,7565,1.2121212121212122,89,85,7565,1.0470588235294118,Medium,353.5,73.5,0.5891666666666666,0.1484848484848485,top-center,297000,0.02547138047138047,Small (1-5%)
00001830.jpg,1000,667,348,64,721,360,False,373,296,110408,1.4992503748125936,373,296,110408,1.260135135135135,Very Large,534.5,212.0,0.5345,0.31784107946026985,top-center,667000,0.16552923538230885,Large (15-30%)
00002487.jpg,533,800,187,58,303,261,False,116,203,23548,0.66625,116,203,23548,0.5714285714285714,Large,245.0,159.5,0.4596622889305816,0.199375,top-center,426400,0.05522514071294559,Medium (5-15%)
00002486.jpg,600,400,228,61,356,160,False,128,99,12672,1.5,128,99,12672,1.292929292929293,Medium,292.0,110.5,0.4866666666666667,0.27625,top-center,240000,0.0528,Medium (5-15%)
00000285.jpg,867,1300,437,392,599,670,False,162,278,45036,0.666923076923077,162,278,45036,0.5827338129496403,Large,518.0,531.0,0.5974625144175317,0.4084615384615385,middle-center,1127100,0.03995741282938515,Small (1-5%)
00002492.jpg,362,512,222,89,266,161,False,44,72,3168,0.70703125,44,72,3168,0.6111111111111112,Small,244.0,125.0,0.6740331491712708,0.244140625,top-right,185344,0.01709254143646409,Small (1-5%)
00001825.jpg,2000,1334,463,167,1282,802,False,819,635,520065,1.4992503748125936,819,635,520065,1.2897637795275592,Very Large,872.5,484.5,0.43625,0.3631934032983508,middle-center,2668000,0.1949269115442279,Large (15-30%)
00001819.jpg,1024,682,365,24,557,172,False,192,148,28416,1.501466275659824,192,148,28416,1.2972972972972974,Large,461.0,98.0,0.4501953125,0.1436950146627566,top-center,698368,0.0406891495601173,Small (1-5%)
00002323.jpg,1331,1080,360,203,1085,888,False,725,685,496625,1.2324074074074074,725,685,496625,1.0583941605839415,Very Large,722.5,545.5,0.5428249436513899,0.5050925925925925,middle-center,1437480,0.3454830675905056,Very Large (>30%)
00002445.jpg,385,450,156,105,204,168,False,48,63,3024,0.8555555555555555,48,63,3024,0.7619047619047619,Small,180.0,136.5,0.4675324675324675,0.30333333333333334,top-center,173250,0.017454545454545455,Small (1-5%)
00002451.jpg,1800,1200,204,1,1506,884,False,1302,883,1149666,1.5,1302,883,1149666,1.4745186862967157,Very Large,855.0,442.5,0.475,0.36875,middle-center,2160000,0.5322527777777778,Very Large (>30%)
00001158.jpg,533,849,199,1,370,304,False,171,303,51813,0.6277974087161367,171,303,51813,0.5643564356435643,Very Large,284.5,152.5,0.5337711069418386,0.17962308598351,top-center,452517,0.11449956576217026,Medium (5-15%)
00000520.jpg,400,290,299,93,374,156,False,75,63,4725,1.3793103448275863,75,63,4725,1.1904761904761905,Small,336.5,124.5,0.84125,0.42931034482758623,middle-right,116000,0.04073275862068965,Small (1-5%)
00000520.jpg,400,290,32,75,137,166,False,105,91,9555,1.3793103448275863,105,91,9555,1.1538461538461537,Medium,84.5,120.5,0.21125,0.41551724137931034,middle-left,116000,0.08237068965517241,Medium (5-15%)
00000520.jpg,400,290,150,81,225,144,False,75,63,4725,1.3793103448275863,75,63,4725,1.1904761904761905,Small,187.5,112.5,0.46875,0.3879310344827586,middle-center,116000,0.04073275862068965,Small (1-5%)
00000520.jpg,400,290,102,43,180,109,False,78,66,5148,1.3793103448275863,78,66,5148,1.1818181818181819,Medium,141.0,76.0,0.3525,0.2620689655172414,top-center,116000,0.04437931034482759,Small (1-5%)
00000520.jpg,400,290,262,64,323,115,False,61,51,3111,1.3793103448275863,61,51,3111,1.196078431372549,Small,292.5,89.5,0.73125,0.3086206896551724,top-right,116000,0.02681896551724138,Small (1-5%)
00000520.jpg,400,290,187,44,246,93,False,59,49,2891,1.3793103448275863,59,49,2891,1.2040816326530612,Small,216.5,68.5,0.54125,0.23620689655172414,top-center,116000,0.02492241379310345,Small (1-5%)
00000508.jpg,1500,1000,273,307,622,578,False,349,271,94579,1.5,349,271,94579,1.2878228782287824,Very Large,447.5,442.5,0.29833333333333334,0.4425,middle-left,1500000,0.06305266666666667,Medium (5-15%)
00000508.jpg,1500,1000,975,410,1354,704,False,379,294,111426,1.5,379,294,111426,1.2891156462585034,Very Large,1164.5,557.0,0.7763333333333333,0.557,middle-right,1500000,0.074284,Medium (5-15%)
00000508.jpg,1500,1000,932,198,1219,421,False,287,223,64001,1.5,287,223,64001,1.2869955156950672,Very Large,1075.5,309.5,0.717,0.3095,top-right,1500000,0.042667333333333335,Small (1-5%)
00000508.jpg,1500,1000,1120,301,1427,529,False,307,228,69996,1.5,307,228,69996,1.3464912280701755,Very Large,1273.5,415.0,0.849,0.415,middle-right,1500000,0.046664,Small (1-5%)
00000508.jpg,1500,1000,788,356,1109,599,False,321,243,78003,1.5,321,243,78003,1.3209876543209877,Very Large,948.5,477.5,0.6323333333333333,0.4775,middle-center,1500000,0.052002,Medium (5-15%)
00000508.jpg,1500,1000,485,451,872,745,False,387,294,113778,1.5,387,294,113778,1.316326530612245,Very Large,678.5,598.0,0.4523333333333333,0.598,middle-center,1500000,0.075852,Medium (5-15%)
00000508.jpg,1500,1000,593,247,965,535,False,372,288,107136,1.5,372,288,107136,1.2916666666666667,Very Large,779.0,391.0,0.5193333333333333,0.391,middle-center,1500000,0.071424,Medium (5-15%)
00000508.jpg,1500,1000,1,562,359,869,False,358,307,109906,1.5,358,307,109906,1.1661237785016287,Very Large,180.0,715.5,0.12,0.7155,bottom-left,1500000,0.07327066666666666,Medium (5-15%)
00000508.jpg,1500,1000,258,649,719,1000,False,461,351,161811,1.5,461,351,161811,1.3133903133903133,Very Large,488.5,824.5,0.32566666666666666,0.8245,bottom-left,1500000,0.107874,Medium (5-15%)
00000508.jpg,1500,1000,819,791,1147,1000,False,328,209,68552,1.5,328,209,68552,1.569377990430622,Very Large,983.0,895.5,0.6553333333333333,0.8955,bottom-center,1500000,0.04570133333333333,Small (1-5%)
00003001.jpg,940,529,376,108,556,224,False,180,116,20880,1.776937618147448,180,116,20880,1.5517241379310345,Large,466.0,166.0,0.4957446808510638,0.31379962192816635,top-center,497260,0.041990105779672604,Small (1-5%)
00001170.jpg,1300,957,431,138,797,452,False,366,314,114924,1.3584117032392895,366,314,114924,1.1656050955414012,Very Large,614.0,295.0,0.4723076923076923,0.30825496342737724,top-center,1244100,0.09237521099590065,Medium (5-15%)
00001164.jpg,1600,1156,1055,92,1222,236,False,167,144,24048,1.3840830449826989,167,144,24048,1.1597222222222223,Large,1138.5,164.0,0.7115625,0.14186851211072665,top-right,1849600,0.013001730103806229,Small (1-5%)
00001602.jpg,612,408,144,107,400,310,False,256,203,51968,1.5,256,203,51968,1.2610837438423645,Very Large,272.0,208.5,0.4444444444444444,0.5110294117647058,middle-center,249696,0.20812508009739844,Large (15-30%)
00002684.jpg,1024,682,266,118,510,303,False,244,185,45140,1.501466275659824,244,185,45140,1.318918918918919,Large,388.0,210.5,0.37890625,0.3086510263929619,top-center,698368,0.064636409457478,Medium (5-15%)
00002684.jpg,1024,682,459,108,713,304,False,254,196,49784,1.501466275659824,254,196,49784,1.2959183673469388,Large,586.0,206.0,0.572265625,0.3020527859237537,top-center,698368,0.07128619868035191,Medium (5-15%)
00000939.jpg,960,678,515,37,615,117,False,100,80,8000,1.415929203539823,100,80,8000,1.25,Medium,565.0,77.0,0.5885416666666666,0.11356932153392331,top-center,650880,0.012291052114060964,Small (1-5%)
00002848.jpg,337,450,132,29,176,97,False,44,68,2992,0.7488888888888889,44,68,2992,0.6470588235294118,Small,154.0,63.0,0.456973293768546,0.14,top-center,151650,0.019729640619848336,Small (1-5%)
00000087.jpg,870,580,108,41,359,235,False,251,194,48694,1.5,251,194,48694,1.2938144329896908,Large,233.5,138.0,0.26839080459770115,0.23793103448275862,top-left,504600,0.09650019817677369,Medium (5-15%)
00000087.jpg,870,580,530,52,781,242,False,251,190,47690,1.5,251,190,47690,1.3210526315789475,Large,655.5,147.0,0.753448275862069,0.253448275862069,top-right,504600,0.09451050336900516,Medium (5-15%)
00001399.jpg,433,650,84,70,215,293,False,131,223,29213,0.6661538461538462,131,223,29213,0.5874439461883408,Large,149.5,181.5,0.34526558891454967,0.2792307692307692,top-center,281450,0.10379463492627465,Medium (5-15%)
00002860.jpg,900,675,678,160,770,240,False,92,80,7360,1.3333333333333333,92,80,7360,1.15,Medium,724.0,200.0,0.8044444444444444,0.2962962962962963,top-right,607500,0.01211522633744856,Small (1-5%)
00002860.jpg,900,675,480,56,568,133,False,88,77,6776,1.3333333333333333,88,77,6776,1.1428571428571428,Medium,524.0,94.5,0.5822222222222222,0.14,top-center,607500,0.011153909465020576,Small (1-5%)
00002860.jpg,900,675,79,114,186,208,False,107,94,10058,1.3333333333333333,107,94,10058,1.1382978723404256,Medium,132.5,161.0,0.14722222222222223,0.23851851851851852,top-left,607500,0.016556378600823044,Small (1-5%)
00002874.jpg,2048,2048,497,583,1158,1352,False,661,769,508309,1.0,661,769,508309,0.8595578673602081,Very Large,827.5,967.5,0.404052734375,0.472412109375,middle-center,4194304,0.12119030952453613,Medium (5-15%)
00002647.jpg,1000,1294,415,321,643,657,False,228,336,76608,0.7727975270479135,228,336,76608,0.6785714285714286,Very Large,529.0,489.0,0.529,0.37789799072642966,middle-center,1294000,0.059202472952086554,Medium (5-15%)
00000050.jpg,1065,1300,425,209,593,447,False,168,238,39984,0.8192307692307692,168,238,39984,0.7058823529411765,Large,509.0,328.0,0.4779342723004695,0.2523076923076923,top-center,1384500,0.02887973997833153,Small (1-5%)
00001428.jpg,590,885,201,89,382,406,False,181,317,57377,0.6666666666666666,181,317,57377,0.5709779179810726,Very Large,291.5,247.5,0.4940677966101695,0.2796610169491525,top-center,522150,0.10988604807047783,Medium (5-15%)
00002121.jpg,359,254,74,17,156,84,False,82,67,5494,1.4133858267716535,82,67,5494,1.2238805970149254,Medium,115.0,50.5,0.3203342618384401,0.19881889763779528,top-left,91186,0.060250477046915094,Medium (5-15%)
00002135.jpg,792,1200,521,189,648,409,False,127,220,27940,0.66,127,220,27940,0.5772727272727273,Large,584.5,299.0,0.7380050505050505,0.24916666666666668,top-right,950400,0.02939814814814815,Small (1-5%)
00002135.jpg,792,1200,155,507,272,713,False,117,206,24102,0.66,117,206,24102,0.5679611650485437,Large,213.5,610.0,0.26957070707070707,0.5083333333333333,middle-left,950400,0.025359848484848485,Small (1-5%)
00000044.jpg,873,580,314,70,626,311,False,312,241,75192,1.5051724137931035,312,241,75192,1.2946058091286308,Very Large,470.0,190.5,0.5383734249713631,0.328448275862069,top-center,506340,0.14850100722834458,Medium (5-15%)
00002653.jpg,1000,1500,434,146,755,706,False,321,560,179760,0.6666666666666666,321,560,179760,0.5732142857142857,Very Large,594.5,426.0,0.5945,0.284,top-center,1500000,0.11984,Medium (5-15%)
00001372.jpg,270,420,96,28,129,87,False,33,59,1947,0.6428571428571429,33,59,1947,0.559322033898305,Small,112.5,57.5,0.4166666666666667,0.13690476190476192,top-center,113400,0.01716931216931217,Small (1-5%)
00003203.jpg,612,408,299,240,413,329,False,114,89,10146,1.5,114,89,10146,1.2808988764044944,Medium,356.0,284.5,0.5816993464052288,0.6973039215686274,bottom-center,249696,0.04063341022683583,Small (1-5%)
00003203.jpg,612,408,147,206,252,287,False,105,81,8505,1.5,105,81,8505,1.2962962962962963,Medium,199.5,246.5,0.32598039215686275,0.6041666666666666,middle-left,249696,0.03406141868512111,Small (1-5%)
00003203.jpg,612,408,282,130,378,205,False,96,75,7200,1.5,96,75,7200,1.28,Medium,330.0,167.5,0.5392156862745098,0.4105392156862745,middle-center,249696,0.02883506343713956,Small (1-5%)
00003203.jpg,612,408,221,52,311,122,False,90,70,6300,1.5,90,70,6300,1.2857142857142858,Medium,266.0,87.0,0.434640522875817,0.21323529411764705,top-center,249696,0.025230680507497116,Small (1-5%)
00003203.jpg,612,408,111,65,202,135,False,91,70,6370,1.5,91,70,6370,1.3,Medium,156.5,100.0,0.255718954248366,0.24509803921568626,top-left,249696,0.025511021402024863,Small (1-5%)
00003203.jpg,612,408,190,140,298,223,False,108,83,8964,1.5,108,83,8964,1.3012048192771084,Medium,244.0,181.5,0.39869281045751637,0.44485294117647056,middle-center,249696,0.035899653979238756,Small (1-5%)
00001400.jpg,2000,1333,540,178,1026,555,False,486,377,183222,1.5003750937734435,486,377,183222,1.2891246684350133,Very Large,783.0,366.5,0.3915,0.27494373593398347,top-center,2666000,0.06872543135783946,Medium (5-15%)
00003217.jpg,1024,683,341,240,569,417,False,228,177,40356,1.499267935578331,228,177,40356,1.2881355932203389,Large,455.0,328.5,0.4443359375,0.48096632503660325,middle-center,699392,0.05770154648609078,Medium (5-15%)
00003217.jpg,1024,683,464,4,723,200,False,259,196,50764,1.499267935578331,259,196,50764,1.3214285714285714,Very Large,593.5,102.0,0.57958984375,0.1493411420204978,top-center,699392,0.07258304355783309,Medium (5-15%)
00001366.jpg,800,568,269,90,499,276,False,230,186,42780,1.408450704225352,230,186,42780,1.2365591397849462,Large,384.0,183.0,0.48,0.3221830985915493,top-center,454400,0.09414612676056339,Medium (5-15%)
00002928.jpg,1200,630,824,319,1097,486,False,273,167,45591,1.9047619047619047,273,167,45591,1.6347305389221556,Large,960.5,402.5,0.8004166666666667,0.6388888888888888,middle-right,756000,0.06030555555555556,Medium (5-15%)
00002096.jpg,600,420,221,37,377,163,False,156,126,19656,1.4285714285714286,156,126,19656,1.2380952380952381,Medium,299.0,100.0,0.49833333333333335,0.23809523809523808,top-center,252000,0.078,Medium (5-15%)
00000681.jpg,650,433,387,100,509,194,False,122,94,11468,1.5011547344110854,122,94,11468,1.297872340425532,Medium,448.0,147.0,0.6892307692307692,0.3394919168591224,middle-right,281450,0.04074613608100906,Small (1-5%)
00000681.jpg,650,433,256,122,352,196,False,96,74,7104,1.5011547344110854,96,74,7104,1.2972972972972974,Medium,304.0,159.0,0.4676923076923077,0.3672055427251732,middle-center,281450,0.025240717711849353,Small (1-5%)
00000681.jpg,650,433,133,67,231,143,False,98,76,7448,1.5011547344110854,98,76,7448,1.2894736842105263,Medium,182.0,105.0,0.28,0.24249422632794457,top-left,281450,0.026462959673121338,Small (1-5%)
00000681.jpg,650,433,229,62,325,137,False,96,75,7200,1.5011547344110854,96,75,7200,1.28,Medium,277.0,99.5,0.42615384615384616,0.22979214780600463,top-center,281450,0.02558180849173921,Small (1-5%)
00000859.jpg,891,980,185,125,458,475,False,273,350,95550,0.9091836734693878,273,350,95550,0.78,Very Large,321.5,300.0,0.3608305274971942,0.30612244897959184,top-center,873180,0.10942760942760943,Medium (5-15%)
00002914.jpg,1070,580,611,109,849,260,False,238,151,35938,1.8448275862068966,238,151,35938,1.576158940397351,Large,730.0,184.5,0.6822429906542056,0.31810344827586207,top-right,620600,0.0579084756687077,Medium (5-15%)
00000642.jpg,1200,800,235,170,465,349,False,230,179,41170,1.5,230,179,41170,1.2849162011173185,Large,350.0,259.5,0.2916666666666667,0.324375,top-left,960000,0.04288541666666667,Small (1-5%)
00000642.jpg,1200,800,377,104,602,279,False,225,175,39375,1.5,225,175,39375,1.2857142857142858,Large,489.5,191.5,0.40791666666666665,0.239375,top-center,960000,0.041015625,Small (1-5%)
00000642.jpg,1200,800,402,287,813,599,False,411,312,128232,1.5,411,312,128232,1.3173076923076923,Very Large,607.5,443.0,0.50625,0.55375,middle-center,960000,0.133575,Medium (5-15%)
00000642.jpg,1200,800,775,363,1188,683,False,413,320,132160,1.5,413,320,132160,1.290625,Very Large,981.5,523.0,0.8179166666666666,0.65375,middle-right,960000,0.13766666666666666,Medium (5-15%)
00000642.jpg,1200,800,610,239,816,399,False,206,160,32960,1.5,206,160,32960,1.2875,Large,713.0,319.0,0.5941666666666666,0.39875,middle-center,960000,0.034333333333333334,Small (1-5%)
00000642.jpg,1200,800,769,204,1014,390,False,245,186,45570,1.5,245,186,45570,1.3172043010752688,Large,891.5,297.0,0.7429166666666667,0.37125,middle-right,960000,0.04746875,Small (1-5%)
00000642.jpg,1200,800,100,356,367,563,False,267,207,55269,1.5,267,207,55269,1.289855072463768,Very Large,233.5,459.5,0.19458333333333333,0.574375,middle-left,960000,0.057571875,Medium (5-15%)
00001548.jpg,3896,5999,1675,1118,2582,2743,False,907,1625,1473875,0.6494415735955993,907,1625,1473875,0.5581538461538461,Very Large,2128.5,1930.5,0.546329568788501,0.3218036339389898,top-center,23372104,0.06306128879111611,Medium (5-15%)
00000656.jpg,700,525,149,243,298,373,False,149,130,19370,1.3333333333333333,149,130,19370,1.146153846153846,Medium,223.5,308.0,0.3192857142857143,0.5866666666666667,middle-left,367500,0.05270748299319728,Medium (5-15%)
00000656.jpg,700,525,223,67,343,172,False,120,105,12600,1.3333333333333333,120,105,12600,1.1428571428571428,Medium,283.0,119.5,0.4042857142857143,0.2276190476190476,top-center,367500,0.03428571428571429,Small (1-5%)
00000656.jpg,700,525,340,135,445,227,False,105,92,9660,1.3333333333333333,105,92,9660,1.141304347826087,Medium,392.5,181.0,0.5607142857142857,0.34476190476190477,middle-center,367500,0.026285714285714287,Small (1-5%)
00000656.jpg,700,525,502,63,608,155,False,106,92,9752,1.3333333333333333,106,92,9752,1.1521739130434783,Medium,555.0,109.0,0.7928571428571428,0.20761904761904762,top-right,367500,0.026536054421768707,Small (1-5%)
00000656.jpg,700,525,2,105,217,349,False,215,244,52460,1.3333333333333333,215,244,52460,0.8811475409836066,Very Large,109.5,227.0,0.15642857142857142,0.43238095238095237,middle-left,367500,0.14274829931972788,Medium (5-15%)
00002727.jpg,868,1300,496,356,592,525,False,96,169,16224,0.6676923076923077,96,169,16224,0.5680473372781065,Medium,544.0,440.5,0.6267281105990783,0.33884615384615385,middle-center,1128400,0.014377880184331797,Small (1-5%)
00002727.jpg,868,1300,248,371,338,529,False,90,158,14220,0.6676923076923077,90,158,14220,0.569620253164557,Medium,293.0,450.0,0.33755760368663595,0.34615384615384615,middle-center,1128400,0.01260191421481744,Small (1-5%)
00003439.jpg,612,409,241,60,417,194,False,176,134,23584,1.4963325183374083,176,134,23584,1.3134328358208955,Large,329.0,127.0,0.5375816993464052,0.3105134474327628,top-center,250308,0.09421992105725746,Medium (5-15%)
00000118.jpg,951,1000,321,127,547,398,False,226,271,61246,0.951,226,271,61246,0.8339483394833949,Very Large,434.0,262.5,0.45636172450052576,0.2625,top-center,951000,0.06440168243953732,Medium (5-15%)
00003377.jpg,390,280,56,18,139,88,False,83,70,5810,1.3928571428571428,83,70,5810,1.1857142857142857,Medium,97.5,53.0,0.25,0.18928571428571428,top-left,109200,0.0532051282051282,Medium (5-15%)
00003377.jpg,390,280,203,38,285,106,False,82,68,5576,1.3928571428571428,82,68,5576,1.2058823529411764,Medium,244.0,72.0,0.6256410256410256,0.2571428571428571,top-center,109200,0.05106227106227106,Medium (5-15%)
00003377.jpg,390,280,135,82,212,145,False,77,63,4851,1.3928571428571428,77,63,4851,1.2222222222222223,Small,173.5,113.5,0.44487179487179485,0.40535714285714286,middle-center,109200,0.044423076923076926,Small (1-5%)
00002069.jpg,1500,1203,1,47,683,728,False,682,681,464442,1.2468827930174564,682,681,464442,1.0014684287812041,Very Large,342.0,387.5,0.228,0.32211138819617624,top-left,1804500,0.25737988362427267,Large (15-30%)
00001560.jpg,1470,980,563,194,905,460,False,342,266,90972,1.5,342,266,90972,1.2857142857142858,Very Large,734.0,327.0,0.4993197278911565,0.3336734693877551,middle-center,1440600,0.06314868804664724,Medium (5-15%)
00003405.jpg,360,239,162,24,241,84,False,79,60,4740,1.506276150627615,79,60,4740,1.3166666666666667,Small,201.5,54.0,0.5597222222222222,0.22594142259414227,top-center,86040,0.05509065550906555,Medium (5-15%)
00003405.jpg,360,239,112,73,193,134,False,81,61,4941,1.506276150627615,81,61,4941,1.3278688524590163,Small,152.5,103.5,0.4236111111111111,0.4330543933054393,middle-center,86040,0.05742677824267783,Medium (5-15%)
00003405.jpg,360,239,73,92,142,145,False,69,53,3657,1.506276150627615,69,53,3657,1.3018867924528301,Small,107.5,118.5,0.2986111111111111,0.49581589958158995,middle-left,86040,0.04250348675034867,Small (1-5%)
00001212.jpg,612,423,269,44,391,145,False,122,101,12322,1.446808510638298,122,101,12322,1.2079207920792079,Medium,330.0,94.5,0.5392156862745098,0.22340425531914893,top-center,258876,0.04759807784421886,Small (1-5%)
00002294.jpg,1050,1400,188,73,699,866,False,511,793,405223,0.75,511,793,405223,0.6443883984867591,Very Large,443.5,469.5,0.42238095238095236,0.33535714285714285,middle-center,1470000,0.2756619047619048,Large (15-30%)
00002280.jpg,1000,750,593,62,846,283,False,253,221,55913,1.3333333333333333,253,221,55913,1.1447963800904977,Very Large,719.5,172.5,0.7195,0.23,top-right,750000,0.07455066666666667,Medium (5-15%)
00001789.jpg,1000,667,1,1,676,348,False,675,347,234225,1.4992503748125936,675,347,234225,1.9452449567723342,Very Large,338.5,174.5,0.3385,0.2616191904047976,top-center,667000,0.3511619190404798,Very Large (>30%)
00001951.jpg,500,333,198,122,317,214,False,119,92,10948,1.5015015015015014,119,92,10948,1.2934782608695652,Medium,257.5,168.0,0.515,0.5045045045045045,middle-center,166500,0.06575375375375375,Medium (5-15%)
00001979.jpg,612,424,195,57,383,209,False,188,152,28576,1.4433962264150944,188,152,28576,1.236842105263158,Large,289.0,133.0,0.4722222222222222,0.3136792452830189,top-center,259488,0.11012455296584042,Medium (5-15%)
00001986.jpg,800,582,176,21,673,442,False,497,421,209237,1.3745704467353952,497,421,209237,1.180522565320665,Very Large,424.5,231.5,0.530625,0.39776632302405496,middle-center,465600,0.4493921821305842,Very Large (>30%)
00001038.jpg,721,720,277,11,476,242,False,199,231,45969,1.0013888888888889,199,231,45969,0.8614718614718615,Large,376.5,126.5,0.5221914008321775,0.17569444444444443,top-center,519120,0.08855177993527508,Medium (5-15%)
00002525.jpg,1200,800,99,46,839,621,False,740,575,425500,1.5,740,575,425500,1.2869565217391303,Very Large,469.0,333.5,0.3908333333333333,0.416875,middle-center,960000,0.4432291666666667,Very Large (>30%)
00002243.jpg,750,500,166,28,298,130,False,132,102,13464,1.5,132,102,13464,1.2941176470588236,Medium,232.0,79.0,0.30933333333333335,0.158,top-left,375000,0.035904,Small (1-5%)
00001762.jpg,722,1390,322,179,435,434,False,113,255,28815,0.5194244604316547,113,255,28815,0.44313725490196076,Large,378.5,306.5,0.5242382271468145,0.22050359712230216,top-center,1003580,0.028712210287171924,Small (1-5%)
00003175.jpg,1000,1500,631,372,744,566,False,113,194,21922,0.6666666666666666,113,194,21922,0.5824742268041238,Large,687.5,469.0,0.6875,0.31266666666666665,top-right,1500000,0.014614666666666666,Small (1-5%)
00001010.jpg,1120,1680,345,441,784,1191,False,439,750,329250,0.6666666666666666,439,750,329250,0.5853333333333334,Very Large,564.5,816.0,0.5040178571428572,0.4857142857142857,middle-center,1881600,0.17498405612244897,Large (15-30%)
00003161.jpg,508,340,125,77,253,178,False,128,101,12928,1.4941176470588236,128,101,12928,1.2673267326732673,Medium,189.0,127.5,0.3720472440944882,0.375,middle-center,172720,0.07484946734599351,Medium (5-15%)
00001776.jpg,591,519,259,26,352,122,False,93,96,8928,1.138728323699422,93,96,8928,0.96875,Medium,305.5,74.0,0.5169204737732657,0.14258188824662812,top-center,306729,0.029107127138288197,Small (1-5%)
00003159.jpg,960,641,339,106,809,479,False,470,373,175310,1.497659906396256,470,373,175310,1.260053619302949,Very Large,574.0,292.5,0.5979166666666667,0.45631825273010923,middle-center,615360,0.2848901456058242,Large (15-30%)
00002247.jpg,640,357,563,108,639,201,False,76,93,7068,1.792717086834734,76,93,7068,0.8172043010752689,Medium,601.0,154.5,0.9390625,0.4327731092436975,middle-right,228480,0.030934873949579833,Small (1-5%)
00001996.jpg,1500,1101,607,108,882,343,False,275,235,64625,1.3623978201634876,275,235,64625,1.1702127659574468,Very Large,744.5,225.5,0.49633333333333335,0.20481380563124432,top-center,1651500,0.03913109294580684,Small (1-5%)
00001028.jpg,1000,667,295,123,704,440,False,409,317,129653,1.4992503748125936,409,317,129653,1.2902208201892744,Very Large,499.5,281.5,0.4995,0.42203898050974514,middle-center,667000,0.19438230884557722,Large (15-30%)
00002521.jpg,1024,683,350,81,633,301,False,283,220,62260,1.499267935578331,283,220,62260,1.2863636363636364,Very Large,491.5,191.0,0.47998046875,0.2796486090775988,top-center,699392,0.08902017752562226,Medium (5-15%)
00002535.jpg,960,720,459,66,708,282,False,249,216,53784,1.3333333333333333,249,216,53784,1.1527777777777777,Very Large,583.5,174.0,0.6078125,0.24166666666666667,top-center,691200,0.0778125,Medium (5-15%)
00000322.jpg,800,582,315,66,522,241,False,207,175,36225,1.3745704467353952,207,175,36225,1.1828571428571428,Large,418.5,153.5,0.523125,0.26374570446735396,top-center,465600,0.07780283505154639,Medium (5-15%)
00001982.jpg,626,417,311,12,473,137,False,162,125,20250,1.501199040767386,162,125,20250,1.296,Large,392.0,74.5,0.6261980830670927,0.17865707434052758,top-center,261042,0.07757372376858897,Medium (5-15%)
00001772.jpg,1335,2000,553,143,832,629,False,279,486,135594,0.6675,279,486,135594,0.5740740740740741,Very Large,692.5,386.0,0.5187265917602997,0.193,top-center,2670000,0.05078426966292135,Medium (5-15%)
00003165.jpg,262,280,75,197,119,250,False,44,53,2332,0.9357142857142857,44,53,2332,0.8301886792452831,Small,97.0,223.5,0.3702290076335878,0.7982142857142858,bottom-center,73360,0.03178844056706652,Small (1-5%)
00003165.jpg,262,280,209,199,251,251,False,42,52,2184,0.9357142857142857,42,52,2184,0.8076923076923077,Small,230.0,225.0,0.8778625954198473,0.8035714285714286,bottom-right,73360,0.029770992366412213,Small (1-5%)
00003165.jpg,262,280,15,5,52,50,False,37,45,1665,0.9357142857142857,37,45,1665,0.8222222222222222,Small,33.5,27.5,0.12786259541984732,0.09821428571428571,top-left,73360,0.02269629225736096,Small (1-5%)
00003165.jpg,262,280,143,3,184,54,False,41,51,2091,0.9357142857142857,41,51,2091,0.803921568627451,Small,163.5,28.5,0.6240458015267175,0.10178571428571428,top-center,73360,0.028503271537622683,Small (1-5%)
00003165.jpg,262,280,140,136,180,186,False,40,50,2000,0.9357142857142857,40,50,2000,0.8,Small,160.0,161.0,0.6106870229007634,0.575,middle-center,73360,0.027262813522355506,Small (1-5%)
00003165.jpg,262,280,15,200,51,245,False,36,45,1620,0.9357142857142857,36,45,1620,0.8,Small,33.0,222.5,0.12595419847328243,0.7946428571428571,bottom-left,73360,0.02208287895310796,Small (1-5%)
00003165.jpg,262,280,77,7,115,54,False,38,47,1786,0.9357142857142857,38,47,1786,0.8085106382978723,Small,96.0,30.5,0.366412213740458,0.10892857142857143,top-center,73360,0.02434569247546347,Small (1-5%)
00003165.jpg,262,280,12,134,49,180,False,37,46,1702,0.9357142857142857,37,46,1702,0.8043478260869565,Small,30.5,157.0,0.11641221374045801,0.5607142857142857,middle-left,73360,0.023200654307524538,Small (1-5%)
00003165.jpg,262,280,16,74,51,118,False,35,44,1540,0.9357142857142857,35,44,1540,0.7954545454545454,Small,33.5,96.0,0.12786259541984732,0.34285714285714286,middle-left,73360,0.02099236641221374,Small (1-5%)
00003165.jpg,262,280,213,71,246,113,False,33,42,1386,0.9357142857142857,33,42,1386,0.7857142857142857,Small,229.5,92.0,0.8759541984732825,0.32857142857142857,top-right,73360,0.018893129770992365,Small (1-5%)
00003165.jpg,262,280,82,135,116,177,False,34,42,1428,0.9357142857142857,34,42,1428,0.8095238095238095,Small,99.0,156.0,0.37786259541984735,0.5571428571428572,middle-center,73360,0.019465648854961833,Small (1-5%)
00001014.jpg,1200,1800,278,80,691,786,False,413,706,291578,0.6666666666666666,413,706,291578,0.5849858356940509,Very Large,484.5,433.0,0.40375,0.24055555555555555,top-center,2160000,0.1349898148148148,Medium (5-15%)
00002509.jpg,390,480,151,60,216,154,False,65,94,6110,0.8125,65,94,6110,0.6914893617021277,Medium,183.5,107.0,0.4705128205128205,0.22291666666666668,top-center,187200,0.03263888888888889,Small (1-5%)
00003171.jpg,682,1023,415,360,532,565,False,117,205,23985,0.6666666666666666,117,205,23985,0.5707317073170731,Large,473.5,462.5,0.6942815249266863,0.4521016617790811,middle-right,697686,0.03437792932637318,Small (1-5%)
00001766.jpg,1600,1157,676,19,945,246,False,269,227,61063,1.382886776145203,269,227,61063,1.1850220264317182,Very Large,810.5,132.5,0.5065625,0.11452031114952463,top-center,1851200,0.032985630942091615,Small (1-5%)
00001766.jpg,1600,1157,968,1,1255,230,False,287,229,65723,1.382886776145203,287,229,65723,1.2532751091703056,Very Large,1111.5,115.5,0.6946875,0.09982713915298184,top-right,1851200,0.03550291702679343,Small (1-5%)
00000478.jpg,1023,819,437,135,788,462,False,351,327,114777,1.249084249084249,351,327,114777,1.073394495412844,Very Large,612.5,298.5,0.5987292277614858,0.36446886446886445,middle-center,837837,0.13699204021784667,Medium (5-15%)
00001955.jpg,640,797,98,48,396,480,False,298,432,128736,0.8030112923462986,298,432,128736,0.6898148148148148,Very Large,247.0,264.0,0.3859375,0.3312421580928482,middle-center,510080,0.2523839397741531,Large (15-30%)
00001955.jpg,640,797,338,235,568,568,False,230,333,76590,0.8030112923462986,230,333,76590,0.6906906906906907,Very Large,453.0,401.5,0.7078125,0.5037641154328732,middle-right,510080,0.15015291718946047,Large (15-30%)
00001941.jpg,861,1300,311,43,576,508,False,265,465,123225,0.6623076923076923,265,465,123225,0.5698924731182796,Very Large,443.5,275.5,0.5150987224157956,0.21192307692307694,top-center,1119300,0.11009112838381131,Medium (5-15%)
00001799.jpg,333,519,43,88,217,396,False,174,308,53592,0.6416184971098265,174,308,53592,0.564935064935065,Very Large,130.0,242.0,0.39039039039039036,0.4662813102119461,middle-center,172827,0.31009043725806734,Very Large (>30%)
00001969.jpg,667,1024,259,91,443,412,False,184,321,59064,0.6513671875,184,321,59064,0.573208722741433,Very Large,351.0,251.5,0.5262368815592204,0.24560546875,top-center,683008,0.08647629310344827,Medium (5-15%)
00002723.jpg,1000,1500,231,175,641,874,False,410,699,286590,0.6666666666666666,410,699,286590,0.586552217453505,Very Large,436.0,524.5,0.436,0.3496666666666667,middle-center,1500000,0.19106,Large (15-30%)
00000652.jpg,920,634,482,66,593,155,False,111,89,9879,1.4511041009463723,111,89,9879,1.247191011235955,Medium,537.5,110.5,0.5842391304347826,0.17429022082018927,top-center,583280,0.01693697709504869,Small (1-5%)
00000652.jpg,920,634,177,68,292,158,False,115,90,10350,1.4511041009463723,115,90,10350,1.2777777777777777,Medium,234.5,113.0,0.2548913043478261,0.17823343848580442,top-left,583280,0.01774447949526814,Small (1-5%)
00000652.jpg,920,634,402,128,487,195,False,85,67,5695,1.4511041009463723,85,67,5695,1.2686567164179106,Medium,444.5,161.5,0.4831521739130435,0.2547318611987382,top-center,583280,0.009763749828555754,Tiny (<1%)
00002045.jpg,1500,1000,1191,257,1497,559,False,306,302,92412,1.5,306,302,92412,1.0132450331125828,Very Large,1344.0,408.0,0.896,0.408,middle-right,1500000,0.061608,Medium (5-15%)
00002045.jpg,1500,1000,231,51,398,183,False,167,132,22044,1.5,167,132,22044,1.2651515151515151,Large,314.5,117.0,0.20966666666666667,0.117,top-left,1500000,0.014696,Small (1-5%)
00002045.jpg,1500,1000,105,133,265,257,False,160,124,19840,1.5,160,124,19840,1.2903225806451613,Medium,185.0,195.0,0.12333333333333334,0.195,top-left,1500000,0.013226666666666666,Small (1-5%)
00002045.jpg,1500,1000,500,97,663,224,False,163,127,20701,1.5,163,127,20701,1.2834645669291338,Large,581.5,160.5,0.38766666666666666,0.1605,top-center,1500000,0.013800666666666666,Small (1-5%)
00002045.jpg,1500,1000,490,394,680,542,False,190,148,28120,1.5,190,148,28120,1.2837837837837838,Large,585.0,468.0,0.39,0.468,middle-center,1500000,0.018746666666666665,Small (1-5%)
00002045.jpg,1500,1000,317,358,477,482,False,160,124,19840,1.5,160,124,19840,1.2903225806451613,Medium,397.0,420.0,0.26466666666666666,0.42,middle-left,1500000,0.013226666666666666,Small (1-5%)
00002051.jpg,345,520,149,66,207,167,False,58,101,5858,0.6634615384615384,58,101,5858,0.5742574257425742,Medium,178.0,116.5,0.5159420289855072,0.22403846153846155,top-center,179400,0.03265328874024526,Small (1-5%)
00001558.jpg,500,333,285,16,404,108,False,119,92,10948,1.5015015015015014,119,92,10948,1.2934782608695652,Medium,344.5,62.0,0.689,0.18618618618618618,top-right,166500,0.06575375375375375,Medium (5-15%)
00000120.jpg,736,1104,344,234,448,420,False,104,186,19344,0.6666666666666666,104,186,19344,0.5591397849462365,Medium,396.0,327.0,0.5380434782608695,0.296195652173913,top-center,812544,0.023806710775047257,Small (1-5%)
00003429.jpg,300,450,67,16,129,124,False,62,108,6696,0.6666666666666666,62,108,6696,0.5740740740740741,Medium,98.0,70.0,0.32666666666666666,0.15555555555555556,top-left,135000,0.0496,Small (1-5%)
00003429.jpg,300,450,146,15,203,116,False,57,101,5757,0.6666666666666666,57,101,5757,0.5643564356435643,Medium,174.5,65.5,0.5816666666666667,0.14555555555555555,top-center,135000,0.04264444444444444,Small (1-5%)
00002737.jpg,1800,1200,1461,536,1727,742,False,266,206,54796,1.5,266,206,54796,1.2912621359223302,Very Large,1594.0,639.0,0.8855555555555555,0.5325,middle-right,2160000,0.02536851851851852,Small (1-5%)
00002737.jpg,1800,1200,488,491,693,650,False,205,159,32595,1.5,205,159,32595,1.2893081761006289,Large,590.5,570.5,0.32805555555555554,0.47541666666666665,middle-left,2160000,0.015090277777777777,Small (1-5%)
00002737.jpg,1800,1200,671,333,881,495,False,210,162,34020,1.5,210,162,34020,1.2962962962962963,Large,776.0,414.0,0.4311111111111111,0.345,middle-center,2160000,0.01575,Small (1-5%)
00001216.jpg,236,354,101,3,158,97,False,57,94,5358,0.6666666666666666,57,94,5358,0.6063829787234043,Medium,129.5,50.0,0.548728813559322,0.14124293785310735,top-center,83544,0.06413386957770756,Medium (5-15%)
00001570.jpg,590,393,298,100,370,156,False,72,56,4032,1.5012722646310432,72,56,4032,1.2857142857142858,Small,334.0,128.0,0.5661016949152542,0.3256997455470738,top-center,231870,0.017389054211411566,Small (1-5%)
00001564.jpg,866,1390,327,83,599,580,False,272,497,135184,0.6230215827338129,272,497,135184,0.5472837022132797,Very Large,463.0,331.5,0.5346420323325635,0.23848920863309353,top-center,1203740,0.11230332131523418,Medium (5-15%)
00002938.jpg,550,309,21,29,278,205,False,257,176,45232,1.779935275080906,257,176,45232,1.4602272727272727,Large,149.5,117.0,0.2718181818181818,0.3786407766990291,middle-left,169950,0.26614886731391585,Large (15-30%)
00002938.jpg,550,309,251,1,424,110,False,173,109,18857,1.779935275080906,173,109,18857,1.5871559633027523,Medium,337.5,55.5,0.6136363636363636,0.1796116504854369,top-center,169950,0.1109561635775228,Medium (5-15%)
00002938.jpg,550,309,239,89,381,182,False,142,93,13206,1.779935275080906,142,93,13206,1.5268817204301075,Medium,310.0,135.5,0.5636363636363636,0.43851132686084143,middle-center,169950,0.07770520741394528,Medium (5-15%)
00002938.jpg,550,309,412,40,548,215,False,136,175,23800,1.779935275080906,136,175,23800,0.7771428571428571,Large,480.0,127.5,0.8727272727272727,0.41262135922330095,middle-right,169950,0.1400411885848779,Medium (5-15%)
00002086.jpg,300,450,46,21,171,240,False,125,219,27375,0.6666666666666666,125,219,27375,0.5707762557077626,Large,108.5,130.5,0.3616666666666667,0.29,top-center,135000,0.20277777777777778,Large (15-30%)
00000849.jpg,636,1024,296,36,375,184,False,79,148,11692,0.62109375,79,148,11692,0.5337837837837838,Medium,335.5,110.0,0.5275157232704403,0.107421875,top-center,651264,0.01795278105345912,Small (1-5%)
00002092.jpg,626,418,374,35,540,163,False,166,128,21248,1.4976076555023923,166,128,21248,1.296875,Large,457.0,99.0,0.7300319488817891,0.23684210526315788,top-right,261668,0.08120213400186496,Medium (5-15%)
00002904.jpg,2048,1365,965,371,1402,710,False,437,339,148143,1.5003663003663004,437,339,148143,1.289085545722714,Very Large,1183.5,540.5,0.577880859375,0.39597069597069595,middle-center,2795520,0.05299300309065934,Medium (5-15%)
00000875.jpg,800,582,513,153,711,321,False,198,168,33264,1.3745704467353952,198,168,33264,1.1785714285714286,Large,612.0,237.0,0.765,0.4072164948453608,middle-right,465600,0.07144329896907216,Medium (5-15%)
00002910.jpg,480,320,120,195,191,250,False,71,55,3905,1.5,71,55,3905,1.290909090909091,Small,155.5,222.5,0.32395833333333335,0.6953125,bottom-left,153600,0.025423177083333335,Small (1-5%)
00002910.jpg,480,320,187,116,277,185,False,90,69,6210,1.5,90,69,6210,1.3043478260869565,Medium,232.0,150.5,0.48333333333333334,0.4703125,middle-center,153600,0.0404296875,Small (1-5%)
00002910.jpg,480,320,268,160,338,214,False,70,54,3780,1.5,70,54,3780,1.2962962962962963,Small,303.0,187.0,0.63125,0.584375,middle-center,153600,0.024609375,Small (1-5%)
00002910.jpg,480,320,200,37,260,83,False,60,46,2760,1.5,60,46,2760,1.3043478260869565,Small,230.0,60.0,0.4791666666666667,0.1875,top-center,153600,0.01796875,Small (1-5%)
00002657.jpg,236,354,93,45,169,177,False,76,132,10032,0.6666666666666666,76,132,10032,0.5757575757575758,Medium,131.0,111.0,0.5550847457627118,0.3135593220338983,top-center,83544,0.1200804366561333,Medium (5-15%)
00001438.jpg,640,960,132,127,291,403,False,159,276,43884,0.6666666666666666,159,276,43884,0.5760869565217391,Large,211.5,265.0,0.33046875,0.2760416666666667,top-center,614400,0.07142578125,Medium (5-15%)
00000726.jpg,1300,956,533,39,811,271,False,278,232,64496,1.3598326359832635,278,232,64496,1.1982758620689655,Very Large,672.0,155.0,0.5169230769230769,0.16213389121338911,top-center,1242800,0.051895719343418086,Medium (5-15%)
00000726.jpg,1300,956,229,315,545,586,False,316,271,85636,1.3598326359832635,316,271,85636,1.1660516605166051,Very Large,387.0,450.5,0.2976923076923077,0.47123430962343094,middle-left,1242800,0.06890569681364661,Medium (5-15%)
00000726.jpg,1300,956,483,309,779,563,False,296,254,75184,1.3598326359832635,296,254,75184,1.1653543307086613,Very Large,631.0,436.0,0.48538461538461536,0.4560669456066946,middle-center,1242800,0.06049565497264242,Medium (5-15%)
00000726.jpg,1300,956,618,512,927,771,False,309,259,80031,1.3598326359832635,309,259,80031,1.193050193050193,Very Large,772.5,641.5,0.5942307692307692,0.6710251046025104,bottom-center,1242800,0.06439571934341809,Medium (5-15%)
00000726.jpg,1300,956,750,329,1086,617,False,336,288,96768,1.3598326359832635,336,288,96768,1.1666666666666667,Very Large,918.0,473.0,0.7061538461538461,0.49476987447698745,middle-right,1242800,0.07786289024782748,Medium (5-15%)
00000726.jpg,1300,956,728,166,924,334,False,196,168,32928,1.3598326359832635,196,168,32928,1.1666666666666667,Large,826.0,250.0,0.6353846153846154,0.2615062761506276,top-center,1242800,0.02649501126488574,Small (1-5%)
00002131.jpg,684,1024,189,121,488,641,False,299,520,155480,0.66796875,299,520,155480,0.575,Very Large,338.5,381.0,0.49488304093567254,0.3720703125,middle-center,700416,0.22198236476608188,Large (15-30%)
00002125.jpg,1000,666,245,1,682,325,False,437,324,141588,1.5015015015015014,437,324,141588,1.3487654320987654,Very Large,463.5,163.0,0.4635,0.24474474474474475,top-center,666000,0.2125945945945946,Large (15-30%)
00002643.jpg,681,1024,295,211,434,454,False,139,243,33777,0.6650390625,139,243,33777,0.5720164609053497,Large,364.5,332.5,0.5352422907488987,0.32470703125,top-center,697344,0.048436639592511016,Small (1-5%)
00003213.jpg,626,417,299,47,439,155,False,140,108,15120,1.501199040767386,140,108,15120,1.2962962962962963,Medium,369.0,101.0,0.5894568690095847,0.2422062350119904,top-center,261042,0.05792171374721309,Medium (5-15%)
00001404.jpg,600,900,213,88,284,212,False,71,124,8804,0.6666666666666666,71,124,8804,0.5725806451612904,Medium,248.5,150.0,0.4141666666666667,0.16666666666666666,top-center,540000,0.016303703703703702,Small (1-5%)
00001410.jpg,1000,1250,385,437,589,734,False,204,297,60588,0.8,204,297,60588,0.6868686868686869,Very Large,487.0,585.5,0.487,0.4684,middle-center,1250000,0.0484704,Small (1-5%)
00002119.jpg,1500,1120,530,1,1001,402,False,471,401,188871,1.3392857142857142,471,401,188871,1.174563591022444,Very Large,765.5,201.5,0.5103333333333333,0.17991071428571428,top-center,1680000,0.11242321428571428,Medium (5-15%)
00000068.jpg,1177,1175,521,67,668,233,False,147,166,24402,1.0017021276595746,147,166,24402,0.8855421686746988,Large,594.5,150.0,0.5050977060322854,0.1276595744680851,top-center,1382975,0.017644570581536182,Small (1-5%)
00000068.jpg,1177,1175,964,46,1104,206,False,140,160,22400,1.0017021276595746,140,160,22400,0.875,Large,1034.0,126.0,0.8785046728971962,0.1072340425531915,top-right,1382975,0.016196966684141074,Small (1-5%)
00000068.jpg,1177,1175,491,494,669,700,False,178,206,36668,1.0017021276595746,178,206,36668,0.8640776699029126,Large,580.0,597.0,0.4927782497875956,0.5080851063829788,middle-center,1382975,0.026513855998843074,Small (1-5%)
00001376.jpg,400,620,107,126,191,276,False,84,150,12600,0.6451612903225806,84,150,12600,0.56,Medium,149.0,201.0,0.3725,0.3241935483870968,top-center,248000,0.050806451612903224,Medium (5-15%)
00002858.jpg,525,315,168,31,423,209,False,255,178,45390,1.6666666666666667,255,178,45390,1.4325842696629214,Large,295.5,120.0,0.5628571428571428,0.38095238095238093,middle-center,165375,0.2744671201814059,Large (15-30%)
00002680.jpg,2500,1831,409,519,919,954,False,510,435,221850,1.3653741125068268,510,435,221850,1.1724137931034482,Very Large,664.0,736.5,0.2656,0.4022392135445112,middle-left,4577500,0.04846531949754233,Small (1-5%)
00001389.jpg,736,863,242,41,600,530,False,358,489,175062,0.8528389339513326,358,489,175062,0.7321063394683026,Very Large,421.0,285.5,0.5720108695652174,0.3308227114716107,middle-center,635168,0.27561527029069477,Large (15-30%)
00000097.jpg,4256,2832,2214,752,2962,1331,False,748,579,433092,1.502824858757062,748,579,433092,1.2918825561312608,Very Large,2588.0,1041.5,0.6080827067669173,0.3677612994350282,middle-center,12052992,0.035932322862240344,Small (1-5%)
00000901.jpg,866,1390,553,251,638,409,False,85,158,13430,0.6230215827338129,85,158,13430,0.5379746835443038,Medium,595.5,330.0,0.6876443418013857,0.23741007194244604,top-right,1203740,0.011156894345955107,Small (1-5%)
00000524.jpg,970,714,553,108,774,297,False,221,189,41769,1.3585434173669468,221,189,41769,1.1693121693121693,Large,663.5,202.5,0.684020618556701,0.28361344537815125,top-right,692580,0.060309278350515465,Medium (5-15%)
00000524.jpg,970,714,210,274,381,420,False,171,146,24966,1.3585434173669468,171,146,24966,1.1712328767123288,Large,295.5,347.0,0.30463917525773193,0.48599439775910364,middle-left,692580,0.0360478211903318,Small (1-5%)
00000524.jpg,970,714,403,270,573,416,False,170,146,24820,1.3585434173669468,170,146,24820,1.1643835616438356,Large,488.0,343.0,0.5030927835051546,0.4803921568627451,middle-center,692580,0.035837015218458515,Small (1-5%)
00002441.jpg,4256,2832,779,484,1769,1235,False,990,751,743490,1.502824858757062,990,751,743490,1.3182423435419441,Very Large,1274.0,859.5,0.2993421052631579,0.3034957627118644,top-left,12052992,0.061685098604562255,Medium (5-15%)
00001148.jpg,1331,2000,476,613,754,1099,False,278,486,135108,0.6655,278,486,135108,0.5720164609053497,Very Large,615.0,856.0,0.46205860255447034,0.428,middle-center,2662000,0.05075432006010518,Medium (5-15%)
00000256.jpg,1300,956,342,160,538,328,False,196,168,32928,1.3598326359832635,196,168,32928,1.1666666666666667,Large,440.0,244.0,0.3384615384615385,0.25523012552301255,top-center,1242800,0.02649501126488574,Small (1-5%)
00000256.jpg,1300,956,708,84,936,279,False,228,195,44460,1.3598326359832635,228,195,44460,1.1692307692307693,Large,822.0,181.5,0.6323076923076923,0.18985355648535565,top-center,1242800,0.03577405857740586,Small (1-5%)
00000530.jpg,1300,866,534,342,752,512,False,218,170,37060,1.5011547344110854,218,170,37060,1.2823529411764707,Large,643.0,427.0,0.4946153846153846,0.4930715935334873,middle-center,1125800,0.0329188132883283,Small (1-5%)
00000530.jpg,1300,866,332,313,556,486,False,224,173,38752,1.5011547344110854,224,173,38752,1.2947976878612717,Large,444.0,399.5,0.3415384615384615,0.46131639722863743,middle-center,1125800,0.034421744537217976,Small (1-5%)
00000530.jpg,1300,866,777,130,1037,327,False,260,197,51220,1.5011547344110854,260,197,51220,1.3197969543147208,Very Large,907.0,228.5,0.6976923076923077,0.26385681293302543,top-right,1125800,0.04549653579676674,Small (1-5%)
00000530.jpg,1300,866,655,283,899,468,False,244,185,45140,1.5011547344110854,244,185,45140,1.318918918918919,Large,777.0,375.5,0.5976923076923077,0.4336027713625866,middle-center,1125800,0.04009593178184402,Small (1-5%)
00003039.jpg,509,339,302,28,497,183,False,195,155,30225,1.5014749262536873,195,155,30225,1.2580645161290323,Large,399.5,105.5,0.7848722986247544,0.3112094395280236,top-right,172551,0.17516560321296312,Large (15-30%)
00003039.jpg,509,339,257,43,427,175,False,170,132,22440,1.5014749262536873,170,132,22440,1.2878787878787878,Large,342.0,109.0,0.6719056974459725,0.3215339233038348,top-right,172551,0.13004850739781282,Medium (5-15%)
00000518.jpg,400,211,87,93,198,159,False,111,66,7326,1.8957345971563981,111,66,7326,1.6818181818181819,Medium,142.5,126.0,0.35625,0.5971563981042654,middle-center,84400,0.08680094786729858,Medium (5-15%)
00001606.jpg,867,1300,379,155,478,327,False,99,172,17028,0.666923076923077,99,172,17028,0.5755813953488372,Medium,428.5,241.0,0.4942329873125721,0.1853846153846154,top-center,1127100,0.015107798775618846,Small (1-5%)
00001821.jpg,1024,683,238,18,707,383,False,469,365,171185,1.499267935578331,469,365,171185,1.284931506849315,Very Large,472.5,200.5,0.46142578125,0.2935578330893119,top-center,699392,0.24476259379575402,Large (15-30%)
00002496.jpg,956,1280,423,374,521,527,False,98,153,14994,0.746875,98,153,14994,0.6405228758169934,Medium,472.0,450.5,0.49372384937238495,0.351953125,middle-center,1223680,0.012253203451882844,Small (1-5%)
00000281.jpg,2832,4256,1236,1109,1867,2213,False,631,1104,696624,0.6654135338345865,631,1104,696624,0.5715579710144928,Very Large,1551.5,1661.0,0.5478460451977402,0.39027255639097747,middle-center,12052992,0.05779676946603798,Medium (5-15%)
00002482.jpg,1000,774,577,258,704,372,False,127,114,14478,1.2919896640826873,127,114,14478,1.1140350877192982,Medium,640.5,315.0,0.6405,0.4069767441860465,middle-center,774000,0.018705426356589148,Small (1-5%)
00002482.jpg,1000,774,791,353,900,452,False,109,99,10791,1.2919896640826873,109,99,10791,1.101010101010101,Medium,845.5,402.5,0.8455,0.5200258397932817,middle-right,774000,0.01394186046511628,Small (1-5%)
00001835.jpg,590,393,33,84,196,211,False,163,127,20701,1.5012722646310432,163,127,20701,1.2834645669291338,Large,114.5,147.5,0.19406779661016949,0.3753180661577608,middle-left,231870,0.08927847500754733,Medium (5-15%)
00001809.jpg,800,533,107,41,593,418,False,486,377,183222,1.5009380863039399,486,377,183222,1.2891246684350133,Very Large,350.0,229.5,0.4375,0.43058161350844276,middle-center,426400,0.4296951219512195,Very Large (>30%)
00001808.jpg,590,393,255,4,590,342,False,335,338,113230,1.5012722646310432,335,338,113230,0.9911242603550295,Very Large,422.5,173.0,0.7161016949152542,0.4402035623409669,middle-right,231870,0.48833398024755253,Very Large (>30%)
00002483.jpg,750,500,174,55,315,162,False,141,107,15087,1.5,141,107,15087,1.3177570093457944,Medium,244.5,108.5,0.326,0.217,top-left,375000,0.040232,Small (1-5%)
00001834.jpg,683,1024,228,95,310,236,False,82,141,11562,0.6669921875,82,141,11562,0.5815602836879432,Medium,269.0,165.5,0.3938506588579795,0.16162109375,top-center,699392,0.01653150164714495,Small (1-5%)
00001820.jpg,1300,950,481,24,899,378,False,418,354,147972,1.368421052631579,418,354,147972,1.1807909604519775,Very Large,690.0,201.0,0.5307692307692308,0.21157894736842106,top-center,1235000,0.11981538461538462,Medium (5-15%)
00000280.jpg,1000,667,132,155,390,351,False,258,196,50568,1.4992503748125936,258,196,50568,1.316326530612245,Very Large,261.0,253.0,0.261,0.3793103448275862,middle-left,667000,0.07581409295352323,Medium (5-15%)
00000280.jpg,1000,667,655,144,950,372,False,295,228,67260,1.4992503748125936,295,228,67260,1.293859649122807,Very Large,802.5,258.0,0.8025,0.3868065967016492,middle-right,667000,0.10083958020989506,Medium (5-15%)
00000280.jpg,1000,667,88,416,396,654,False,308,238,73304,1.4992503748125936,308,238,73304,1.2941176470588236,Very Large,242.0,535.0,0.242,0.8020989505247377,bottom-left,667000,0.10990104947526237,Medium (5-15%)
00000280.jpg,1000,667,443,116,725,335,False,282,219,61758,1.4992503748125936,282,219,61758,1.2876712328767124,Very Large,584.0,225.5,0.584,0.33808095952023987,middle-center,667000,0.09259070464767616,Medium (5-15%)
00000280.jpg,1000,667,1,198,227,437,False,226,239,54014,1.4992503748125936,226,239,54014,0.9456066945606695,Very Large,114.0,317.5,0.114,0.4760119940029985,middle-left,667000,0.08098050974512744,Medium (5-15%)
00002497.jpg,400,264,205,34,358,152,False,153,118,18054,1.5151515151515151,153,118,18054,1.2966101694915255,Medium,281.5,93.0,0.70375,0.3522727272727273,middle-right,105600,0.17096590909090909,Large (15-30%)
00001175.jpg,600,420,225,34,391,169,False,166,135,22410,1.4285714285714286,166,135,22410,1.2296296296296296,Large,308.0,101.5,0.5133333333333333,0.24166666666666667,top-center,252000,0.08892857142857143,Medium (5-15%)
00001613.jpg,736,736,259,123,434,327,False,175,204,35700,1.0,175,204,35700,0.8578431372549019,Large,346.5,225.0,0.47078804347826086,0.30570652173913043,top-center,541696,0.06590412334593573,Medium (5-15%)
00003004.jpg,800,800,214,261,430,512,False,216,251,54216,1.0,216,251,54216,0.8605577689243028,Very Large,322.0,386.5,0.4025,0.483125,middle-center,640000,0.0847125,Medium (5-15%)
00003010.jpg,382,287,16,1,381,286,False,365,285,104025,1.3310104529616724,365,285,104025,1.280701754385965,Very Large,198.5,143.5,0.5196335078534031,0.5,middle-center,109634,0.948838863856103,Very Large (>30%)
00001607.jpg,2410,3679,1142,1140,1393,1587,False,251,447,112197,0.6550693123131286,251,447,112197,0.5615212527964206,Very Large,1267.5,1363.5,0.5259336099585062,0.3706170154933406,middle-center,8866390,0.012654191841324372,Small (1-5%)
00000519.jpg,1000,667,220,57,579,336,False,359,279,100161,1.4992503748125936,359,279,100161,1.2867383512544803,Very Large,399.5,196.5,0.3995,0.2946026986506747,top-center,667000,0.1501664167916042,Large (15-30%)
00000519.jpg,1000,667,357,112,724,397,False,367,285,104595,1.4992503748125936,367,285,104595,1.287719298245614,Very Large,540.5,254.5,0.5405,0.3815592203898051,middle-center,667000,0.15681409295352325,Large (15-30%)
00000519.jpg,1000,667,750,109,1000,377,False,250,268,67000,1.4992503748125936,250,268,67000,0.9328358208955224,Very Large,875.0,243.0,0.875,0.36431784107946025,middle-right,667000,0.10044977511244378,Medium (5-15%)
00000519.jpg,1000,667,4,71,318,408,False,314,337,105818,1.4992503748125936,314,337,105818,0.9317507418397626,Very Large,161.0,239.5,0.161,0.35907046476761617,middle-left,667000,0.15864767616191905,Large (15-30%)
00001161.jpg,332,519,61,3,242,325,False,181,322,58282,0.6396917148362236,181,322,58282,0.562111801242236,Very Large,151.5,164.0,0.4563253012048193,0.3159922928709056,top-center,172308,0.33824314599438216,Very Large (>30%)
00002468.jpg,980,654,75,23,645,457,False,570,434,247380,1.4984709480122325,570,434,247380,1.3133640552995391,Very Large,360.0,240.0,0.3673469387755102,0.3669724770642202,middle-center,640920,0.3859764089121887,Very Large (>30%)
00001149.jpg,1257,1300,524,171,731,421,False,207,250,51750,0.9669230769230769,207,250,51750,0.828,Very Large,627.5,296.0,0.4992044550517104,0.2276923076923077,top-center,1634100,0.031668808518450525,Small (1-5%)
00002440.jpg,338,450,240,107,277,165,False,37,58,2146,0.7511111111111111,37,58,2146,0.6379310344827587,Small,258.5,136.0,0.764792899408284,0.3022222222222222,top-right,152100,0.014109138724523339,Small (1-5%)
00002440.jpg,338,450,159,130,193,181,False,34,51,1734,0.7511111111111111,34,51,1734,0.6666666666666666,Small,176.0,155.5,0.5207100591715976,0.34555555555555556,middle-center,152100,0.011400394477317555,Small (1-5%)
00003038.jpg,612,407,324,72,470,187,False,146,115,16790,1.5036855036855037,146,115,16790,1.2695652173913043,Medium,397.0,129.5,0.6486928104575164,0.3181818181818182,top-center,249084,0.06740697917168506,Medium (5-15%)
00003038.jpg,612,407,33,86,182,201,False,149,115,17135,1.5036855036855037,149,115,17135,1.2956521739130435,Medium,107.5,143.5,0.17565359477124182,0.3525798525798526,middle-left,249084,0.06879205408617173,Medium (5-15%)
00002326.jpg,474,640,133,99,289,343,False,156,244,38064,0.740625,156,244,38064,0.639344262295082,Large,211.0,221.0,0.4451476793248945,0.3453125,middle-center,303360,0.1254746835443038,Medium (5-15%)
00000525.jpg,612,416,33,122,175,233,False,142,111,15762,1.4711538461538463,142,111,15762,1.2792792792792793,Medium,104.0,177.5,0.16993464052287582,0.4266826923076923,middle-left,254592,0.06191082202111614,Medium (5-15%)
00000525.jpg,612,416,417,126,545,227,False,128,101,12928,1.4711538461538463,128,101,12928,1.2673267326732673,Medium,481.0,176.5,0.7859477124183006,0.42427884615384615,middle-right,254592,0.05077928607340372,Medium (5-15%)
00000525.jpg,612,416,264,93,374,179,False,110,86,9460,1.4711538461538463,110,86,9460,1.2790697674418605,Medium,319.0,136.0,0.5212418300653595,0.3269230769230769,top-center,254592,0.03715749120160885,Small (1-5%)
00002454.jpg,500,750,186,63,316,288,False,130,225,29250,0.6666666666666666,130,225,29250,0.5777777777777777,Large,251.0,175.5,0.502,0.234,top-center,375000,0.078,Medium (5-15%)
00000243.jpg,870,580,384,62,624,249,False,240,187,44880,1.5,240,187,44880,1.2834224598930482,Large,504.0,155.5,0.5793103448275863,0.2681034482758621,top-center,504600,0.08894173602853746,Medium (5-15%)
00002871.jpg,858,1390,226,247,325,435,False,99,188,18612,0.6172661870503597,99,188,18612,0.526595744680851,Medium,275.5,341.0,0.3210955710955711,0.24532374100719426,top-left,1192620,0.015605976757055894,Small (1-5%)
00002871.jpg,858,1390,475,612,582,813,False,107,201,21507,0.6172661870503597,107,201,21507,0.5323383084577115,Large,528.5,712.5,0.615967365967366,0.512589928057554,middle-center,1192620,0.018033405443477386,Small (1-5%)
00000900.jpg,590,393,247,47,365,138,False,118,91,10738,1.5012722646310432,118,91,10738,1.2967032967032968,Medium,306.0,92.5,0.5186440677966102,0.23536895674300254,top-center,231870,0.04631043256997455,Small (1-5%)
00000928.jpg,333,519,131,76,193,189,False,62,113,7006,0.6416184971098265,62,113,7006,0.5486725663716814,Medium,162.0,132.5,0.4864864864864865,0.25529865125240847,top-center,172827,0.04053764747406366,Small (1-5%)
00001388.jpg,800,630,167,72,459,334,False,292,262,76504,1.2698412698412698,292,262,76504,1.1145038167938932,Very Large,313.0,203.0,0.39125,0.32222222222222224,top-center,504000,0.1517936507936508,Large (15-30%)
00002681.jpg,236,354,139,76,174,137,False,35,61,2135,0.6666666666666666,35,61,2135,0.5737704918032787,Small,156.5,106.5,0.663135593220339,0.3008474576271186,top-center,83544,0.025555395959015608,Small (1-5%)
00000082.jpg,1150,1680,454,516,758,1033,False,304,517,157168,0.6845238095238095,304,517,157168,0.5880077369439072,Very Large,606.0,774.5,0.5269565217391304,0.4610119047619048,middle-center,1932000,0.08134989648033127,Medium (5-15%)
00002118.jpg,1200,799,134,128,817,658,False,683,530,361990,1.5018773466833542,683,530,361990,1.288679245283019,Very Large,475.5,393.0,0.39625,0.4918648310387985,middle-center,958800,0.3775448477263246,Very Large (>30%)
00003206.jpg,600,400,212,94,299,162,False,87,68,5916,1.5,87,68,5916,1.2794117647058822,Medium,255.5,128.0,0.42583333333333334,0.32,top-center,240000,0.02465,Small (1-5%)
00003206.jpg,600,400,310,87,401,156,False,91,69,6279,1.5,91,69,6279,1.318840579710145,Medium,355.5,121.5,0.5925,0.30375,top-center,240000,0.0261625,Small (1-5%)
00003206.jpg,600,400,408,104,497,172,False,89,68,6052,1.5,89,68,6052,1.3088235294117647,Medium,452.5,138.0,0.7541666666666667,0.345,middle-right,240000,0.025216666666666665,Small (1-5%)
00001411.jpg,612,329,267,79,483,213,False,216,134,28944,1.8601823708206686,216,134,28944,1.6119402985074627,Large,375.0,146.0,0.6127450980392157,0.44376899696048633,middle-center,201348,0.1437511174682639,Medium (5-15%)
00001377.jpg,683,1024,253,27,405,293,False,152,266,40432,0.6669921875,152,266,40432,0.5714285714285714,Large,329.0,160.0,0.4816983894582723,0.15625,top-center,699392,0.05781021229868229,Medium (5-15%)
00000069.jpg,1000,1500,399,909,515,1112,False,116,203,23548,0.6666666666666666,116,203,23548,0.5714285714285714,Large,457.0,1010.5,0.457,0.6736666666666666,bottom-center,1500000,0.015698666666666666,Small (1-5%)
00001363.jpg,1024,768,427,58,607,215,False,180,157,28260,1.3333333333333333,180,157,28260,1.1464968152866242,Large,517.0,136.5,0.5048828125,0.177734375,top-center,786432,0.0359344482421875,Small (1-5%)
00001363.jpg,1024,768,730,182,854,290,False,124,108,13392,1.3333333333333333,124,108,13392,1.1481481481481481,Medium,792.0,236.0,0.7734375,0.3072916666666667,top-right,786432,0.01702880859375,Small (1-5%)
00001363.jpg,1024,768,221,193,332,290,False,111,97,10767,1.3333333333333333,111,97,10767,1.1443298969072164,Medium,276.5,241.5,0.27001953125,0.314453125,top-left,786432,0.013690948486328125,Small (1-5%)
00001405.jpg,318,450,122,134,170,213,False,48,79,3792,0.7066666666666667,48,79,3792,0.6075949367088608,Small,146.0,173.5,0.4591194968553459,0.38555555555555554,middle-center,143100,0.02649895178197065,Small (1-5%)
00003212.jpg,800,800,259,278,518,579,False,259,301,77959,1.0,259,301,77959,0.8604651162790697,Very Large,388.5,428.5,0.485625,0.535625,middle-center,640000,0.1218109375,Medium (5-15%)
00002124.jpg,1300,956,563,69,1228,638,False,665,569,378385,1.3598326359832635,665,569,378385,1.1687170474516695,Very Large,895.5,353.5,0.6888461538461539,0.36976987447698745,middle-right,1242800,0.3044616993884776,Very Large (>30%)
00000055.jpg,750,1050,343,1,451,160,False,108,159,17172,0.7142857142857143,108,159,17172,0.6792452830188679,Medium,397.0,80.5,0.5293333333333333,0.07666666666666666,top-center,787500,0.021805714285714286,Small (1-5%)
00000041.jpg,1024,683,244,20,768,426,False,524,406,212744,1.499267935578331,524,406,212744,1.29064039408867,Very Large,506.0,223.0,0.494140625,0.32650073206442165,top-center,699392,0.30418420571010246,Very Large (>30%)
00002130.jpg,2000,1334,774,195,1350,642,False,576,447,257472,1.4992503748125936,576,447,257472,1.2885906040268456,Very Large,1062.0,418.5,0.531,0.3137181409295352,top-center,2668000,0.09650374812593703,Medium (5-15%)
00001439.jpg,333,519,129,103,185,204,False,56,101,5656,0.6416184971098265,56,101,5656,0.5544554455445545,Medium,157.0,153.5,0.47147147147147145,0.2957610789980732,top-center,172827,0.032726367986483595,Small (1-5%)
00000860.jpg,1500,1120,644,54,880,259,False,236,205,48380,1.3392857142857142,236,205,48380,1.1512195121951219,Large,762.0,156.5,0.508,0.13973214285714286,top-center,1680000,0.028797619047619048,Small (1-5%)
00002911.jpg,1600,1167,183,90,1069,842,False,886,752,666272,1.3710368466152527,886,752,666272,1.178191489361702,Very Large,626.0,466.0,0.39125,0.39931448157669236,middle-center,1867200,0.3568294772922022,Very Large (>30%)
00000874.jpg,866,1300,294,1,467,284,False,173,283,48959,0.6661538461538462,173,283,48959,0.6113074204946997,Large,380.5,142.5,0.43937644341801385,0.10961538461538461,top-center,1125800,0.04348818617871736,Small (1-5%)
00000684.jpg,1030,580,312,20,622,228,False,310,208,64480,1.7758620689655173,310,208,64480,1.4903846153846154,Very Large,467.0,124.0,0.4533980582524272,0.21379310344827587,top-center,597400,0.10793438232340141,Medium (5-15%)
00002939.jpg,566,850,262,153,330,271,False,68,118,8024,0.6658823529411765,68,118,8024,0.576271186440678,Medium,296.0,212.0,0.5229681978798587,0.24941176470588236,top-center,481100,0.01667844522968198,Small (1-5%)
00000848.jpg,1500,1000,509,122,897,423,False,388,301,116788,1.5,388,301,116788,1.2890365448504983,Very Large,703.0,272.5,0.4686666666666667,0.2725,top-center,1500000,0.07785866666666667,Medium (5-15%)
00002087.jpg,1300,956,225,32,1106,770,False,881,738,650178,1.3598326359832635,881,738,650178,1.1937669376693767,Very Large,665.5,401.0,0.5119230769230769,0.4194560669456067,middle-center,1242800,0.5231557772771162,Very Large (>30%)
00003399.jpg,390,280,142,61,243,145,False,101,84,8484,1.3928571428571428,101,84,8484,1.2023809523809523,Medium,192.5,103.0,0.4935897435897436,0.3678571428571429,middle-center,109200,0.07769230769230769,Medium (5-15%)
00003372.jpg,408,612,151,266,203,356,False,52,90,4680,0.6666666666666666,52,90,4680,0.5777777777777777,Small,177.0,311.0,0.4338235294117647,0.5081699346405228,middle-center,249696,0.018742791234140715,Small (1-5%)
00001203.jpg,333,519,158,68,223,187,False,65,119,7735,0.6416184971098265,65,119,7735,0.5462184873949579,Medium,190.5,127.5,0.5720720720720721,0.24566473988439305,top-center,172827,0.044755738397356894,Small (1-5%)
00001571.jpg,2693,3914,880,606,1507,1666,False,627,1060,664620,0.6880429228410833,627,1060,664620,0.5915094339622642,Very Large,1193.5,1136.0,0.44318603787597477,0.29024016351558507,top-center,10540402,0.06305452107044873,Medium (5-15%)
00002736.jpg,640,467,154,61,288,175,False,134,114,15276,1.3704496788008564,134,114,15276,1.1754385964912282,Medium,221.0,118.0,0.3453125,0.25267665952890794,top-center,298880,0.051110813704496785,Medium (5-15%)
00002736.jpg,640,467,355,150,463,243,False,108,93,10044,1.3704496788008564,108,93,10044,1.1612903225806452,Medium,409.0,196.5,0.6390625,0.4207708779443255,middle-center,298880,0.03360546038543897,Small (1-5%)
00002736.jpg,640,467,168,174,296,283,False,128,109,13952,1.3704496788008564,128,109,13952,1.1743119266055047,Medium,232.0,228.5,0.3625,0.4892933618843683,middle-center,298880,0.046680942184154174,Small (1-5%)
00002736.jpg,640,467,233,37,332,121,False,99,84,8316,1.3704496788008564,99,84,8316,1.1785714285714286,Medium,282.5,79.0,0.44140625,0.16916488222698073,top-center,298880,0.027823875802997857,Small (1-5%)
00002736.jpg,640,467,402,110,478,176,False,76,66,5016,1.3704496788008564,76,66,5016,1.1515151515151516,Medium,440.0,143.0,0.6875,0.30620985010706636,top-right,298880,0.016782655246252675,Small (1-5%)
00002736.jpg,640,467,269,114,374,203,False,105,89,9345,1.3704496788008564,105,89,9345,1.1797752808988764,Medium,321.5,158.5,0.50234375,0.33940042826552463,middle-center,298880,0.03126672912205567,Small (1-5%)
00002736.jpg,640,467,495,143,576,212,False,81,69,5589,1.3704496788008564,81,69,5589,1.173913043478261,Medium,535.5,177.5,0.83671875,0.38008565310492504,middle-right,298880,0.018699812633832975,Small (1-5%)
00003428.jpg,1000,1000,295,288,475,497,False,180,209,37620,1.0,180,209,37620,0.861244019138756,Large,385.0,392.5,0.385,0.3925,middle-center,1000000,0.03762,Small (1-5%)
00000135.jpg,3689,5515,1669,1285,2226,2254,False,557,969,539733,0.6689029918404352,557,969,539733,0.5748194014447885,Very Large,1947.5,1769.5,0.5279208457576579,0.32085222121486856,top-center,20344835,0.026529239485107645,Small (1-5%)
00000135.jpg,3689,5515,1022,1365,1533,2253,False,511,888,453768,0.6689029918404352,511,888,453768,0.5754504504504504,Very Large,1277.5,1809.0,0.34629981024667933,0.32801450589301906,top-center,20344835,0.022303842719786127,Small (1-5%)
00002722.jpg,1024,682,298,1,881,428,False,583,427,248941,1.501466275659824,583,427,248941,1.3653395784543325,Very Large,589.5,214.5,0.57568359375,0.31451612903225806,top-center,698368,0.3564610635080645,Very Large (>30%)
00002044.jpg,1300,957,846,98,1015,242,False,169,144,24336,1.3584117032392895,169,144,24336,1.1736111111111112,Large,930.5,170.0,0.7157692307692308,0.17763845350052246,top-right,1244100,0.01956112852664577,Small (1-5%)
00000653.jpg,1040,694,451,113,678,289,False,227,176,39952,1.4985590778097984,227,176,39952,1.2897727272727273,Large,564.5,201.0,0.5427884615384615,0.2896253602305475,top-center,721760,0.05535358013744181,Medium (5-15%)
00000653.jpg,1040,694,147,41,467,289,False,320,248,79360,1.4985590778097984,320,248,79360,1.2903225806451613,Very Large,307.0,165.0,0.2951923076923077,0.2377521613832853,top-left,721760,0.10995344712923964,Medium (5-15%)
00000653.jpg,1040,694,661,167,865,325,False,204,158,32232,1.4985590778097984,204,158,32232,1.2911392405063291,Large,763.0,246.0,0.7336538461538461,0.35446685878962536,middle-right,721760,0.044657503879405896,Small (1-5%)
00001968.jpg,2000,1333,854,259,1183,514,False,329,255,83895,1.5003750937734435,329,255,83895,1.2901960784313726,Very Large,1018.5,386.5,0.50925,0.28994748687171795,top-center,2666000,0.03146849212303076,Small (1-5%)
00001798.jpg,860,1300,315,132,424,324,False,109,192,20928,0.6615384615384615,109,192,20928,0.5677083333333334,Large,369.5,228.0,0.42965116279069765,0.1753846153846154,top-center,1118000,0.018719141323792488,Small (1-5%)
00000486.jpg,402,604,157,67,209,159,False,52,92,4784,0.6655629139072847,52,92,4784,0.5652173913043478,Small,183.0,113.0,0.4552238805970149,0.1870860927152318,top-center,242808,0.01970281045105598,Small (1-5%)
00001940.jpg,626,417,220,39,421,194,False,201,155,31155,1.501199040767386,201,155,31155,1.2967741935483872,Large,320.5,116.5,0.5119808306709265,0.2793764988009592,top-center,261042,0.11934861056841428,Medium (5-15%)
00000492.jpg,1001,1500,383,124,606,513,False,223,389,86747,0.6673333333333333,223,389,86747,0.5732647814910026,Very Large,494.5,318.5,0.494005994005994,0.21233333333333335,top-center,1501500,0.057773559773559774,Medium (5-15%)
00001954.jpg,1473,980,729,107,1348,586,False,619,479,296501,1.5030612244897958,619,479,296501,1.292275574112735,Very Large,1038.5,346.5,0.7050237610319077,0.3535714285714286,middle-right,1443540,0.20539853415908116,Large (15-30%)
00002508.jpg,236,346,59,25,124,136,False,65,111,7215,0.6820809248554913,65,111,7215,0.5855855855855856,Medium,91.5,80.5,0.3877118644067797,0.23265895953757226,top-center,81656,0.08835847947487019,Medium (5-15%)
00001001.jpg,800,582,301,57,487,215,False,186,158,29388,1.3745704467353952,186,158,29388,1.1772151898734178,Large,394.0,136.0,0.4925,0.23367697594501718,top-center,465600,0.06311855670103093,Medium (5-15%)
00000479.jpg,565,321,485,164,565,223,False,80,59,4720,1.7601246105919004,80,59,4720,1.3559322033898304,Small,525.0,193.5,0.9292035398230089,0.602803738317757,middle-right,181365,0.026024866980950016,Small (1-5%)
00001767.jpg,612,408,124,12,480,289,False,356,277,98612,1.5,356,277,98612,1.2851985559566788,Very Large,302.0,150.5,0.4934640522875817,0.36887254901960786,middle-center,249696,0.3949282327310009,Very Large (>30%)
00001773.jpg,683,1024,216,213,472,661,False,256,448,114688,0.6669921875,256,448,114688,0.5714285714285714,Very Large,344.0,437.0,0.5036603221083455,0.4267578125,middle-center,699392,0.16398243045387995,Large (15-30%)
00001015.jpg,333,519,142,36,204,151,False,62,115,7130,0.6416184971098265,62,115,7130,0.5391304347826087,Medium,173.0,93.5,0.5195195195195195,0.18015414258188825,top-center,172827,0.04125512796033027,Small (1-5%)
00000323.jpg,866,1390,367,225,507,485,False,140,260,36400,0.6230215827338129,140,260,36400,0.5384615384615384,Large,437.0,355.0,0.5046189376443418,0.25539568345323743,top-center,1203740,0.030239088175187334,Small (1-5%)
00000445.jpg,973,648,123,199,317,350,False,194,151,29294,1.501543209876543,194,151,29294,1.2847682119205297,Large,220.0,274.5,0.2261048304213772,0.4236111111111111,middle-left,630504,0.046461243703449936,Small (1-5%)
00000445.jpg,973,648,564,278,821,478,False,257,200,51400,1.501543209876543,257,200,51400,1.285,Very Large,692.5,378.0,0.7117163412127441,0.5833333333333334,middle-right,630504,0.08152208392016545,Medium (5-15%)
00000445.jpg,973,648,615,93,866,288,False,251,195,48945,1.501543209876543,251,195,48945,1.2871794871794873,Large,740.5,190.5,0.7610483042137718,0.29398148148148145,top-right,630504,0.07762837349168285,Medium (5-15%)
00000445.jpg,973,648,261,119,507,314,False,246,195,47970,1.501543209876543,246,195,47970,1.2615384615384615,Large,384.0,216.5,0.394655704008222,0.3341049382716049,middle-center,630504,0.07608199154961745,Medium (5-15%)
00001983.jpg,1000,667,496,90,803,328,False,307,238,73066,1.4992503748125936,307,238,73066,1.2899159663865547,Very Large,649.5,209.0,0.6495,0.31334332833583206,top-center,667000,0.10954422788605697,Medium (5-15%)
00001997.jpg,400,309,158,1,357,171,False,199,170,33830,1.2944983818770226,199,170,33830,1.1705882352941177,Large,257.5,86.0,0.64375,0.2783171521035599,top-center,123600,0.27370550161812296,Large (15-30%)
00002246.jpg,590,394,143,1,430,216,False,287,215,61705,1.49746192893401,287,215,61705,1.3348837209302327,Very Large,286.5,108.5,0.48559322033898306,0.2753807106598985,top-center,232460,0.2654435171642433,Large (15-30%)
00000337.jpg,600,420,431,104,493,155,False,62,51,3162,1.4285714285714286,62,51,3162,1.2156862745098038,Small,462.0,129.5,0.77,0.30833333333333335,top-right,252000,0.012547619047619047,Small (1-5%)
00001981.jpg,1068,1700,381,177,676,711,False,295,534,157530,0.6282352941176471,295,534,157530,0.552434456928839,Very Large,528.5,444.0,0.4948501872659176,0.2611764705882353,top-center,1815600,0.08676470588235294,Medium (5-15%)
00000447.jpg,390,280,159,58,230,118,False,71,60,4260,1.3928571428571428,71,60,4260,1.1833333333333333,Small,194.5,88.0,0.4987179487179487,0.3142857142857143,top-center,109200,0.03901098901098901,Small (1-5%)
00000447.jpg,390,280,302,66,352,109,False,50,43,2150,1.3928571428571428,50,43,2150,1.1627906976744187,Small,327.0,87.5,0.8384615384615385,0.3125,top-right,109200,0.019688644688644688,Small (1-5%)
00002536.jpg,612,459,204,18,496,273,False,292,255,74460,1.3333333333333333,292,255,74460,1.1450980392156862,Very Large,350.0,145.5,0.5718954248366013,0.31699346405228757,top-center,280908,0.26506899055918665,Large (15-30%)
00000321.jpg,640,800,223,122,302,235,False,79,113,8927,0.8,79,113,8927,0.6991150442477876,Medium,262.5,178.5,0.41015625,0.223125,top-center,512000,0.017435546875,Small (1-5%)
00000321.jpg,640,800,390,139,462,243,False,72,104,7488,0.8,72,104,7488,0.6923076923076923,Medium,426.0,191.0,0.665625,0.23875,top-center,512000,0.014625,Small (1-5%)
00000321.jpg,640,800,142,212,208,307,False,66,95,6270,0.8,66,95,6270,0.6947368421052632,Medium,175.0,259.5,0.2734375,0.324375,top-left,512000,0.01224609375,Small (1-5%)
00000321.jpg,640,800,323,230,388,323,False,65,93,6045,0.8,65,93,6045,0.6989247311827957,Medium,355.5,276.5,0.55546875,0.345625,middle-center,512000,0.011806640625,Small (1-5%)
00002244.jpg,400,600,152,67,316,352,False,164,285,46740,0.6666666666666666,164,285,46740,0.5754385964912281,Large,234.0,209.5,0.585,0.3491666666666667,middle-center,240000,0.19475,Large (15-30%)
00000453.jpg,1000,667,481,133,592,217,False,111,84,9324,1.4992503748125936,111,84,9324,1.3214285714285714,Medium,536.5,175.0,0.5365,0.2623688155922039,top-center,667000,0.013979010494752624,Small (1-5%)
00000453.jpg,1000,667,214,9,378,135,False,164,126,20664,1.4992503748125936,164,126,20664,1.3015873015873016,Large,296.0,72.0,0.296,0.10794602698650675,top-left,667000,0.030980509745127435,Small (1-5%)
00000453.jpg,1000,667,309,140,467,262,False,158,122,19276,1.4992503748125936,158,122,19276,1.2950819672131149,Medium,388.0,201.0,0.388,0.30134932533733133,top-center,667000,0.028899550224887556,Small (1-5%)
00000453.jpg,1000,667,618,158,750,261,False,132,103,13596,1.4992503748125936,132,103,13596,1.2815533980582525,Medium,684.0,209.5,0.684,0.3140929535232384,top-right,667000,0.020383808095952024,Small (1-5%)
00003172.jpg,262,280,75,197,119,250,False,44,53,2332,0.9357142857142857,44,53,2332,0.8301886792452831,Small,97.0,223.5,0.3702290076335878,0.7982142857142858,bottom-center,73360,0.03178844056706652,Small (1-5%)
00003172.jpg,262,280,209,199,251,251,False,42,52,2184,0.9357142857142857,42,52,2184,0.8076923076923077,Small,230.0,225.0,0.8778625954198473,0.8035714285714286,bottom-right,73360,0.029770992366412213,Small (1-5%)
00003172.jpg,262,280,15,5,52,50,False,37,45,1665,0.9357142857142857,37,45,1665,0.8222222222222222,Small,33.5,27.5,0.12786259541984732,0.09821428571428571,top-left,73360,0.02269629225736096,Small (1-5%)
00003172.jpg,262,280,143,3,184,54,False,41,51,2091,0.9357142857142857,41,51,2091,0.803921568627451,Small,163.5,28.5,0.6240458015267175,0.10178571428571428,top-center,73360,0.028503271537622683,Small (1-5%)
00003172.jpg,262,280,140,136,180,186,False,40,50,2000,0.9357142857142857,40,50,2000,0.8,Small,160.0,161.0,0.6106870229007634,0.575,middle-center,73360,0.027262813522355506,Small (1-5%)
00003172.jpg,262,280,15,200,51,245,False,36,45,1620,0.9357142857142857,36,45,1620,0.8,Small,33.0,222.5,0.12595419847328243,0.7946428571428571,bottom-left,73360,0.02208287895310796,Small (1-5%)
00003172.jpg,262,280,77,7,115,54,False,38,47,1786,0.9357142857142857,38,47,1786,0.8085106382978723,Small,96.0,30.5,0.366412213740458,0.10892857142857143,top-center,73360,0.02434569247546347,Small (1-5%)
00003172.jpg,262,280,12,134,49,180,False,37,46,1702,0.9357142857142857,37,46,1702,0.8043478260869565,Small,30.5,157.0,0.11641221374045801,0.5607142857142857,middle-left,73360,0.023200654307524538,Small (1-5%)
00003172.jpg,262,280,16,74,51,118,False,35,44,1540,0.9357142857142857,35,44,1540,0.7954545454545454,Small,33.5,96.0,0.12786259541984732,0.34285714285714286,middle-left,73360,0.02099236641221374,Small (1-5%)
00003172.jpg,262,280,213,71,246,113,False,33,42,1386,0.9357142857142857,33,42,1386,0.7857142857142857,Small,229.5,92.0,0.8759541984732825,0.32857142857142857,top-right,73360,0.018893129770992365,Small (1-5%)
00003172.jpg,262,280,82,135,116,177,False,34,42,1428,0.9357142857142857,34,42,1428,0.8095238095238095,Small,99.0,156.0,0.37786259541984735,0.5571428571428572,middle-center,73360,0.019465648854961833,Small (1-5%)
00001003.jpg,500,333,148,63,327,202,False,179,139,24881,1.5015015015015014,179,139,24881,1.2877697841726619,Large,237.5,132.5,0.475,0.3978978978978979,middle-center,166500,0.14943543543543544,Medium (5-15%)
00000309.jpg,1000,667,293,18,770,387,False,477,369,176013,1.4992503748125936,477,369,176013,1.2926829268292683,Very Large,531.5,202.5,0.5315,0.30359820089955025,top-center,667000,0.26388755622188903,Large (15-30%)
00001017.jpg,800,533,399,54,559,178,False,160,124,19840,1.5009380863039399,160,124,19840,1.2903225806451613,Medium,479.0,116.0,0.59875,0.2176360225140713,top-center,426400,0.04652908067542214,Small (1-5%)
00001771.jpg,1000,667,133,63,755,545,False,622,482,299804,1.4992503748125936,622,482,299804,1.2904564315352698,Very Large,444.0,304.0,0.444,0.45577211394302847,middle-center,667000,0.44948125937031486,Very Large (>30%)
00003166.jpg,1300,956,531,79,1087,555,False,556,476,264656,1.3598326359832635,556,476,264656,1.1680672268907564,Very Large,809.0,317.0,0.6223076923076923,0.33158995815899583,middle-center,1242800,0.21295140006437077,Large (15-30%)
00002293.jpg,1335,2000,638,413,843,772,False,205,359,73595,0.6675,205,359,73595,0.5710306406685237,Very Large,740.5,592.5,0.5546816479400749,0.29625,top-center,2670000,0.027563670411985017,Small (1-5%)
00001942.jpg,400,280,204,34,324,130,False,120,96,11520,1.4285714285714286,120,96,11520,1.25,Medium,264.0,82.0,0.66,0.29285714285714287,top-center,112000,0.10285714285714286,Medium (5-15%)
00001956.jpg,1300,956,394,109,1000,628,False,606,519,314514,1.3598326359832635,606,519,314514,1.1676300578034682,Very Large,697.0,368.5,0.5361538461538462,0.3854602510460251,middle-center,1242800,0.2530688767299646,Large (15-30%)
00002287.jpg,433,650,120,36,336,412,False,216,376,81216,0.6661538461538462,216,376,81216,0.574468085106383,Very Large,228.0,224.0,0.5265588914549654,0.3446153846153846,middle-center,281450,0.28856279978681826,Large (15-30%)
00000123.jpg,681,1024,268,139,350,281,False,82,142,11644,0.6650390625,82,142,11644,0.5774647887323944,Medium,309.0,210.0,0.45374449339207046,0.205078125,top-center,697344,0.01669764133627019,Small (1-5%)
00002052.jpg,1300,956,480,125,871,453,False,391,328,128248,1.3598326359832635,391,328,128248,1.1920731707317074,Very Large,675.5,289.0,0.5196153846153846,0.3023012552301255,top-center,1242800,0.1031927904731252,Medium (5-15%)
00000645.jpg,590,393,299,109,422,202,False,123,93,11439,1.5012722646310432,123,93,11439,1.3225806451612903,Medium,360.5,155.5,0.6110169491525423,0.39567430025445294,middle-center,231870,0.049333678354250225,Small (1-5%)
00000645.jpg,590,393,400,118,508,200,False,108,82,8856,1.5012722646310432,108,82,8856,1.3170731707317074,Medium,454.0,159.0,0.7694915254237288,0.40458015267175573,middle-right,231870,0.03819381550006469,Small (1-5%)
00000645.jpg,590,393,349,65,442,137,False,93,72,6696,1.5012722646310432,93,72,6696,1.2916666666666667,Medium,395.5,101.0,0.6703389830508475,0.25699745547073793,top-right,231870,0.028878250743951353,Small (1-5%)
00000645.jpg,590,393,200,82,329,182,False,129,100,12900,1.5012722646310432,129,100,12900,1.29,Medium,264.5,132.0,0.4483050847457627,0.33587786259541985,middle-center,231870,0.05563462284901022,Medium (5-15%)
00000645.jpg,590,393,466,76,559,148,False,93,72,6696,1.5012722646310432,93,72,6696,1.2916666666666667,Medium,512.5,112.0,0.8686440677966102,0.28498727735368956,top-right,231870,0.028878250743951353,Small (1-5%)
00000889.jpg,612,408,215,66,435,237,False,220,171,37620,1.5,220,171,37620,1.286549707602339,Large,325.0,151.5,0.5310457516339869,0.3713235294117647,middle-center,249696,0.1506632064590542,Large (15-30%)
00002046.jpg,1500,1120,490,96,904,455,False,414,359,148626,1.3392857142857142,414,359,148626,1.1532033426183843,Very Large,697.0,275.5,0.4646666666666667,0.24598214285714284,top-center,1680000,0.08846785714285714,Medium (5-15%)
00003358.jpg,800,533,235,173,406,305,False,171,132,22572,1.5009380863039399,171,132,22572,1.2954545454545454,Large,320.5,239.0,0.400625,0.44840525328330205,middle-center,426400,0.05293621013133208,Medium (5-15%)
00003358.jpg,800,533,517,262,632,352,False,115,90,10350,1.5009380863039399,115,90,10350,1.2777777777777777,Medium,574.5,307.0,0.718125,0.575984990619137,middle-right,426400,0.02427298311444653,Small (1-5%)
00003358.jpg,800,533,410,190,519,275,False,109,85,9265,1.5009380863039399,109,85,9265,1.2823529411764707,Medium,464.5,232.5,0.580625,0.43621013133208253,middle-center,426400,0.021728424015009382,Small (1-5%)
00000137.jpg,600,900,217,23,325,207,False,108,184,19872,0.6666666666666666,108,184,19872,0.5869565217391305,Medium,271.0,115.0,0.45166666666666666,0.12777777777777777,top-center,540000,0.0368,Small (1-5%)
00003416.jpg,236,346,83,11,118,70,False,35,59,2065,0.6820809248554913,35,59,2065,0.5932203389830508,Small,100.5,40.5,0.4258474576271186,0.11705202312138728,top-center,81656,0.025289017341040464,Small (1-5%)
00003416.jpg,236,346,100,102,130,152,False,30,50,1500,0.6820809248554913,30,50,1500,0.6,Small,115.0,127.0,0.4872881355932203,0.3670520231213873,middle-center,81656,0.018369746252571765,Small (1-5%)
00002708.jpg,2000,1228,60,115,469,407,False,409,292,119428,1.6286644951140066,409,292,119428,1.4006849315068493,Very Large,264.5,261.0,0.13225,0.21254071661237786,top-left,2456000,0.04862703583061889,Small (1-5%)
00002708.jpg,2000,1228,441,94,958,463,False,517,369,190773,1.6286644951140066,517,369,190773,1.4010840108401084,Very Large,699.5,278.5,0.34975,0.2267915309446254,top-center,2456000,0.0776763029315961,Medium (5-15%)
00002708.jpg,2000,1228,798,202,1295,550,False,497,348,172956,1.6286644951140066,497,348,172956,1.4281609195402298,Very Large,1046.5,376.0,0.52325,0.30618892508143325,top-center,2456000,0.07042182410423453,Medium (5-15%)
00002708.jpg,2000,1228,1422,220,1998,669,False,576,449,258624,1.6286644951140066,576,449,258624,1.2828507795100224,Very Large,1710.0,444.5,0.855,0.36197068403908794,middle-right,2456000,0.1053029315960912,Medium (5-15%)
00000679.jpg,1024,683,652,223,817,351,False,165,128,21120,1.499267935578331,165,128,21120,1.2890625,Large,734.5,287.0,0.71728515625,0.42020497803806733,middle-right,699392,0.03019765739385066,Small (1-5%)
00000679.jpg,1024,683,342,189,543,345,False,201,156,31356,1.499267935578331,201,156,31356,1.2884615384615385,Large,442.5,267.0,0.43212890625,0.39092240117130306,middle-center,699392,0.044833226573938505,Small (1-5%)
00000679.jpg,1024,683,200,135,362,260,False,162,125,20250,1.499267935578331,162,125,20250,1.296,Large,281.0,197.5,0.2744140625,0.2891654465592972,top-left,699392,0.028953719802342605,Small (1-5%)
00000679.jpg,1024,683,256,200,418,325,False,162,125,20250,1.499267935578331,162,125,20250,1.296,Large,337.0,262.5,0.3291015625,0.38433382137628114,middle-left,699392,0.028953719802342605,Small (1-5%)
00000679.jpg,1024,683,756,156,904,273,False,148,117,17316,1.499267935578331,148,117,17316,1.264957264957265,Medium,830.0,214.5,0.810546875,0.3140556368960469,top-right,699392,0.024758647510980968,Small (1-5%)
00000679.jpg,1024,683,460,128,590,227,False,130,99,12870,1.499267935578331,130,99,12870,1.3131313131313131,Medium,525.0,177.5,0.5126953125,0.25988286969253294,top-center,699392,0.018401697474377744,Small (1-5%)
00001567.jpg,406,608,167,36,266,207,False,99,171,16929,0.6677631578947368,99,171,16929,0.5789473684210527,Medium,216.5,121.5,0.5332512315270936,0.19983552631578946,top-center,246848,0.06858066502463055,Medium (5-15%)
00003370.jpg,500,700,196,85,273,211,False,77,126,9702,0.7142857142857143,77,126,9702,0.6111111111111112,Medium,234.5,148.0,0.469,0.21142857142857144,top-center,350000,0.02772,Small (1-5%)
00003364.jpg,736,917,378,92,501,267,False,123,175,21525,0.8026172300981461,123,175,21525,0.7028571428571428,Large,439.5,179.5,0.5971467391304348,0.19574700109051255,top-center,674912,0.03189304679721208,Small (1-5%)
00001215.jpg,1001,1600,437,143,548,350,False,111,207,22977,0.625625,111,207,22977,0.5362318840579711,Large,492.5,246.5,0.492007992007992,0.1540625,top-center,1601600,0.014346278721278721,Small (1-5%)
00003402.jpg,236,354,81,45,149,163,False,68,118,8024,0.6666666666666666,68,118,8024,0.576271186440678,Medium,115.0,104.0,0.4872881355932203,0.2937853107344633,top-center,83544,0.096045197740113,Medium (5-15%)
00002085.jpg,600,900,271,61,344,186,False,73,125,9125,0.6666666666666666,73,125,9125,0.584,Medium,307.5,123.5,0.5125,0.13722222222222222,top-center,540000,0.016898148148148148,Small (1-5%)
00000876.jpg,1500,1178,639,97,1018,444,False,379,347,131513,1.2733446519524618,379,347,131513,1.0922190201729107,Very Large,828.5,270.5,0.5523333333333333,0.2296264855687606,top-center,1767000,0.0744272778720996,Medium (5-15%)
00002640.jpg,612,408,264,68,531,276,False,267,208,55536,1.5,267,208,55536,1.2836538461538463,Very Large,397.5,172.0,0.6495098039215687,0.4215686274509804,middle-center,249696,0.22241445597846982,Large (15-30%)
00002898.jpg,600,401,1,3,501,393,False,500,390,195000,1.4962593516209477,500,390,195000,1.2820512820512822,Very Large,251.0,198.0,0.41833333333333333,0.4937655860349127,middle-center,240600,0.8104738154613467,Very Large (>30%)
00003238.jpg,612,413,72,89,322,282,False,250,193,48250,1.4818401937046004,250,193,48250,1.2953367875647668,Large,197.0,185.5,0.32189542483660133,0.4491525423728814,middle-left,252756,0.1908955672664546,Large (15-30%)
00002132.jpg,1600,1167,553,46,942,383,False,389,337,131093,1.3710368466152527,389,337,131093,1.1543026706231454,Very Large,747.5,214.5,0.4671875,0.18380462724935734,top-center,1867200,0.07020833333333333,Medium (5-15%)
00002654.jpg,900,600,339,105,898,539,False,559,434,242606,1.5,559,434,242606,1.2880184331797235,Very Large,618.5,322.0,0.6872222222222222,0.5366666666666666,middle-right,540000,0.4492703703703704,Very Large (>30%)
00001413.jpg,1300,1021,498,90,842,404,False,344,314,108016,1.2732615083251715,344,314,108016,1.0955414012738853,Very Large,670.0,247.0,0.5153846153846153,0.24191968658178256,top-center,1327300,0.08138024561139155,Medium (5-15%)
00001407.jpg,1023,759,255,31,569,302,False,314,271,85094,1.3478260869565217,314,271,85094,1.1586715867158672,Very Large,412.0,166.5,0.4027370478983382,0.21936758893280633,top-center,776457,0.1095926754475779,Medium (5-15%)
00000719.jpg,626,417,153,20,272,113,False,119,93,11067,1.501199040767386,119,93,11067,1.2795698924731183,Medium,212.5,66.5,0.33945686900958466,0.15947242206235013,top-center,261042,0.04239547658997403,Small (1-5%)
00000719.jpg,626,417,65,89,208,197,False,143,108,15444,1.501199040767386,143,108,15444,1.3240740740740742,Medium,136.5,143.0,0.21805111821086262,0.34292565947242204,middle-left,261042,0.05916289332751051,Medium (5-15%)
00000719.jpg,626,417,304,32,460,150,False,156,118,18408,1.501199040767386,156,118,18408,1.3220338983050848,Medium,382.0,91.0,0.610223642172524,0.2182254196642686,top-center,261042,0.07051738800652768,Medium (5-15%)
00000719.jpg,626,417,408,32,554,142,False,146,110,16060,1.501199040767386,146,110,16060,1.3272727272727274,Medium,481.0,87.0,0.768370607028754,0.20863309352517986,top-right,261042,0.061522666850545124,Medium (5-15%)
00000719.jpg,626,417,205,72,374,203,False,169,131,22139,1.501199040767386,169,131,22139,1.2900763358778626,Large,289.5,137.5,0.46246006389776356,0.32973621103117506,top-center,261042,0.08481010718581684,Medium (5-15%)
00000719.jpg,626,417,135,118,297,244,False,162,126,20412,1.501199040767386,162,126,20412,1.2857142857142858,Large,216.0,181.0,0.3450479233226837,0.434052757793765,middle-center,261042,0.07819431355873767,Medium (5-15%)
00002683.jpg,792,1024,484,194,599,366,False,115,172,19780,0.7734375,115,172,19780,0.6686046511627907,Medium,541.5,280.0,0.6837121212121212,0.2734375,top-right,811008,0.02438940183080808,Small (1-5%)
00002683.jpg,792,1024,330,192,450,368,False,120,176,21120,0.7734375,120,176,21120,0.6818181818181818,Large,390.0,280.0,0.49242424242424243,0.2734375,top-center,811008,0.026041666666666668,Small (1-5%)
00000094.jpg,1024,682,402,26,685,245,False,283,219,61977,1.501466275659824,283,219,61977,1.2922374429223744,Very Large,543.5,135.5,0.53076171875,0.19868035190615835,top-center,698368,0.08874547516495601,Medium (5-15%)
00002867.jpg,1920,1080,816,171,1146,387,False,330,216,71280,1.7777777777777777,330,216,71280,1.5277777777777777,Very Large,981.0,279.0,0.5109375,0.25833333333333336,top-center,2073600,0.034375,Small (1-5%)
00000916.jpg,681,1024,323,20,404,159,False,81,139,11259,0.6650390625,81,139,11259,0.5827338129496403,Medium,363.5,89.5,0.5337738619676946,0.08740234375,top-center,697344,0.016145546530837003,Small (1-5%)
00000902.jpg,600,400,329,144,477,259,False,148,115,17020,1.5,148,115,17020,1.2869565217391303,Medium,403.0,201.5,0.6716666666666666,0.50375,middle-right,240000,0.07091666666666667,Medium (5-15%)
00000533.jpg,1500,1101,880,271,1312,640,False,432,369,159408,1.3623978201634876,432,369,159408,1.170731707317073,Very Large,1096.0,455.5,0.7306666666666667,0.4137148047229791,middle-right,1651500,0.09652316076294278,Medium (5-15%)
00000533.jpg,1500,1101,1170,73,1417,284,False,247,211,52117,1.3623978201634876,247,211,52117,1.1706161137440758,Very Large,1293.5,178.5,0.8623333333333333,0.16212534059945505,top-right,1651500,0.031557372085982444,Small (1-5%)
00000533.jpg,1500,1101,487,291,750,511,False,263,220,57860,1.3623978201634876,263,220,57860,1.1954545454545455,Very Large,618.5,401.0,0.41233333333333333,0.3642143505903724,middle-center,1651500,0.03503481683318196,Small (1-5%)
00000533.jpg,1500,1101,331,63,583,279,False,252,216,54432,1.3623978201634876,252,216,54432,1.1666666666666667,Very Large,457.0,171.0,0.30466666666666664,0.1553133514986376,top-left,1651500,0.032959128065395096,Small (1-5%)
00000533.jpg,1500,1101,544,383,893,682,False,349,299,104351,1.3623978201634876,349,299,104351,1.1672240802675586,Very Large,718.5,532.5,0.479,0.48365122615803813,middle-center,1651500,0.06318558885861338,Medium (5-15%)
00000533.jpg,1500,1101,92,198,471,530,False,379,332,125828,1.3623978201634876,379,332,125828,1.141566265060241,Very Large,281.5,364.0,0.18766666666666668,0.33060853769300635,middle-left,1651500,0.0761901301846806,Medium (5-15%)
00000533.jpg,1500,1101,691,226,933,432,False,242,206,49852,1.3623978201634876,242,206,49852,1.174757281553398,Large,812.0,329.0,0.5413333333333333,0.298819255222525,top-center,1651500,0.03018589161368453,Small (1-5%)
00000255.jpg,401,343,239,67,392,219,False,153,152,23256,1.1690962099125364,153,152,23256,1.006578947368421,Large,315.5,143.0,0.786783042394015,0.41690962099125367,middle-right,137543,0.16908166900532925,Large (15-30%)
00000255.jpg,401,343,112,77,279,243,False,167,166,27722,1.1690962099125364,167,166,27722,1.0060240963855422,Large,195.5,160.0,0.48753117206982544,0.46647230320699706,middle-center,137543,0.20155151479900832,Large (15-30%)
00002456.jpg,629,472,104,229,174,288,False,70,59,4130,1.3326271186440677,70,59,4130,1.1864406779661016,Small,139.0,258.5,0.22098569157392686,0.5476694915254238,middle-left,296888,0.013910969793322734,Small (1-5%)
00000527.jpg,1300,1002,252,202,470,398,False,218,196,42728,1.2974051896207586,218,196,42728,1.1122448979591837,Large,361.0,300.0,0.2776923076923077,0.2994011976047904,top-left,1302600,0.03280208813142945,Small (1-5%)
00000527.jpg,1300,1002,646,331,860,523,False,214,192,41088,1.2974051896207586,214,192,41088,1.1145833333333333,Large,753.0,427.0,0.5792307692307692,0.42614770459081835,middle-center,1302600,0.031543067710732384,Small (1-5%)
00000527.jpg,1300,1002,465,367,670,551,False,205,184,37720,1.2974051896207586,205,184,37720,1.1141304347826086,Large,567.5,459.0,0.43653846153846154,0.45808383233532934,middle-center,1302600,0.02895746967603255,Small (1-5%)
00000527.jpg,1300,1002,156,388,384,593,False,228,205,46740,1.2974051896207586,228,205,46740,1.1121951219512196,Large,270.0,490.5,0.2076923076923077,0.48952095808383234,middle-left,1302600,0.03588208198986642,Small (1-5%)
00000527.jpg,1300,1002,800,312,1010,500,False,210,188,39480,1.2974051896207586,210,188,39480,1.1170212765957446,Large,905.0,406.0,0.6961538461538461,0.405189620758483,middle-right,1302600,0.030308613542146475,Small (1-5%)
00001639.jpg,682,1024,338,73,501,356,False,163,283,46129,0.666015625,163,283,46129,0.5759717314487632,Large,419.5,214.5,0.6151026392961877,0.20947265625,top-center,698368,0.06605256827346041,Medium (5-15%)
00002318.jpg,1728,1075,519,81,681,198,False,162,117,18954,1.6074418604651164,162,117,18954,1.3846153846153846,Medium,600.0,139.5,0.3472222222222222,0.12976744186046513,top-center,1857600,0.010203488372093023,Small (1-5%)
00002318.jpg,1728,1075,1134,234,1311,361,False,177,127,22479,1.6074418604651164,177,127,22479,1.3937007874015748,Large,1222.5,297.5,0.7074652777777778,0.27674418604651163,top-right,1857600,0.01210109819121447,Small (1-5%)
00003006.jpg,800,800,193,103,350,285,False,157,182,28574,1.0,157,182,28574,0.8626373626373627,Large,271.5,194.0,0.339375,0.2425,top-center,640000,0.044646875,Small (1-5%)
00003006.jpg,800,800,173,529,336,720,False,163,191,31133,1.0,163,191,31133,0.8534031413612565,Large,254.5,624.5,0.318125,0.780625,bottom-left,640000,0.0486453125,Small (1-5%)
00001611.jpg,1024,683,433,33,682,226,False,249,193,48057,1.499267935578331,249,193,48057,1.2901554404145077,Large,557.5,129.5,0.54443359375,0.18960468521229867,top-center,699392,0.0687125388909224,Medium (5-15%)
00001177.jpg,667,1000,400,66,512,262,False,112,196,21952,0.667,112,196,21952,0.5714285714285714,Large,456.0,164.0,0.6836581709145427,0.164,top-right,667000,0.03291154422788606,Small (1-5%)
00001163.jpg,1600,1167,428,29,1142,649,False,714,620,442680,1.3710368466152527,714,620,442680,1.1516129032258065,Very Large,785.0,339.0,0.490625,0.29048843187660667,top-center,1867200,0.23708226221079692,Large (15-30%)
00001605.jpg,2940,1960,1030,144,1672,641,False,642,497,319074,1.5,642,497,319074,1.2917505030181087,Very Large,1351.0,392.5,0.4595238095238095,0.2002551020408163,top-center,5762400,0.055371720116618076,Medium (5-15%)
00003012.jpg,510,340,56,50,409,318,False,353,268,94604,1.5,353,268,94604,1.3171641791044777,Very Large,232.5,184.0,0.45588235294117646,0.5411764705882353,middle-center,173400,0.5455824682814302,Very Large (>30%)
00001836.jpg,1500,1120,448,66,861,425,False,413,359,148267,1.3392857142857142,413,359,148267,1.15041782729805,Very Large,654.5,245.5,0.43633333333333335,0.21919642857142857,top-center,1680000,0.08825416666666666,Medium (5-15%)
00000296.jpg,682,1023,285,186,407,395,False,122,209,25498,0.6666666666666666,122,209,25498,0.583732057416268,Large,346.0,290.5,0.5073313782991202,0.28396871945259045,top-center,697686,0.03654652666099076,Small (1-5%)
00001188.jpg,333,519,117,24,189,156,False,72,132,9504,0.6416184971098265,72,132,9504,0.5454545454545454,Medium,153.0,90.0,0.4594594594594595,0.17341040462427745,top-center,172827,0.054991407592563664,Medium (5-15%)
00002481.jpg,700,467,157,90,359,247,False,202,157,31714,1.4989293361884368,202,157,31714,1.286624203821656,Large,258.0,168.5,0.36857142857142855,0.360813704496788,middle-center,326900,0.09701437748546957,Medium (5-15%)
00002495.jpg,1024,682,126,80,478,353,False,352,273,96096,1.501466275659824,352,273,96096,1.2893772893772895,Very Large,302.0,216.5,0.294921875,0.31744868035190615,top-left,698368,0.1376008064516129,Medium (5-15%)
00000282.jpg,434,650,196,133,303,321,False,107,188,20116,0.6676923076923077,107,188,20116,0.5691489361702128,Large,249.5,227.0,0.5748847926267281,0.34923076923076923,middle-center,282100,0.07130804679191775,Medium (5-15%)
00001822.jpg,318,450,115,25,176,123,False,61,98,5978,0.7066666666666667,61,98,5978,0.6224489795918368,Medium,145.5,74.0,0.45754716981132076,0.16444444444444445,top-center,143100,0.04177498252969951,Small (1-5%)
00000283.jpg,1272,1960,485,280,607,498,False,122,218,26596,0.6489795918367347,122,218,26596,0.5596330275229358,Large,546.0,389.0,0.42924528301886794,0.19846938775510203,top-center,2493120,0.010667757669105379,Small (1-5%)
00001823.jpg,683,1023,243,117,382,361,False,139,244,33916,0.667644183773216,139,244,33916,0.569672131147541,Large,312.5,239.0,0.4575402635431918,0.23362658846529813,top-center,698709,0.04854095195567826,Small (1-5%)
00001837.jpg,867,1390,316,189,517,566,False,201,377,75777,0.6237410071942446,201,377,75777,0.53315649867374,Very Large,416.5,377.5,0.4803921568627451,0.2715827338129496,top-center,1205130,0.06287869358492444,Medium (5-15%)
00001162.jpg,1000,569,381,77,614,231,False,233,154,35882,1.757469244288225,233,154,35882,1.5129870129870129,Large,497.5,154.0,0.4975,0.27065026362038663,top-center,569000,0.06306151142355008,Medium (5-15%)
00001176.jpg,1800,1800,940,292,1200,594,False,260,302,78520,1.0,260,302,78520,0.8609271523178808,Very Large,1070.0,443.0,0.5944444444444444,0.2461111111111111,top-center,3240000,0.024234567901234568,Small (1-5%)
00000240.jpg,400,267,37,2,228,150,False,191,148,28268,1.4981273408239701,191,148,28268,1.2905405405405406,Large,132.5,76.0,0.33125,0.2846441947565543,top-center,106800,0.2646816479400749,Large (15-30%)
00000240.jpg,400,267,177,56,356,195,False,179,139,24881,1.4981273408239701,179,139,24881,1.2877697841726619,Large,266.5,125.5,0.66625,0.4700374531835206,middle-center,106800,0.2329681647940075,Large (15-30%)
00000240.jpg,400,267,125,99,259,201,False,134,102,13668,1.4981273408239701,134,102,13668,1.3137254901960784,Medium,192.0,150.0,0.48,0.5617977528089888,middle-center,106800,0.12797752808988763,Medium (5-15%)
00002325.jpg,1500,1101,617,108,1049,477,False,432,369,159408,1.3623978201634876,432,369,159408,1.170731707317073,Very Large,833.0,292.5,0.5553333333333333,0.2656675749318801,top-center,1651500,0.09652316076294278,Medium (5-15%)
00000532.jpg,1000,667,97,169,320,342,False,223,173,38579,1.4992503748125936,223,173,38579,1.2890173410404624,Large,208.5,255.5,0.2085,0.3830584707646177,middle-left,667000,0.057839580209895054,Medium (5-15%)
00000532.jpg,1000,667,547,50,739,195,False,192,145,27840,1.4992503748125936,192,145,27840,1.3241379310344827,Large,643.0,122.5,0.643,0.18365817091454273,top-center,667000,0.04173913043478261,Small (1-5%)
00000532.jpg,1000,667,301,130,469,260,False,168,130,21840,1.4992503748125936,168,130,21840,1.2923076923076924,Large,385.0,195.0,0.385,0.29235382308845576,top-center,667000,0.032743628185907044,Small (1-5%)
00000532.jpg,1000,667,355,171,619,371,False,264,200,52800,1.4992503748125936,264,200,52800,1.32,Very Large,487.0,271.0,0.487,0.4062968515742129,middle-center,667000,0.07916041979010495,Medium (5-15%)
00000254.jpg,864,1296,330,233,461,460,False,131,227,29737,0.6666666666666666,131,227,29737,0.5770925110132159,Large,395.5,346.5,0.45775462962962965,0.2673611111111111,top-center,1119744,0.026556963020118885,Small (1-5%)
00000903.jpg,2936,1960,1061,464,1803,1041,False,742,577,428134,1.4979591836734694,742,577,428134,1.2859618717504333,Very Large,1432.0,752.5,0.4877384196185286,0.38392857142857145,middle-center,5754560,0.07439908524717789,Medium (5-15%)
00002872.jpg,510,340,31,65,382,331,False,351,266,93366,1.5,351,266,93366,1.3195488721804511,Very Large,206.5,198.0,0.40490196078431373,0.5823529411764706,middle-center,173400,0.5384429065743944,Very Large (>30%)
00002866.jpg,800,600,427,71,630,251,False,203,180,36540,1.3333333333333333,203,180,36540,1.1277777777777778,Large,528.5,161.0,0.660625,0.2683333333333333,top-center,480000,0.076125,Medium (5-15%)
00002866.jpg,800,600,559,12,800,231,False,241,219,52779,1.3333333333333333,241,219,52779,1.1004566210045663,Very Large,679.5,121.5,0.849375,0.2025,top-right,480000,0.10995625,Medium (5-15%)
00002866.jpg,800,600,510,427,603,508,False,93,81,7533,1.3333333333333333,93,81,7533,1.1481481481481481,Medium,556.5,467.5,0.695625,0.7791666666666667,bottom-right,480000,0.01569375,Small (1-5%)
00002866.jpg,800,600,615,467,695,537,False,80,70,5600,1.3333333333333333,80,70,5600,1.1428571428571428,Medium,655.0,502.0,0.81875,0.8366666666666667,bottom-right,480000,0.011666666666666667,Small (1-5%)
00000917.jpg,2000,1375,820,306,1171,587,False,351,281,98631,1.4545454545454546,351,281,98631,1.2491103202846976,Very Large,995.5,446.5,0.49775,0.32472727272727275,top-center,2750000,0.03586581818181818,Small (1-5%)
00002696.jpg,866,1300,279,156,539,621,False,260,465,120900,0.6661538461538462,260,465,120900,0.5591397849462365,Very Large,409.0,388.5,0.4722863741339492,0.2988461538461539,top-center,1125800,0.10739030023094688,Medium (5-15%)
00000095.jpg,612,408,159,1,457,220,False,298,219,65262,1.5,298,219,65262,1.360730593607306,Very Large,308.0,110.5,0.5032679738562091,0.2708333333333333,top-center,249696,0.2613658208381392,Large (15-30%)
00002682.jpg,600,401,47,56,271,230,False,224,174,38976,1.4962593516209477,224,174,38976,1.2873563218390804,Large,159.0,143.0,0.265,0.3566084788029925,middle-left,240600,0.16199501246882794,Large (15-30%)
00002682.jpg,600,401,313,139,501,285,False,188,146,27448,1.4962593516209477,188,146,27448,1.2876712328767124,Large,407.0,212.0,0.6783333333333333,0.5286783042394015,middle-right,240600,0.1140814630091438,Medium (5-15%)
00000718.jpg,1280,1280,951,459,1152,699,False,201,240,48240,1.0,201,240,48240,0.8375,Large,1051.5,579.0,0.821484375,0.45234375,middle-right,1638400,0.029443359375,Small (1-5%)
00000718.jpg,1280,1280,316,367,522,607,False,206,240,49440,1.0,206,240,49440,0.8583333333333333,Large,419.0,487.0,0.32734375,0.38046875,middle-left,1638400,0.03017578125,Small (1-5%)
00000718.jpg,1280,1280,8,444,218,690,False,210,246,51660,1.0,210,246,51660,0.8536585365853658,Very Large,113.0,567.0,0.08828125,0.44296875,middle-left,1638400,0.03153076171875,Small (1-5%)
00000718.jpg,1280,1280,521,394,756,667,False,235,273,64155,1.0,235,273,64155,0.8608058608058609,Very Large,638.5,530.5,0.498828125,0.414453125,middle-center,1638400,0.0391571044921875,Small (1-5%)
00000718.jpg,1280,1280,9,764,271,1068,False,262,304,79648,1.0,262,304,79648,0.8618421052631579,Very Large,140.0,916.0,0.109375,0.715625,bottom-left,1638400,0.04861328125,Small (1-5%)
00000718.jpg,1280,1280,1097,627,1280,952,False,183,325,59475,1.0,183,325,59475,0.563076923076923,Very Large,1188.5,789.5,0.928515625,0.616796875,middle-right,1638400,0.0363006591796875,Small (1-5%)
00000718.jpg,1280,1280,737,297,939,532,False,202,235,47470,1.0,202,235,47470,0.8595744680851064,Large,838.0,414.5,0.6546875,0.323828125,top-center,1638400,0.028973388671875,Small (1-5%)
00001406.jpg,768,768,126,120,603,675,False,477,555,264735,1.0,477,555,264735,0.8594594594594595,Very Large,364.5,397.5,0.474609375,0.517578125,middle-center,589824,0.4488372802734375,Very Large (>30%)
00002669.jpg,612,408,263,68,482,238,False,219,170,37230,1.5,219,170,37230,1.2882352941176471,Large,372.5,153.0,0.6086601307189542,0.375,middle-center,249696,0.14910130718954248,Medium (5-15%)
00002669.jpg,612,408,158,136,350,282,False,192,146,28032,1.5,192,146,28032,1.3150684931506849,Large,254.0,209.0,0.4150326797385621,0.5122549019607843,middle-center,249696,0.1122645136485967,Medium (5-15%)
00002669.jpg,612,408,2,3,186,180,False,184,177,32568,1.5,184,177,32568,1.03954802259887,Large,94.0,91.5,0.15359477124183007,0.22426470588235295,top-left,249696,0.1304306036139946,Medium (5-15%)
00002669.jpg,612,408,473,47,606,224,False,133,177,23541,1.5,133,177,23541,0.751412429378531,Large,539.5,135.5,0.8815359477124183,0.3321078431372549,middle-right,249696,0.09427864282968089,Medium (5-15%)
00002669.jpg,612,408,27,121,215,267,False,188,146,27448,1.5,188,146,27448,1.2876712328767124,Large,121.0,194.0,0.1977124183006536,0.47549019607843135,middle-left,249696,0.10992566961425093,Medium (5-15%)
00001360.jpg,2000,1333,756,102,1262,503,False,506,401,202906,1.5003750937734435,506,401,202906,1.2618453865336658,Very Large,1009.0,302.5,0.5045,0.22693173293323332,top-center,2666000,0.07610877719429858,Medium (5-15%)
00001374.jpg,863,1300,248,208,436,538,False,188,330,62040,0.6638461538461539,188,330,62040,0.5696969696969697,Very Large,342.0,373.0,0.3962920046349942,0.28692307692307695,top-center,1121900,0.05529904626080756,Medium (5-15%)
00002133.jpg,800,533,334,57,512,195,False,178,138,24564,1.5009380863039399,178,138,24564,1.289855072463768,Large,423.0,126.0,0.52875,0.23639774859287055,top-center,426400,0.057607879924953094,Medium (5-15%)
00000724.jpg,696,440,333,64,445,146,False,112,82,9184,1.5818181818181818,112,82,9184,1.3658536585365855,Medium,389.0,105.0,0.5589080459770115,0.23863636363636365,top-center,306240,0.02998955067920585,Small (1-5%)
00000724.jpg,696,440,225,71,340,155,False,115,84,9660,1.5818181818181818,115,84,9660,1.369047619047619,Medium,282.5,113.0,0.40589080459770116,0.25681818181818183,top-center,306240,0.03154388714733542,Small (1-5%)
00002655.jpg,1600,1155,382,162,657,393,False,275,231,63525,1.3852813852813852,275,231,63525,1.1904761904761905,Very Large,519.5,277.5,0.3246875,0.24025974025974026,top-left,1848000,0.034375,Small (1-5%)
00002655.jpg,1600,1155,736,230,1011,461,False,275,231,63525,1.3852813852813852,275,231,63525,1.1904761904761905,Very Large,873.5,345.5,0.5459375,0.29913419913419914,top-center,1848000,0.034375,Small (1-5%)
00002655.jpg,1600,1155,1079,120,1360,361,False,281,241,67721,1.3852813852813852,281,241,67721,1.16597510373444,Very Large,1219.5,240.5,0.7621875,0.20822510822510823,top-right,1848000,0.03664556277056277,Small (1-5%)
00002655.jpg,1600,1155,934,135,1191,346,False,257,211,54227,1.3852813852813852,257,211,54227,1.2180094786729858,Very Large,1062.5,240.5,0.6640625,0.20822510822510823,top-center,1848000,0.02934361471861472,Small (1-5%)
00002655.jpg,1600,1155,176,226,457,457,False,281,231,64911,1.3852813852813852,281,231,64911,1.2164502164502164,Very Large,316.5,341.5,0.1978125,0.2956709956709957,top-left,1848000,0.035125,Small (1-5%)
00002899.jpg,800,800,159,137,357,367,False,198,230,45540,1.0,198,230,45540,0.8608695652173913,Large,258.0,252.0,0.3225,0.315,top-left,640000,0.07115625,Medium (5-15%)
00002641.jpg,736,1104,246,201,482,613,False,236,412,97232,0.6666666666666666,236,412,97232,0.5728155339805825,Very Large,364.0,407.0,0.4945652173913043,0.3686594202898551,middle-center,812544,0.11966367359798362,Medium (5-15%)
00001348.jpg,1600,1167,961,67,1132,212,False,171,145,24795,1.3710368466152527,171,145,24795,1.1793103448275861,Large,1046.5,139.5,0.6540625,0.11953727506426735,top-center,1867200,0.013279241645244216,Small (1-5%)
00002127.jpg,2048,1367,826,114,1254,439,False,428,325,139100,1.4981711777615216,428,325,139100,1.3169230769230769,Very Large,1040.0,276.5,0.5078125,0.20226773957571323,top-center,2799616,0.04968538542428676,Small (1-5%)
00002127.jpg,2048,1367,1230,445,1559,696,False,329,251,82579,1.4981711777615216,329,251,82579,1.3107569721115537,Very Large,1394.5,570.5,0.680908203125,0.4173372348207754,middle-right,2799616,0.029496545240490123,Small (1-5%)
00000877.jpg,400,245,108,18,304,157,False,196,139,27244,1.6326530612244898,196,139,27244,1.410071942446043,Large,206.0,87.5,0.515,0.35714285714285715,middle-center,98000,0.278,Large (15-30%)
00002912.jpg,894,894,158,264,357,501,False,199,237,47163,1.0,199,237,47163,0.8396624472573839,Large,257.5,382.5,0.28803131991051456,0.4278523489932886,middle-left,799236,0.05901010464994069,Medium (5-15%)
00002084.jpg,600,420,232,11,368,122,False,136,111,15096,1.4285714285714286,136,111,15096,1.2252252252252251,Medium,300.0,66.5,0.5,0.15833333333333333,top-center,252000,0.059904761904761905,Medium (5-15%)
00002090.jpg,867,1300,368,65,475,253,False,107,188,20116,0.666923076923077,107,188,20116,0.5691489361702128,Large,421.5,159.0,0.486159169550173,0.12230769230769231,top-center,1127100,0.017847573418507675,Small (1-5%)
00001599.jpg,333,519,109,46,203,216,False,94,170,15980,0.6416184971098265,94,170,15980,0.5529411764705883,Medium,156.0,131.0,0.46846846846846846,0.2524084778420039,top-center,172827,0.09246240460113292,Medium (5-15%)
00003365.jpg,800,800,311,27,440,177,False,129,150,19350,1.0,129,150,19350,0.86,Medium,375.5,102.0,0.469375,0.1275,top-center,640000,0.030234375,Small (1-5%)
00003365.jpg,800,800,407,544,525,679,False,118,135,15930,1.0,118,135,15930,0.8740740740740741,Medium,466.0,611.5,0.5825,0.764375,bottom-center,640000,0.024890625,Small (1-5%)
00001566.jpg,1024,1024,525,114,883,532,False,358,418,149644,1.0,358,418,149644,0.8564593301435407,Very Large,704.0,323.0,0.6875,0.3154296875,top-right,1048576,0.14271163940429688,Medium (5-15%)
00000678.jpg,960,539,234,124,462,273,False,228,149,33972,1.7810760667903525,228,149,33972,1.5302013422818792,Large,348.0,198.5,0.3625,0.3682745825602968,middle-center,517440,0.06565398886827459,Medium (5-15%)
00000136.jpg,1600,1168,603,81,1272,650,False,669,569,380661,1.36986301369863,669,569,380661,1.1757469244288226,Very Large,937.5,365.5,0.5859375,0.3129280821917808,top-center,1868800,0.2036927440068493,Large (15-30%)
00001228.jpg,390,280,208,12,339,121,False,131,109,14279,1.3928571428571428,131,109,14279,1.201834862385321,Medium,273.5,66.5,0.7012820512820512,0.2375,top-right,109200,0.13076007326007327,Medium (5-15%)
00002735.jpg,400,600,154,65,229,196,False,75,131,9825,0.6666666666666666,75,131,9825,0.5725190839694656,Medium,191.5,130.5,0.47875,0.2175,top-center,240000,0.0409375,Small (1-5%)
00000644.jpg,612,408,209,114,455,301,False,246,187,46002,1.5,246,187,46002,1.3155080213903743,Large,332.0,207.5,0.5424836601307189,0.508578431372549,middle-center,249696,0.18423202614379086,Large (15-30%)
00000644.jpg,612,408,43,137,253,296,False,210,159,33390,1.5,210,159,33390,1.320754716981132,Large,148.0,216.5,0.24183006535947713,0.5306372549019608,middle-left,249696,0.1337226066897347,Medium (5-15%)
00000644.jpg,612,408,384,161,599,328,False,215,167,35905,1.5,215,167,35905,1.2874251497005988,Large,491.5,244.5,0.8031045751633987,0.5992647058823529,middle-right,249696,0.14379485454312443,Medium (5-15%)
00002053.jpg,1024,683,680,132,885,291,False,205,159,32595,1.499267935578331,205,159,32595,1.2893081761006289,Large,782.5,211.5,0.76416015625,0.3096632503660322,top-right,699392,0.046604765281844804,Small (1-5%)
00003198.jpg,626,418,303,172,420,263,False,117,91,10647,1.4976076555023923,117,91,10647,1.2857142857142858,Medium,361.5,217.5,0.5774760383386581,0.5203349282296651,middle-center,261668,0.040688964642218384,Small (1-5%)
00003198.jpg,626,418,75,149,190,236,False,115,87,10005,1.4976076555023923,115,87,10005,1.3218390804597702,Medium,132.5,192.5,0.21166134185303515,0.4605263157894737,middle-left,261668,0.03823547395936836,Small (1-5%)
00003198.jpg,626,418,232,26,339,108,False,107,82,8774,1.4976076555023923,107,82,8774,1.3048780487804879,Medium,285.5,67.0,0.4560702875399361,0.16028708133971292,top-center,261668,0.03353103933228366,Small (1-5%)
00003198.jpg,626,418,118,60,228,145,False,110,85,9350,1.4976076555023923,110,85,9350,1.2941176470588236,Medium,173.0,102.5,0.2763578274760383,0.2452153110047847,top-left,261668,0.03573230200100891,Small (1-5%)
00003198.jpg,626,418,443,149,558,236,False,115,87,10005,1.4976076555023923,115,87,10005,1.3218390804597702,Medium,500.5,192.5,0.799520766773163,0.4605263157894737,middle-right,261668,0.03823547395936836,Small (1-5%)
00002286.jpg,800,600,216,40,672,438,False,456,398,181488,1.3333333333333333,456,398,181488,1.1457286432160805,Very Large,444.0,239.0,0.555,0.3983333333333333,middle-center,480000,0.3781,Very Large (>30%)
00001957.jpg,1600,1167,321,72,1139,766,False,818,694,567692,1.3710368466152527,818,694,567692,1.1786743515850144,Very Large,730.0,419.0,0.45625,0.35904027420736934,middle-center,1867200,0.3040338474721508,Very Large (>30%)
00000485.jpg,576,768,333,156,393,249,False,60,93,5580,0.75,60,93,5580,0.6451612903225806,Medium,363.0,202.5,0.6302083333333334,0.263671875,top-center,442368,0.012613932291666666,Small (1-5%)
00001943.jpg,1200,773,77,65,317,244,False,240,179,42960,1.5523932729624839,240,179,42960,1.3407821229050279,Large,197.0,154.5,0.16416666666666666,0.1998706338939198,top-left,927600,0.0463130659767141,Small (1-5%)
00001943.jpg,1200,773,260,137,505,321,False,245,184,45080,1.5523932729624839,245,184,45080,1.3315217391304348,Large,382.5,229.0,0.31875,0.296248382923674,top-left,927600,0.04859853385079776,Small (1-5%)
00001943.jpg,1200,773,510,59,749,239,False,239,180,43020,1.5523932729624839,239,180,43020,1.3277777777777777,Large,629.5,149.0,0.5245833333333333,0.1927554980595084,top-center,927600,0.0463777490297542,Small (1-5%)
00001943.jpg,1200,773,670,150,926,338,False,256,188,48128,1.5523932729624839,256,188,48128,1.3617021276595744,Large,798.0,244.0,0.665,0.31565329883570503,top-center,927600,0.051884432945235016,Medium (5-15%)
00001943.jpg,1200,773,813,158,1098,372,False,285,214,60990,1.5523932729624839,285,214,60990,1.3317757009345794,Very Large,955.5,265.0,0.79625,0.3428201811125485,middle-right,927600,0.0657503234152652,Medium (5-15%)
00001016.jpg,683,1023,288,34,376,188,False,88,154,13552,0.667644183773216,88,154,13552,0.5714285714285714,Medium,332.0,111.0,0.486090775988287,0.10850439882697947,top-center,698709,0.019395771344007304,Small (1-5%)
00000308.jpg,620,348,262,29,381,107,False,119,78,9282,1.7816091954022988,119,78,9282,1.5256410256410255,Medium,321.5,68.0,0.5185483870967742,0.19540229885057472,top-center,215760,0.04302002224694105,Small (1-5%)
00002279.jpg,1200,1800,334,335,687,938,False,353,603,212859,0.6666666666666666,353,603,212859,0.5854063018242123,Very Large,510.5,636.5,0.42541666666666667,0.3536111111111111,middle-center,2160000,0.09854583333333333,Medium (5-15%)
00003167.jpg,2000,1333,1487,244,1776,469,False,289,225,65025,1.5003750937734435,289,225,65025,1.2844444444444445,Very Large,1631.5,356.5,0.81575,0.26744186046511625,top-right,2666000,0.024390472618154538,Small (1-5%)
00003167.jpg,2000,1333,1115,313,1353,498,False,238,185,44030,1.5003750937734435,238,185,44030,1.2864864864864864,Large,1234.0,405.5,0.617,0.30420105026256566,top-center,2666000,0.016515378844711177,Small (1-5%)
00003167.jpg,2000,1333,514,453,791,668,False,277,215,59555,1.5003750937734435,277,215,59555,1.2883720930232558,Very Large,652.5,560.5,0.32625,0.4204801200300075,middle-left,2666000,0.022338709677419355,Small (1-5%)
00001770.jpg,800,533,190,30,769,489,False,579,459,265761,1.5009380863039399,579,459,265761,1.261437908496732,Very Large,479.5,259.5,0.599375,0.48686679174484054,middle-center,426400,0.6232668855534709,Very Large (>30%)
00001764.jpg,1300,1142,367,61,1124,835,False,757,774,585918,1.138353765323993,757,774,585918,0.9780361757105943,Very Large,745.5,448.0,0.5734615384615385,0.3922942206654991,middle-center,1484600,0.3946638825272801,Very Large (>30%)
00003173.jpg,612,408,313,45,509,198,False,196,153,29988,1.5,196,153,29988,1.2810457516339868,Large,411.0,121.5,0.6715686274509803,0.2977941176470588,top-right,249696,0.12009803921568628,Medium (5-15%)
00000452.jpg,2939,1960,632,90,1535,791,False,903,701,633003,1.4994897959183673,903,701,633003,1.2881597717546363,Very Large,1083.5,440.5,0.368662810479755,0.22474489795918368,top-center,5760440,0.10988795994750401,Medium (5-15%)
00001994.jpg,300,470,36,7,266,408,False,230,401,92230,0.6382978723404256,230,401,92230,0.57356608478803,Very Large,151.0,207.5,0.5033333333333333,0.44148936170212766,middle-center,141000,0.654113475177305,Very Large (>30%)
00002245.jpg,512,512,155,1,382,164,False,227,163,37001,1.0,227,163,37001,1.392638036809816,Large,268.5,82.5,0.5244140625,0.1611328125,top-center,262144,0.14114761352539062,Medium (5-15%)
00001980.jpg,1024,769,506,329,702,501,False,196,172,33712,1.3315994798439532,196,172,33712,1.1395348837209303,Large,604.0,415.0,0.58984375,0.5396618985695709,middle-center,787456,0.04281128088426528,Small (1-5%)
00001980.jpg,1024,769,132,413,312,570,False,180,157,28260,1.3315994798439532,180,157,28260,1.1464968152866242,Large,222.0,491.5,0.216796875,0.6391417425227568,middle-left,787456,0.03588771944083225,Small (1-5%)
00001758.jpg,718,1024,308,46,390,182,False,82,136,11152,0.701171875,82,136,11152,0.6029411764705882,Medium,349.0,114.0,0.4860724233983287,0.111328125,top-center,735232,0.01516800139275766,Small (1-5%)
00001703.jpg,2770,1960,984,80,1562,557,False,578,477,275706,1.413265306122449,578,477,275706,1.2117400419287212,Very Large,1273.0,318.5,0.4595667870036101,0.1625,top-center,5429200,0.050782067339571205,Medium (5-15%)
00001065.jpg,590,393,177,67,268,138,False,91,71,6461,1.5012722646310432,91,71,6461,1.2816901408450705,Medium,222.5,102.5,0.3771186440677966,0.2608142493638677,top-center,231870,0.02786475180057791,Small (1-5%)
00001065.jpg,590,393,284,59,390,141,False,106,82,8692,1.5012722646310432,106,82,8692,1.2926829268292683,Medium,337.0,100.0,0.5711864406779661,0.2544529262086514,top-center,231870,0.037486522620433865,Small (1-5%)
00001071.jpg,450,382,237,43,392,196,False,155,153,23715,1.1780104712041886,155,153,23715,1.0130718954248366,Large,314.5,119.5,0.6988888888888889,0.31282722513089006,top-right,171900,0.13795811518324608,Medium (5-15%)
00002578.jpg,960,641,482,138,662,278,False,180,140,25200,1.497659906396256,180,140,25200,1.2857142857142858,Large,572.0,208.0,0.5958333333333333,0.3244929797191888,top-center,615360,0.04095163806552262,Small (1-5%)
00003100.jpg,1080,814,36,67,939,809,False,903,742,670026,1.3267813267813269,903,742,670026,1.2169811320754718,Very Large,487.5,438.0,0.4513888888888889,0.538083538083538,middle-center,879120,0.7621553371553371,Very Large (>30%)
00001717.jpg,2000,1281,571,84,1449,739,False,878,655,575090,1.56128024980484,878,655,575090,1.3404580152671757,Very Large,1010.0,411.5,0.505,0.32123341139734585,top-center,2562000,0.22446916471506637,Large (15-30%)
00000409.jpg,4000,6000,1339,1376,2121,2743,False,782,1367,1068994,0.6666666666666666,782,1367,1068994,0.5720555961960497,Very Large,1730.0,2059.5,0.4325,0.34325,middle-center,24000000,0.04454141666666667,Small (1-5%)
00003128.jpg,1000,1000,321,239,609,574,False,288,335,96480,1.0,288,335,96480,0.8597014925373134,Very Large,465.0,406.5,0.465,0.4065,middle-center,1000000,0.09648,Medium (5-15%)
00002236.jpg,1280,853,363,79,902,496,False,539,417,224763,1.5005861664712778,539,417,224763,1.2925659472422062,Very Large,632.5,287.5,0.494140625,0.33704572098475966,middle-center,1091840,0.20585708528722158,Large (15-30%)
00002236.jpg,1280,853,598,261,1142,683,False,544,422,229568,1.5005861664712778,544,422,229568,1.2890995260663507,Very Large,870.0,472.0,0.6796875,0.5533411488862837,middle-right,1091840,0.21025791324736226,Large (15-30%)
00001059.jpg,857,1024,248,84,383,272,False,135,188,25380,0.8369140625,135,188,25380,0.7180851063829787,Large,315.5,178.0,0.36814469078179696,0.173828125,top-center,877568,0.02892083576429405,Small (1-5%)
00002550.jpg,445,600,120,136,166,209,False,46,73,3358,0.7416666666666667,46,73,3358,0.6301369863013698,Small,143.0,172.5,0.32134831460674157,0.2875,top-left,267000,0.012576779026217228,Small (1-5%)
00002544.jpg,660,424,206,1,437,174,False,231,173,39963,1.5566037735849056,231,173,39963,1.3352601156069364,Large,321.5,87.5,0.4871212121212121,0.20636792452830188,top-center,279840,0.1428066037735849,Medium (5-15%)
00000353.jpg,700,466,263,81,376,168,False,113,87,9831,1.502145922746781,113,87,9831,1.2988505747126438,Medium,319.5,124.5,0.4564285714285714,0.26716738197424894,top-center,326200,0.030137952176578785,Small (1-5%)
00001918.jpg,800,533,282,41,534,236,False,252,195,49140,1.5009380863039399,252,195,49140,1.2923076923076924,Large,408.0,138.5,0.51,0.2598499061913696,top-center,426400,0.1152439024390244,Medium (5-15%)
00001924.jpg,360,254,89,14,273,165,False,184,151,27784,1.4173228346456692,184,151,27784,1.218543046357616,Large,181.0,89.5,0.5027777777777778,0.35236220472440943,middle-center,91440,0.3038495188101487,Very Large (>30%)
00002593.jpg,467,700,161,266,255,428,False,94,162,15228,0.6671428571428571,94,162,15228,0.5802469135802469,Medium,208.0,347.0,0.44539614561027835,0.4957142857142857,middle-center,326900,0.046583052921382685,Small (1-5%)
00002587.jpg,210,280,85,26,132,99,False,47,73,3431,0.75,47,73,3431,0.6438356164383562,Small,108.5,62.5,0.5166666666666667,0.22321428571428573,top-center,58800,0.058350340136054425,Medium (5-15%)
00001930.jpg,682,1023,195,1,384,123,False,189,122,23058,0.6666666666666666,189,122,23058,1.5491803278688525,Large,289.5,62.0,0.4244868035190616,0.06060606060606061,top-center,697686,0.03304925138242705,Small (1-5%)
00001267.jpg,500,749,198,174,298,344,False,100,170,17000,0.6675567423230975,100,170,17000,0.5882352941176471,Medium,248.0,259.0,0.496,0.34579439252336447,middle-center,374500,0.04539385847797063,Small (1-5%)
00000179.jpg,1500,2250,704,409,854,671,False,150,262,39300,0.6666666666666666,150,262,39300,0.5725190839694656,Large,779.0,540.0,0.5193333333333333,0.24,top-center,3375000,0.011644444444444445,Small (1-5%)
00003470.jpg,236,157,54,46,140,112,False,86,66,5676,1.5031847133757963,86,66,5676,1.303030303030303,Medium,97.0,79.0,0.4110169491525424,0.5031847133757962,middle-center,37052,0.1531901111950772,Large (15-30%)
00002008.jpg,2936,1960,1168,278,1755,735,False,587,457,268259,1.4979591836734694,587,457,268259,1.2844638949671772,Very Large,1461.5,506.5,0.49778610354223435,0.2584183673469388,top-center,5754560,0.04661677000500473,Small (1-5%)
00001501.jpg,1200,1800,473,208,616,457,False,143,249,35607,0.6666666666666666,143,249,35607,0.5742971887550201,Large,544.5,332.5,0.45375,0.18472222222222223,top-center,2160000,0.016484722222222224,Small (1-5%)
00001515.jpg,1300,867,389,171,780,468,False,391,297,116127,1.4994232987312572,391,297,116127,1.3164983164983164,Very Large,584.5,319.5,0.44961538461538464,0.3685121107266436,middle-center,1127100,0.1030316742081448,Medium (5-15%)
00003302.jpg,1600,1600,567,278,947,712,False,380,434,164920,1.0,380,434,164920,0.8755760368663594,Very Large,757.0,495.0,0.473125,0.309375,top-center,2560000,0.064421875,Medium (5-15%)
00003464.jpg,236,330,76,108,128,194,False,52,86,4472,0.7151515151515152,52,86,4472,0.6046511627906976,Small,102.0,151.0,0.4322033898305085,0.4575757575757576,middle-center,77880,0.05742167437082691,Medium (5-15%)
00001273.jpg,417,626,104,70,241,309,False,137,239,32743,0.6661341853035144,137,239,32743,0.5732217573221757,Large,172.5,189.5,0.4136690647482014,0.3027156549520767,top-center,261042,0.12543192283234117,Medium (5-15%)
00000145.jpg,866,1390,353,101,526,418,False,173,317,54841,0.6230215827338129,173,317,54841,0.5457413249211357,Very Large,439.5,259.5,0.5075057736720554,0.1866906474820144,top-center,1203740,0.04555884161031452,Small (1-5%)
00000623.jpg,2000,1333,1121,416,1697,863,False,576,447,257472,1.5003750937734435,576,447,257472,1.2885906040268456,Very Large,1409.0,639.5,0.7045,0.4797449362340585,middle-right,2666000,0.096576144036009,Medium (5-15%)
00000623.jpg,2000,1333,1015,213,1441,544,False,426,331,141006,1.5003750937734435,426,331,141006,1.2870090634441087,Very Large,1228.0,378.5,0.614,0.28394598649662417,top-center,2666000,0.052890472618154535,Medium (5-15%)
00000623.jpg,2000,1333,202,409,887,941,False,685,532,364420,1.5003750937734435,685,532,364420,1.287593984962406,Very Large,544.5,675.0,0.27225,0.5063765941485371,middle-left,2666000,0.13669167291822956,Medium (5-15%)
00000623.jpg,2000,1333,748,467,1300,904,False,552,437,241224,1.5003750937734435,552,437,241224,1.263157894736842,Very Large,1024.0,685.5,0.512,0.5142535633908477,middle-center,2666000,0.09048162040510127,Medium (5-15%)
00000623.jpg,2000,1333,1496,111,1905,428,False,409,317,129653,1.5003750937734435,409,317,129653,1.2902208201892744,Very Large,1700.5,269.5,0.85025,0.2021755438859715,top-right,2666000,0.048632033008252064,Small (1-5%)
00002034.jpg,510,340,115,124,214,202,False,99,78,7722,1.5,99,78,7722,1.2692307692307692,Medium,164.5,163.0,0.32254901960784316,0.47941176470588237,middle-left,173400,0.04453287197231834,Small (1-5%)
00002034.jpg,510,340,242,14,393,131,False,151,117,17667,1.5,151,117,17667,1.2905982905982907,Medium,317.5,72.5,0.6225490196078431,0.21323529411764705,top-center,173400,0.10188581314878893,Medium (5-15%)
00002034.jpg,510,340,164,63,317,182,False,153,119,18207,1.5,153,119,18207,1.2857142857142858,Medium,240.5,122.5,0.4715686274509804,0.3602941176470588,middle-center,173400,0.105,Medium (5-15%)
00002020.jpg,800,533,556,103,685,203,False,129,100,12900,1.5009380863039399,129,100,12900,1.29,Medium,620.5,153.0,0.775625,0.2870544090056285,top-right,426400,0.03025328330206379,Small (1-5%)
00002020.jpg,800,533,336,51,483,164,False,147,113,16611,1.5009380863039399,147,113,16611,1.3008849557522124,Medium,409.5,107.5,0.511875,0.20168855534709193,top-center,426400,0.03895637898686679,Small (1-5%)
00002020.jpg,800,533,103,109,226,206,False,123,97,11931,1.5009380863039399,123,97,11931,1.268041237113402,Medium,164.5,157.5,0.205625,0.2954971857410882,top-left,426400,0.02798076923076923,Small (1-5%)
00000637.jpg,1300,956,691,106,1027,393,False,336,287,96432,1.3598326359832635,336,287,96432,1.170731707317073,Very Large,859.0,249.5,0.6607692307692308,0.26098326359832635,top-center,1242800,0.07759253299002253,Medium (5-15%)
00000637.jpg,1300,956,440,303,907,712,False,467,409,191003,1.3598326359832635,467,409,191003,1.1418092909535453,Very Large,673.5,507.5,0.5180769230769231,0.5308577405857741,middle-center,1242800,0.15368764081107178,Large (15-30%)
00000637.jpg,1300,956,563,79,829,301,False,266,222,59052,1.3598326359832635,266,222,59052,1.1981981981981982,Very Large,696.0,190.0,0.5353846153846153,0.19874476987447698,top-center,1242800,0.04751528805922112,Small (1-5%)
00000637.jpg,1300,956,348,141,602,359,False,254,218,55372,1.3598326359832635,254,218,55372,1.165137614678899,Very Large,475.0,250.0,0.36538461538461536,0.2615062761506276,top-center,1242800,0.04455423237850016,Small (1-5%)
00000637.jpg,1300,956,908,12,1157,220,False,249,208,51792,1.3598326359832635,249,208,51792,1.1971153846153846,Very Large,1032.5,116.0,0.7942307692307692,0.12133891213389121,top-right,1242800,0.041673640167364016,Small (1-5%)
00000637.jpg,1300,956,5,125,364,482,False,359,357,128163,1.3598326359832635,359,357,128163,1.0056022408963585,Very Large,184.5,303.5,0.14192307692307693,0.3174686192468619,top-left,1242800,0.10312439652397812,Medium (5-15%)
00001529.jpg,683,1024,214,103,410,439,False,196,336,65856,0.6669921875,196,336,65856,0.5833333333333334,Very Large,312.0,271.0,0.4568081991215227,0.2646484375,top-center,699392,0.09416178623718888,Medium (5-15%)
00000151.jpg,1024,681,328,215,678,487,False,350,272,95200,1.5036710719530102,350,272,95200,1.286764705882353,Very Large,503.0,351.0,0.4912109375,0.5154185022026432,middle-center,697344,0.13651798825256975,Medium (5-15%)
00003458.jpg,236,268,109,14,158,79,False,49,65,3185,0.8805970149253731,49,65,3185,0.7538461538461538,Small,133.5,46.5,0.565677966101695,0.17350746268656717,top-center,63248,0.05035732355173286,Medium (5-15%)
00003458.jpg,236,268,74,54,115,108,False,41,54,2214,0.8805970149253731,41,54,2214,0.7592592592592593,Small,94.5,81.0,0.4004237288135593,0.30223880597014924,top-center,63248,0.03500505944852011,Small (1-5%)
00003458.jpg,236,268,104,100,142,150,False,38,50,1900,0.8805970149253731,38,50,1900,0.76,Small,123.0,125.0,0.5211864406779662,0.4664179104477612,middle-center,63248,0.030040475588160892,Small (1-5%)
00002975.jpg,612,408,240,60,538,291,False,298,231,68838,1.5,298,231,68838,1.29004329004329,Very Large,389.0,175.5,0.6356209150326797,0.43014705882352944,middle-center,249696,0.27568723567858516,Large (15-30%)
00002949.jpg,288,360,109,74,176,170,False,67,96,6432,0.8,67,96,6432,0.6979166666666666,Medium,142.5,122.0,0.4947916666666667,0.3388888888888889,middle-center,103680,0.062037037037037036,Medium (5-15%)
00000838.jpg,799,1024,123,45,588,723,False,465,678,315270,0.7802734375,465,678,315270,0.6858407079646017,Very Large,355.5,384.0,0.4449311639549437,0.375,middle-center,818176,0.38533274014392993,Very Large (>30%)
00001313.jpg,682,1024,230,69,475,488,False,245,419,102655,0.666015625,245,419,102655,0.5847255369928401,Very Large,352.5,278.5,0.5168621700879765,0.27197265625,top-center,698368,0.14699270298753667,Medium (5-15%)
00003504.jpg,236,354,52,96,99,179,False,47,83,3901,0.6666666666666666,47,83,3901,0.5662650602409639,Small,75.5,137.5,0.3199152542372881,0.3884180790960452,middle-left,83544,0.04669395767499761,Small (1-5%)
00003262.jpg,681,1024,284,81,439,347,False,155,266,41230,0.6650390625,155,266,41230,0.5827067669172933,Large,361.5,214.0,0.5308370044052864,0.208984375,top-center,697344,0.05912433461820852,Medium (5-15%)
00001475.jpg,800,532,305,43,556,238,False,251,195,48945,1.5037593984962405,251,195,48945,1.2871794871794873,Large,430.5,140.5,0.538125,0.2640977443609023,top-center,425600,0.11500234962406015,Medium (5-15%)
00001461.jpg,512,512,345,20,459,152,False,114,132,15048,1.0,114,132,15048,0.8636363636363636,Medium,402.0,86.0,0.78515625,0.16796875,top-right,262144,0.057403564453125,Medium (5-15%)
00001461.jpg,512,512,266,72,371,196,False,105,124,13020,1.0,105,124,13020,0.8467741935483871,Medium,318.5,134.0,0.6220703125,0.26171875,top-center,262144,0.0496673583984375,Small (1-5%)
00001461.jpg,512,512,107,247,193,347,False,86,100,8600,1.0,86,100,8600,0.86,Medium,150.0,297.0,0.29296875,0.580078125,middle-left,262144,0.032806396484375,Small (1-5%)
00003276.jpg,681,1024,284,81,439,347,False,155,266,41230,0.6650390625,155,266,41230,0.5827067669172933,Large,361.5,214.0,0.5308370044052864,0.208984375,top-center,697344,0.05912433461820852,Medium (5-15%)
00002168.jpg,1000,792,271,18,439,173,False,168,155,26040,1.2626262626262625,168,155,26040,1.0838709677419356,Large,355.0,95.5,0.355,0.12058080808080808,top-center,792000,0.032878787878787875,Small (1-5%)
00002168.jpg,1000,792,627,39,788,187,False,161,148,23828,1.2626262626262625,161,148,23828,1.087837837837838,Large,707.5,113.0,0.7075,0.14267676767676768,top-right,792000,0.030085858585858587,Small (1-5%)
00002168.jpg,1000,792,493,250,617,362,False,124,112,13888,1.2626262626262625,124,112,13888,1.1071428571428572,Medium,555.0,306.0,0.555,0.38636363636363635,middle-center,792000,0.017535353535353536,Small (1-5%)
00003510.jpg,236,318,85,13,133,89,False,48,76,3648,0.7421383647798742,48,76,3648,0.631578947368421,Small,109.0,51.0,0.461864406779661,0.16037735849056603,top-center,75048,0.04860889031020147,Small (1-5%)
00003510.jpg,236,318,77,91,116,150,False,39,59,2301,0.7421383647798742,39,59,2301,0.6610169491525424,Small,96.5,120.5,0.4088983050847458,0.3789308176100629,middle-center,75048,0.030660377358490566,Small (1-5%)
00001307.jpg,1000,667,403,47,691,266,False,288,219,63072,1.4992503748125936,288,219,63072,1.3150684931506849,Very Large,547.0,156.5,0.547,0.23463268365817092,top-center,667000,0.09456071964017991,Medium (5-15%)
00002626.jpg,612,408,203,103,421,273,False,218,170,37060,1.5,218,170,37060,1.2823529411764707,Large,312.0,188.0,0.5098039215686274,0.46078431372549017,middle-center,249696,0.14842047930283225,Medium (5-15%)
00000031.jpg,434,650,170,328,222,418,False,52,90,4680,0.6676923076923077,52,90,4680,0.5777777777777777,Small,196.0,373.0,0.45161290322580644,0.5738461538461539,middle-center,282100,0.016589861751152075,Small (1-5%)
00000757.jpg,800,582,258,148,479,335,False,221,187,41327,1.3745704467353952,221,187,41327,1.1818181818181819,Large,368.5,241.5,0.460625,0.41494845360824745,middle-center,465600,0.08876073883161512,Medium (5-15%)
00002140.jpg,1001,1600,363,235,521,523,False,158,288,45504,0.625625,158,288,45504,0.5486111111111112,Large,442.0,379.0,0.44155844155844154,0.236875,top-center,1601600,0.02841158841158841,Small (1-5%)
00002154.jpg,1300,861,699,186,840,296,False,141,110,15510,1.5098722415795587,141,110,15510,1.2818181818181817,Medium,769.5,241.0,0.5919230769230769,0.27990708478513354,top-center,1119300,0.013856874832484588,Small (1-5%)
00002801.jpg,819,1024,367,186,608,537,False,241,351,84591,0.7998046875,241,351,84591,0.6866096866096866,Very Large,487.5,361.5,0.5952380952380952,0.35302734375,middle-center,838656,0.10086495535714286,Medium (5-15%)
00002801.jpg,819,1024,1,1,149,139,False,148,138,20424,0.7998046875,148,138,20424,1.0724637681159421,Large,75.0,70.0,0.09157509157509157,0.068359375,top-left,838656,0.024353250915750916,Small (1-5%)
00002801.jpg,819,1024,280,3,517,222,False,237,219,51903,0.7998046875,237,219,51903,1.082191780821918,Very Large,398.5,112.5,0.48656898656898656,0.10986328125,top-center,838656,0.061888307005494504,Medium (5-15%)
00000970.jpg,1024,688,415,1,924,399,False,509,398,202582,1.4883720930232558,509,398,202582,1.278894472361809,Very Large,669.5,200.0,0.65380859375,0.29069767441860467,top-center,704512,0.28754939589389533,Large (15-30%)
00002815.jpg,900,600,369,155,527,278,False,158,123,19434,1.5,158,123,19434,1.2845528455284554,Medium,448.0,216.5,0.49777777777777776,0.36083333333333334,middle-center,540000,0.03598888888888889,Small (1-5%)
00002183.jpg,900,642,374,61,705,335,False,331,274,90694,1.4018691588785046,331,274,90694,1.2080291970802919,Very Large,539.5,198.0,0.5994444444444444,0.308411214953271,top-center,577800,0.1569643475250952,Large (15-30%)
00002183.jpg,900,642,615,233,820,403,False,205,170,34850,1.4018691588785046,205,170,34850,1.2058823529411764,Large,717.5,318.0,0.7972222222222223,0.4953271028037383,middle-right,577800,0.06031498788508134,Medium (5-15%)
00000794.jpg,512,512,97,1,500,430,False,403,429,172887,1.0,403,429,172887,0.9393939393939394,Very Large,298.5,215.5,0.5830078125,0.4208984375,middle-center,262144,0.6595115661621094,Very Large (>30%)
00000958.jpg,600,400,248,90,337,159,False,89,69,6141,1.5,89,69,6141,1.289855072463768,Medium,292.5,124.5,0.4875,0.31125,top-center,240000,0.0255875,Small (1-5%)
00002197.jpg,800,534,296,78,390,150,False,94,72,6768,1.4981273408239701,94,72,6768,1.3055555555555556,Medium,343.0,114.0,0.42875,0.21348314606741572,top-center,427200,0.015842696629213483,Small (1-5%)
00003289.jpg,461,713,127,200,186,306,False,59,106,6254,0.6465638148667602,59,106,6254,0.5566037735849056,Medium,156.5,253.0,0.33947939262472887,0.3548387096774194,middle-center,328693,0.0190268731004311,Small (1-5%)
00002829.jpg,960,642,396,130,773,429,False,377,299,112723,1.4953271028037383,377,299,112723,1.2608695652173914,Very Large,584.5,279.5,0.6088541666666667,0.4353582554517134,middle-center,616320,0.1828968717549325,Large (15-30%)
00000569.jpg,590,394,78,79,252,211,False,174,132,22968,1.49746192893401,174,132,22968,1.3181818181818181,Large,165.0,145.0,0.2796610169491525,0.3680203045685279,middle-left,232460,0.09880409532822851,Medium (5-15%)
00000569.jpg,590,394,440,62,512,118,False,72,56,4032,1.49746192893401,72,56,4032,1.2857142857142858,Small,476.0,90.0,0.8067796610169492,0.22842639593908629,top-right,232460,0.017344919556052656,Small (1-5%)
00000569.jpg,590,394,381,125,452,181,False,71,56,3976,1.49746192893401,71,56,3976,1.2678571428571428,Small,416.5,153.0,0.7059322033898305,0.3883248730964467,middle-right,232460,0.017104017895551923,Small (1-5%)
00000569.jpg,590,394,246,77,330,143,False,84,66,5544,1.49746192893401,84,66,5544,1.2727272727272727,Medium,288.0,110.0,0.488135593220339,0.27918781725888325,top-center,232460,0.0238492643895724,Small (1-5%)
00002418.jpg,1023,682,243,64,557,307,False,314,243,76302,1.5,314,243,76302,1.2921810699588476,Very Large,400.0,185.5,0.39100684261974583,0.2719941348973607,top-center,697686,0.10936438455121646,Medium (5-15%)
00001105.jpg,1024,682,433,64,956,470,False,523,406,212338,1.501466275659824,523,406,212338,1.2881773399014778,Very Large,694.5,267.0,0.67822265625,0.3914956011730205,middle-right,698368,0.3040488682184751,Very Large (>30%)
00003074.jpg,1600,1154,350,280,540,436,False,190,156,29640,1.3864818024263432,190,156,29640,1.2179487179487178,Large,445.0,358.0,0.278125,0.31022530329289427,top-left,1846400,0.016052859618717503,Small (1-5%)
00001663.jpg,866,1300,339,230,509,532,False,170,302,51340,0.6661538461538462,170,302,51340,0.5629139072847682,Very Large,424.0,381.0,0.4896073903002309,0.29307692307692307,top-center,1125800,0.04560312666548232,Small (1-5%)
00001893.jpg,875,1390,385,99,712,690,False,327,591,193257,0.6294964028776978,327,591,193257,0.5532994923857868,Very Large,548.5,394.5,0.6268571428571429,0.28381294964028775,top-center,1216250,0.15889578622816034,Large (15-30%)
00000233.jpg,1300,1300,549,628,787,906,False,238,278,66164,1.0,238,278,66164,0.8561151079136691,Very Large,668.0,767.0,0.5138461538461538,0.59,middle-center,1690000,0.03915029585798817,Small (1-5%)
00002430.jpg,728,546,145,41,443,301,False,298,260,77480,1.3333333333333333,298,260,77480,1.146153846153846,Very Large,294.0,171.0,0.40384615384615385,0.3131868131868132,top-center,397488,0.19492412349555208,Large (15-30%)
00001139.jpg,700,1050,305,58,507,410,False,202,352,71104,0.6666666666666666,202,352,71104,0.5738636363636364,Very Large,406.0,234.0,0.58,0.22285714285714286,top-center,735000,0.09674013605442176,Medium (5-15%)
00002356.jpg,359,320,66,41,104,80,False,38,39,1482,1.121875,38,39,1482,0.9743589743589743,Small,85.0,60.5,0.23676880222841226,0.1890625,top-left,114880,0.01290041782729805,Small (1-5%)
00003048.jpg,2000,1333,242,318,1065,956,False,823,638,525074,1.5003750937734435,823,638,525074,1.2899686520376175,Very Large,653.5,637.0,0.32675,0.4778694673668417,middle-left,2666000,0.19695198799699926,Large (15-30%)
00003048.jpg,2000,1333,1093,339,1778,870,False,685,531,363735,1.5003750937734435,685,531,363735,1.2900188323917137,Very Large,1435.5,604.5,0.71775,0.45348837209302323,middle-right,2666000,0.13643473368342085,Medium (5-15%)
00001878.jpg,600,332,105,15,208,83,False,103,68,7004,1.8072289156626506,103,68,7004,1.5147058823529411,Medium,156.5,49.0,0.2608333333333333,0.14759036144578314,top-left,199200,0.03516064257028113,Small (1-5%)
00001688.jpg,408,612,222,25,286,135,False,64,110,7040,0.6666666666666666,64,110,7040,0.5818181818181818,Medium,254.0,80.0,0.6225490196078431,0.13071895424836602,top-center,249696,0.02819428424964757,Small (1-5%)
00001850.jpg,596,900,272,182,334,291,False,62,109,6758,0.6622222222222223,62,109,6758,0.5688073394495413,Medium,303.0,236.5,0.5083892617449665,0.2627777777777778,top-center,536400,0.012598806860551827,Small (1-5%)
00001844.jpg,1600,1165,519,78,806,321,False,287,243,69741,1.3733905579399142,287,243,69741,1.1810699588477367,Very Large,662.5,199.5,0.4140625,0.17124463519313304,top-center,1864000,0.03741469957081545,Small (1-5%)
00001844.jpg,1600,1165,898,103,1140,308,False,242,205,49610,1.3733905579399142,242,205,49610,1.1804878048780487,Large,1019.0,205.5,0.636875,0.17639484978540773,top-center,1864000,0.02661480686695279,Small (1-5%)
00000582.jpg,1200,675,314,366,599,553,False,285,187,53295,1.7777777777777777,285,187,53295,1.5240641711229947,Very Large,456.5,459.5,0.3804166666666667,0.6807407407407408,bottom-center,810000,0.0657962962962963,Medium (5-15%)
00000583.jpg,2716,1810,1877,511,2365,889,False,488,378,184464,1.5005524861878452,488,378,184464,1.291005291005291,Very Large,2121.0,700.0,0.7809278350515464,0.3867403314917127,middle-right,4915960,0.03752349490231816,Small (1-5%)
00000583.jpg,2716,1810,774,120,1379,590,False,605,470,284350,1.5005524861878452,605,470,284350,1.2872340425531914,Very Large,1076.5,355.0,0.3963549337260677,0.19613259668508287,top-center,4915960,0.05784221189757443,Medium (5-15%)
00001845.jpg,1500,1120,608,64,943,354,False,335,290,97150,1.3392857142857142,335,290,97150,1.1551724137931034,Very Large,775.5,209.0,0.517,0.18660714285714286,top-center,1680000,0.05782738095238095,Medium (5-15%)
00002380.jpg,746,431,76,31,222,129,False,146,98,14308,1.7308584686774942,146,98,14308,1.489795918367347,Medium,149.0,80.0,0.19973190348525469,0.18561484918793503,top-left,321526,0.04450028924565976,Small (1-5%)
00002380.jpg,746,431,256,47,393,139,False,137,92,12604,1.7308584686774942,137,92,12604,1.4891304347826086,Medium,324.5,93.0,0.43498659517426275,0.21577726218097448,top-center,321526,0.03920056231844392,Small (1-5%)
00002380.jpg,746,431,473,101,585,177,False,112,76,8512,1.7308584686774942,112,76,8512,1.4736842105263157,Medium,529.0,139.0,0.7091152815013405,0.3225058004640371,top-right,321526,0.026473753289003067,Small (1-5%)
00000597.jpg,1440,810,607,241,778,353,False,171,112,19152,1.7777777777777777,171,112,19152,1.5267857142857142,Medium,692.5,297.0,0.4809027777777778,0.36666666666666664,middle-center,1166400,0.016419753086419752,Small (1-5%)
00001851.jpg,1300,867,241,68,785,490,False,544,422,229568,1.4994232987312572,544,422,229568,1.2890995260663507,Very Large,513.0,279.0,0.3946153846153846,0.3217993079584775,top-center,1127100,0.20368024132730014,Large (15-30%)
00001689.jpg,1500,1000,529,160,810,383,False,281,223,62663,1.5,281,223,62663,1.2600896860986548,Very Large,669.5,271.5,0.44633333333333336,0.2715,top-center,1500000,0.04177533333333333,Small (1-5%)
00001689.jpg,1500,1000,946,97,1246,325,False,300,228,68400,1.5,300,228,68400,1.3157894736842106,Very Large,1096.0,211.0,0.7306666666666667,0.211,top-right,1500000,0.0456,Small (1-5%)
00001879.jpg,509,339,141,28,395,225,False,254,197,50038,1.5014749262536873,254,197,50038,1.2893401015228427,Very Large,268.0,126.5,0.5265225933202358,0.37315634218289084,middle-center,172551,0.28998962625542596,Large (15-30%)
00000226.jpg,1000,1500,336,559,458,771,False,122,212,25864,0.6666666666666666,122,212,25864,0.5754716981132075,Large,397.0,665.0,0.397,0.44333333333333336,middle-center,1500000,0.017242666666666667,Small (1-5%)
00001138.jpg,332,519,61,3,242,325,False,181,322,58282,0.6396917148362236,181,322,58282,0.562111801242236,Very Large,151.5,164.0,0.4563253012048193,0.3159922928709056,top-center,172308,0.33824314599438216,Very Large (>30%)
00003049.jpg,600,901,221,187,355,420,False,134,233,31222,0.6659267480577137,134,233,31222,0.575107296137339,Large,288.0,303.5,0.48,0.33684794672586016,middle-center,540600,0.0577543470218276,Medium (5-15%)
00003049.jpg,600,901,374,103,529,374,False,155,271,42005,0.6659267480577137,155,271,42005,0.5719557195571956,Large,451.5,238.5,0.7525,0.2647058823529412,top-right,540600,0.0777007029226785,Medium (5-15%)
00002357.jpg,536,600,178,148,336,353,False,158,205,32390,0.8933333333333333,158,205,32390,0.7707317073170732,Large,257.0,250.5,0.47947761194029853,0.4175,middle-center,321600,0.10071517412935323,Medium (5-15%)
00000540.jpg,612,408,245,138,378,241,False,133,103,13699,1.5,133,103,13699,1.2912621359223302,Medium,311.5,189.5,0.5089869281045751,0.4644607843137255,middle-center,249696,0.05486271305907984,Medium (5-15%)
00000540.jpg,612,408,9,61,174,186,False,165,125,20625,1.5,165,125,20625,1.32,Large,91.5,123.5,0.14950980392156862,0.30269607843137253,top-left,249696,0.08260044213763937,Medium (5-15%)
00000540.jpg,612,408,317,46,424,128,False,107,82,8774,1.5,107,82,8774,1.3048780487804879,Medium,370.5,87.0,0.6053921568627451,0.21323529411764705,top-center,249696,0.035138728694092014,Small (1-5%)
00000540.jpg,612,408,215,46,352,154,False,137,108,14796,1.5,137,108,14796,1.2685185185185186,Medium,283.5,100.0,0.4632352941176471,0.24509803921568626,top-center,249696,0.0592560553633218,Medium (5-15%)
00000540.jpg,612,408,355,90,489,194,False,134,104,13936,1.5,134,104,13936,1.2884615384615385,Medium,422.0,142.0,0.6895424836601307,0.3480392156862745,middle-right,249696,0.05581186723055235,Medium (5-15%)
00000540.jpg,612,408,466,1,612,91,False,146,90,13140,1.5,146,90,13140,1.6222222222222222,Medium,539.0,46.0,0.880718954248366,0.11274509803921569,top-right,249696,0.0526239907727797,Medium (5-15%)
00000540.jpg,612,408,146,43,245,118,False,99,75,7425,1.5,99,75,7425,1.32,Medium,195.5,80.5,0.3194444444444444,0.19730392156862744,top-left,249696,0.029736159169550174,Small (1-5%)
00001886.jpg,612,612,204,22,392,241,False,188,219,41172,1.0,188,219,41172,0.8584474885844748,Large,298.0,131.5,0.4869281045751634,0.21486928104575165,top-center,374544,0.10992566961425093,Medium (5-15%)
00001892.jpg,866,1300,494,32,679,348,False,185,316,58460,0.6661538461538462,185,316,58460,0.5854430379746836,Very Large,586.5,190.0,0.6772517321016166,0.14615384615384616,top-right,1125800,0.0519275182092734,Medium (5-15%)
00002343.jpg,1000,1001,451,666,563,796,False,112,130,14560,0.999000999000999,112,130,14560,0.8615384615384616,Medium,507.0,731.0,0.507,0.7302697302697303,bottom-center,1001000,0.014545454545454545,Small (1-5%)
00002343.jpg,1000,1001,775,41,889,174,False,114,133,15162,0.999000999000999,114,133,15162,0.8571428571428571,Medium,832.0,107.5,0.832,0.10739260739260739,top-right,1001000,0.015146853146853146,Small (1-5%)
00002343.jpg,1000,1001,432,121,556,265,False,124,144,17856,0.999000999000999,124,144,17856,0.8611111111111112,Medium,494.0,193.0,0.494,0.1928071928071928,top-center,1001000,0.017838161838161837,Small (1-5%)
00001104.jpg,700,1050,86,1,604,738,False,518,737,381766,0.6666666666666666,518,737,381766,0.7028493894165536,Very Large,345.0,369.5,0.4928571428571429,0.3519047619047619,middle-center,735000,0.5194095238095238,Very Large (>30%)
00003061.jpg,1651,2190,616,416,826,740,False,210,324,68040,0.7538812785388128,210,324,68040,0.6481481481481481,Very Large,721.0,578.0,0.43670502725620836,0.2639269406392694,top-center,3615690,0.01881798494893091,Small (1-5%)
00001676.jpg,736,1492,125,132,406,794,False,281,662,186022,0.4932975871313673,281,662,186022,0.4244712990936556,Very Large,265.5,463.0,0.3607336956521739,0.31032171581769435,top-center,1098112,0.16940166394684694,Large (15-30%)
00002419.jpg,660,440,283,206,421,313,False,138,107,14766,1.5,138,107,14766,1.2897196261682242,Medium,352.0,259.5,0.5333333333333333,0.5897727272727272,middle-center,290400,0.05084710743801653,Medium (5-15%)
00003288.jpg,272,340,137,85,167,129,False,30,44,1320,0.8,30,44,1320,0.6818181818181818,Small,152.0,107.0,0.5588235294117647,0.31470588235294117,top-center,92480,0.014273356401384083,Small (1-5%)
00000959.jpg,1125,1500,248,174,904,1169,False,656,995,652720,0.75,656,995,652720,0.6592964824120603,Very Large,576.0,671.5,0.512,0.44766666666666666,middle-center,1687500,0.38679703703703705,Very Large (>30%)
00002828.jpg,600,338,139,57,453,263,False,314,206,64684,1.7751479289940828,314,206,64684,1.5242718446601942,Very Large,296.0,160.0,0.49333333333333335,0.47337278106508873,middle-center,202800,0.31895463510848127,Very Large (>30%)
00000965.jpg,1334,2000,520,325,977,1105,False,457,780,356460,0.667,457,780,356460,0.5858974358974359,Very Large,748.5,715.0,0.5610944527736131,0.3575,middle-center,2668000,0.13360569715142429,Medium (5-15%)
00002814.jpg,1024,682,418,152,628,311,False,210,159,33390,1.501466275659824,210,159,33390,1.320754716981132,Large,523.0,231.5,0.5107421875,0.33944281524926684,middle-center,698368,0.04781146902492669,Small (1-5%)
00002814.jpg,1024,682,585,190,809,363,False,224,173,38752,1.501466275659824,224,173,38752,1.2947976878612717,Large,697.0,276.5,0.6806640625,0.40542521994134895,middle-right,698368,0.055489369501466275,Medium (5-15%)
00002814.jpg,1024,682,256,164,465,326,False,209,162,33858,1.501466275659824,209,162,33858,1.2901234567901234,Large,360.5,245.0,0.35205078125,0.3592375366568915,middle-center,698368,0.04848160282258065,Small (1-5%)
00002800.jpg,1500,1000,106,38,609,428,False,503,390,196170,1.5,503,390,196170,1.2897435897435898,Very Large,357.5,233.0,0.23833333333333334,0.233,top-left,1500000,0.13078,Medium (5-15%)
00002800.jpg,1500,1000,896,22,1435,441,False,539,419,225841,1.5,539,419,225841,1.2863961813842482,Very Large,1165.5,231.5,0.777,0.2315,top-right,1500000,0.15056066666666668,Large (15-30%)
00002800.jpg,1500,1000,414,276,794,570,False,380,294,111720,1.5,380,294,111720,1.2925170068027212,Very Large,604.0,423.0,0.4026666666666667,0.423,middle-center,1500000,0.07448,Medium (5-15%)
00002800.jpg,1500,1000,3,335,435,685,False,432,350,151200,1.5,432,350,151200,1.2342857142857142,Very Large,219.0,510.0,0.146,0.51,middle-left,1500000,0.1008,Medium (5-15%)
00002633.jpg,750,501,189,106,268,167,False,79,61,4819,1.4970059880239521,79,61,4819,1.2950819672131149,Small,228.5,136.5,0.30466666666666664,0.27245508982035926,top-left,375750,0.012825016633399867,Small (1-5%)
00002633.jpg,750,501,274,81,372,155,False,98,74,7252,1.4970059880239521,98,74,7252,1.3243243243243243,Medium,323.0,118.0,0.43066666666666664,0.23552894211576847,top-center,375750,0.019300066533599468,Small (1-5%)
00002633.jpg,750,501,376,76,473,151,False,97,75,7275,1.4970059880239521,97,75,7275,1.2933333333333332,Medium,424.5,113.5,0.566,0.22654690618762474,top-center,375750,0.019361277445109782,Small (1-5%)
00002633.jpg,750,501,402,170,489,238,False,87,68,5916,1.4970059880239521,87,68,5916,1.2794117647058822,Medium,445.5,204.0,0.594,0.40718562874251496,middle-center,375750,0.015744510978043913,Small (1-5%)
00000024.jpg,829,580,167,36,257,109,False,90,73,6570,1.4293103448275861,90,73,6570,1.2328767123287672,Medium,212.0,72.5,0.255729794933655,0.125,top-left,480820,0.013664157065013935,Small (1-5%)
00000024.jpg,829,580,573,38,664,111,False,91,73,6643,1.4293103448275861,91,73,6643,1.2465753424657535,Medium,618.5,74.5,0.7460796139927623,0.12844827586206897,top-right,480820,0.013815981032402978,Small (1-5%)
00002141.jpg,174,238,82,44,117,101,False,35,57,1995,0.7310924369747899,35,57,1995,0.6140350877192983,Small,99.5,72.5,0.5718390804597702,0.30462184873949577,top-center,41412,0.048174442190669374,Small (1-5%)
00001448.jpg,1600,1168,661,228,1074,580,False,413,352,145376,1.36986301369863,413,352,145376,1.1732954545454546,Very Large,867.5,404.0,0.5421875,0.3458904109589041,middle-center,1868800,0.07779109589041096,Medium (5-15%)
00002169.jpg,721,900,253,266,439,536,False,186,270,50220,0.8011111111111111,186,270,50220,0.6888888888888889,Very Large,346.0,401.0,0.4798890429958391,0.44555555555555554,middle-center,648900,0.07739251040221914,Medium (5-15%)
00003277.jpg,626,417,98,90,425,344,False,327,254,83058,1.501199040767386,327,254,83058,1.2874015748031495,Very Large,261.5,217.0,0.41773162939297126,0.5203836930455635,middle-center,261042,0.31817868388994874,Very Large (>30%)
00001460.jpg,670,450,218,10,475,210,False,257,200,51400,1.488888888888889,257,200,51400,1.285,Very Large,346.5,110.0,0.5171641791044777,0.24444444444444444,top-center,301500,0.1704809286898839,Large (15-30%)
00001306.jpg,600,419,153,36,382,226,False,229,190,43510,1.431980906921241,229,190,43510,1.2052631578947368,Large,267.5,131.0,0.44583333333333336,0.3126491646778043,top-center,251400,0.17307080350039777,Large (15-30%)
00000018.jpg,800,534,131,30,628,408,False,497,378,187866,1.4981273408239701,497,378,187866,1.3148148148148149,Very Large,379.5,219.0,0.474375,0.4101123595505618,middle-center,427200,0.4397612359550562,Very Large (>30%)
00003505.jpg,235,157,110,5,172,53,False,62,48,2976,1.4968152866242037,62,48,2976,1.2916666666666667,Small,141.0,29.0,0.6,0.18471337579617833,top-center,36895,0.08066133622442065,Medium (5-15%)
00003505.jpg,235,157,30,49,75,84,False,45,35,1575,1.4968152866242037,45,35,1575,1.2857142857142858,Small,52.5,66.5,0.22340425531914893,0.42356687898089174,middle-left,36895,0.04268871120748069,Small (1-5%)
00003505.jpg,235,157,75,14,131,57,False,56,43,2408,1.4968152866242037,56,43,2408,1.302325581395349,Small,103.0,35.5,0.43829787234042555,0.22611464968152867,top-center,36895,0.0652662962461038,Medium (5-15%)
00001312.jpg,1001,1600,424,366,683,837,False,259,471,121989,0.625625,259,471,121989,0.5498938428874734,Very Large,553.5,601.5,0.5529470529470529,0.3759375,middle-center,1601600,0.07616695804195804,Medium (5-15%)
00001474.jpg,1098,732,23,350,237,517,False,214,167,35738,1.5,214,167,35738,1.281437125748503,Large,130.0,433.5,0.11839708561020036,0.5922131147540983,middle-left,803736,0.044464849154448725,Small (1-5%)
00001474.jpg,1098,732,834,371,1044,534,False,210,163,34230,1.5,210,163,34230,1.2883435582822085,Large,939.0,452.5,0.855191256830601,0.6181693989071039,middle-right,803736,0.04258861118576249,Small (1-5%)
00001474.jpg,1098,732,728,336,901,467,False,173,131,22663,1.5,173,131,22663,1.3206106870229009,Large,814.5,401.5,0.7418032786885246,0.5484972677595629,middle-right,803736,0.028197069684573042,Small (1-5%)
00001474.jpg,1098,732,198,134,368,266,False,170,132,22440,1.5,170,132,22440,1.2878787878787878,Large,283.0,200.0,0.25774134790528236,0.273224043715847,top-left,803736,0.027919615396100213,Small (1-5%)
00001474.jpg,1098,732,126,33,284,156,False,158,123,19434,1.5,158,123,19434,1.2845528455284554,Medium,205.0,94.5,0.18670309653916212,0.1290983606557377,top-left,803736,0.024179581355071814,Small (1-5%)
00001474.jpg,1098,732,831,77,990,200,False,159,123,19557,1.5,159,123,19557,1.2926829268292683,Medium,910.5,138.5,0.8292349726775956,0.18920765027322403,top-right,803736,0.024332616680103916,Small (1-5%)
00001474.jpg,1098,732,934,171,1089,294,False,155,123,19065,1.5,155,123,19065,1.2601626016260163,Medium,1011.5,232.5,0.9212204007285975,0.3176229508196721,top-right,803736,0.023720475379975514,Small (1-5%)
00001474.jpg,1098,732,157,509,407,703,False,250,194,48500,1.5,250,194,48500,1.288659793814433,Large,282.0,606.0,0.2568306010928962,0.8278688524590164,bottom-left,803736,0.060343197268754915,Medium (5-15%)
00003263.jpg,800,533,388,71,526,178,False,138,107,14766,1.5009380863039399,138,107,14766,1.2897196261682242,Medium,457.0,124.5,0.57125,0.23358348968105067,top-center,426400,0.034629455909943714,Small (1-5%)
00000193.jpg,1000,667,477,76,715,260,False,238,184,43792,1.4992503748125936,238,184,43792,1.2934782608695652,Large,596.0,168.0,0.596,0.2518740629685157,top-center,667000,0.06565517241379311,Medium (5-15%)
00002784.jpg,2000,1000,609,164,1372,618,False,763,454,346402,2.0,763,454,346402,1.6806167400881058,Very Large,990.5,391.0,0.49525,0.391,middle-center,2000000,0.173201,Large (15-30%)
00002784.jpg,2000,1000,25,179,740,595,False,715,416,297440,2.0,715,416,297440,1.71875,Very Large,382.5,387.0,0.19125,0.387,middle-left,2000000,0.14872,Medium (5-15%)
00002784.jpg,2000,1000,1260,153,2000,619,False,740,466,344840,2.0,740,466,344840,1.5879828326180256,Very Large,1630.0,386.0,0.815,0.386,middle-right,2000000,0.17242,Large (15-30%)
00001299.jpg,500,750,211,76,368,350,False,157,274,43018,0.6666666666666666,157,274,43018,0.572992700729927,Large,289.5,213.0,0.579,0.284,top-center,375000,0.11471466666666667,Medium (5-15%)
00000839.jpg,1600,1122,966,127,1247,356,False,281,229,64349,1.4260249554367201,281,229,64349,1.2270742358078603,Very Large,1106.5,241.5,0.6915625,0.21524064171122995,top-right,1795200,0.0358450311942959,Small (1-5%)
00000811.jpg,1500,1600,726,130,1139,633,False,413,503,207739,0.9375,413,503,207739,0.8210735586481114,Very Large,932.5,381.5,0.6216666666666667,0.2384375,top-center,2400000,0.08655791666666666,Medium (5-15%)
00002960.jpg,1200,900,734,202,940,382,False,206,180,37080,1.3333333333333333,206,180,37080,1.1444444444444444,Large,837.0,292.0,0.6975,0.3244444444444444,top-right,1080000,0.034333333333333334,Small (1-5%)
00002974.jpg,1024,683,169,104,361,253,False,192,149,28608,1.499267935578331,192,149,28608,1.2885906040268456,Large,265.0,178.5,0.2587890625,0.2613469985358712,top-left,699392,0.040904099560761346,Small (1-5%)
00002974.jpg,1024,683,313,60,513,216,False,200,156,31200,1.499267935578331,200,156,31200,1.2820512820512822,Large,413.0,138.0,0.4033203125,0.2020497803806735,top-center,699392,0.0446101756954612,Small (1-5%)
00002974.jpg,1024,683,421,131,654,312,False,233,181,42173,1.499267935578331,233,181,42173,1.287292817679558,Large,537.5,221.5,0.52490234375,0.32430453879941434,top-center,699392,0.06029951729502196,Medium (5-15%)
00002974.jpg,1024,683,649,211,872,385,False,223,174,38802,1.499267935578331,223,174,38802,1.2816091954022988,Large,760.5,298.0,0.74267578125,0.4363103953147877,middle-right,699392,0.05547961658125915,Medium (5-15%)
00002974.jpg,1024,683,558,30,781,200,False,223,170,37910,1.499267935578331,223,170,37910,1.311764705882353,Large,669.5,115.0,0.65380859375,0.1683748169838946,top-center,699392,0.0542042230966325,Medium (5-15%)
00002974.jpg,1024,683,106,289,335,466,False,229,177,40533,1.499267935578331,229,177,40533,1.2937853107344632,Large,220.5,377.5,0.21533203125,0.5527086383601757,middle-left,699392,0.057954623444363106,Medium (5-15%)
00002974.jpg,1024,683,763,277,1016,478,False,253,201,50853,1.499267935578331,253,201,50853,1.2587064676616915,Very Large,889.5,377.5,0.86865234375,0.5527086383601757,middle-right,699392,0.07271029694363104,Medium (5-15%)
00002974.jpg,1024,683,399,374,664,580,False,265,206,54590,1.499267935578331,265,206,54590,1.2864077669902914,Very Large,531.5,477.0,0.51904296875,0.698389458272328,bottom-center,699392,0.07805350933382138,Medium (5-15%)
00000805.jpg,450,319,196,40,299,125,False,103,85,8755,1.4106583072100314,103,85,8755,1.2117647058823529,Medium,247.5,82.5,0.55,0.25862068965517243,top-center,143550,0.06098920236851271,Medium (5-15%)
00001528.jpg,450,318,206,93,298,168,False,92,75,6900,1.4150943396226414,92,75,6900,1.2266666666666666,Medium,252.0,130.5,0.56,0.41037735849056606,middle-center,143100,0.04821802935010482,Small (1-5%)
00002021.jpg,493,280,243,21,335,82,False,92,61,5612,1.7607142857142857,92,61,5612,1.5081967213114753,Medium,289.0,51.5,0.5862068965517241,0.18392857142857144,top-center,138040,0.040654882642712255,Small (1-5%)
00003459.jpg,236,322,89,27,119,73,False,30,46,1380,0.7329192546583851,30,46,1380,0.6521739130434783,Small,104.0,50.0,0.4406779661016949,0.15527950310559005,top-center,75992,0.018159806295399514,Small (1-5%)
00000150.jpg,1600,1127,512,82,1060,531,False,548,449,246052,1.419698314108252,548,449,246052,1.2204899777282852,Very Large,786.0,306.5,0.49125,0.271960958296362,top-center,1803200,0.13645297249334518,Medium (5-15%)
00002753.jpg,550,366,107,59,252,169,False,145,110,15950,1.5027322404371584,145,110,15950,1.3181818181818181,Medium,179.5,114.0,0.32636363636363636,0.3114754098360656,top-left,201300,0.07923497267759563,Medium (5-15%)
00002753.jpg,550,366,268,105,417,220,False,149,115,17135,1.5027322404371584,149,115,17135,1.2956521739130435,Medium,342.5,162.5,0.6227272727272727,0.44398907103825136,middle-center,201300,0.08512170889220069,Medium (5-15%)
00002753.jpg,550,366,180,77,308,176,False,128,99,12672,1.5027322404371584,128,99,12672,1.292929292929293,Medium,244.0,126.5,0.44363636363636366,0.34562841530054644,middle-center,201300,0.06295081967213115,Medium (5-15%)
00002035.jpg,1500,1120,519,79,971,471,False,452,392,177184,1.3392857142857142,452,392,177184,1.153061224489796,Very Large,745.0,275.0,0.49666666666666665,0.24553571428571427,top-center,1680000,0.10546666666666667,Medium (5-15%)
00003303.jpg,626,352,462,41,572,113,False,110,72,7920,1.7784090909090908,110,72,7920,1.5277777777777777,Medium,517.0,77.0,0.8258785942492013,0.21875,top-right,220352,0.035942492012779555,Small (1-5%)
00003303.jpg,626,352,300,84,446,177,False,146,93,13578,1.7784090909090908,146,93,13578,1.5698924731182795,Medium,373.0,130.5,0.5958466453674122,0.37073863636363635,middle-center,220352,0.061619590473424336,Medium (5-15%)
00003303.jpg,626,352,427,106,563,195,False,136,89,12104,1.7784090909090908,136,89,12104,1.5280898876404494,Medium,495.0,150.5,0.7907348242811502,0.4275568181818182,middle-right,220352,0.0549302933488237,Medium (5-15%)
00003303.jpg,626,352,220,60,340,137,False,120,77,9240,1.7784090909090908,120,77,9240,1.5584415584415585,Medium,280.0,98.5,0.4472843450479233,0.27982954545454547,top-center,220352,0.041932907348242815,Small (1-5%)
00001514.jpg,626,417,142,36,491,306,False,349,270,94230,1.501199040767386,349,270,94230,1.2925925925925925,Very Large,316.5,171.0,0.505591054313099,0.41007194244604317,middle-center,261042,0.3609763946031673,Very Large (>30%)
00001272.jpg,380,280,127,37,304,189,False,177,152,26904,1.3571428571428572,177,152,26904,1.1644736842105263,Large,215.5,113.0,0.5671052631578948,0.4035714285714286,middle-center,106400,0.25285714285714284,Large (15-30%)
00003465.jpg,235,385,87,146,150,267,False,63,121,7623,0.6103896103896104,63,121,7623,0.5206611570247934,Medium,118.5,206.5,0.5042553191489362,0.5363636363636364,middle-center,90475,0.08425531914893616,Medium (5-15%)
00003471.jpg,236,352,60,191,111,279,False,51,88,4488,0.6704545454545454,51,88,4488,0.5795454545454546,Small,85.5,235.0,0.3622881355932203,0.6676136363636364,middle-center,83072,0.05402542372881356,Medium (5-15%)
00003471.jpg,236,352,51,69,119,187,False,68,118,8024,0.6704545454545454,68,118,8024,0.576271186440678,Medium,85.0,128.0,0.3601694915254237,0.36363636363636365,middle-center,83072,0.09659090909090909,Medium (5-15%)
00000178.jpg,650,434,266,106,434,233,False,168,127,21336,1.4976958525345623,168,127,21336,1.3228346456692914,Large,350.0,169.5,0.5384615384615384,0.39055299539170507,middle-center,282100,0.07563275434243176,Medium (5-15%)
00001266.jpg,612,419,146,39,465,293,False,319,254,81026,1.4606205250596658,319,254,81026,1.2559055118110236,Very Large,305.5,166.0,0.4991830065359477,0.39618138424821003,middle-center,256428,0.31597953421623226,Very Large (>30%)
00003317.jpg,390,280,290,30,348,79,False,58,49,2842,1.3928571428571428,58,49,2842,1.183673469387755,Small,319.0,54.5,0.8179487179487179,0.19464285714285715,top-right,109200,0.026025641025641026,Small (1-5%)
00003317.jpg,390,280,195,12,251,59,False,56,47,2632,1.3928571428571428,56,47,2632,1.1914893617021276,Small,223.0,35.5,0.5717948717948718,0.12678571428571428,top-center,109200,0.024102564102564103,Small (1-5%)
00003317.jpg,390,280,150,48,197,86,False,47,38,1786,1.3928571428571428,47,38,1786,1.236842105263158,Small,173.5,67.0,0.44487179487179485,0.2392857142857143,top-center,109200,0.016355311355311354,Small (1-5%)
00003317.jpg,390,280,59,146,113,191,False,54,45,2430,1.3928571428571428,54,45,2430,1.2,Small,86.0,168.5,0.2205128205128205,0.6017857142857143,middle-left,109200,0.022252747252747253,Small (1-5%)
00002009.jpg,512,512,190,1,331,117,False,141,116,16356,1.0,141,116,16356,1.2155172413793103,Medium,260.5,59.0,0.5087890625,0.115234375,top-center,262144,0.0623931884765625,Medium (5-15%)
00001931.jpg,1334,2000,560,174,709,434,False,149,260,38740,0.667,149,260,38740,0.573076923076923,Large,634.5,304.0,0.47563718140929534,0.152,top-center,2668000,0.01452023988005997,Small (1-5%)
00001925.jpg,1335,2000,559,153,826,619,False,267,466,124422,0.6675,267,466,124422,0.572961373390558,Very Large,692.5,386.0,0.5187265917602997,0.193,top-center,2670000,0.0466,Small (1-5%)
00002592.jpg,467,700,201,94,290,246,False,89,152,13528,0.6671428571428571,89,152,13528,0.5855263157894737,Medium,245.5,170.0,0.525695931477516,0.24285714285714285,top-center,326900,0.041382685836647295,Small (1-5%)
00002545.jpg,400,600,171,46,214,122,False,43,76,3268,0.6666666666666666,43,76,3268,0.5657894736842105,Small,192.5,84.0,0.48125,0.14,top-center,240000,0.013616666666666666,Small (1-5%)
00002223.jpg,744,1116,217,205,566,801,False,349,596,208004,0.6666666666666666,349,596,208004,0.5855704697986577,Very Large,391.5,503.0,0.5262096774193549,0.4507168458781362,middle-center,830304,0.2505154738505415,Large (15-30%)
00002237.jpg,768,1122,342,100,517,397,False,175,297,51975,0.6844919786096256,175,297,51975,0.5892255892255892,Very Large,429.5,248.5,0.5592447916666666,0.22147950089126558,top-center,861696,0.060317095588235295,Medium (5-15%)
00002579.jpg,600,285,253,48,411,135,False,158,87,13746,2.1052631578947367,158,87,13746,1.8160919540229885,Medium,332.0,91.5,0.5533333333333333,0.32105263157894737,top-center,171000,0.0803859649122807,Medium (5-15%)
00002579.jpg,600,285,223,21,372,103,False,149,82,12218,2.1052631578947367,149,82,12218,1.8170731707317074,Medium,297.5,62.0,0.49583333333333335,0.21754385964912282,top-center,171000,0.07145029239766082,Medium (5-15%)
00000408.jpg,1000,1500,297,2,784,815,False,487,813,395931,0.6666666666666666,487,813,395931,0.5990159901599016,Very Large,540.5,408.5,0.5405,0.2723333333333333,top-center,1500000,0.263954,Large (15-30%)
00003115.jpg,681,1024,289,157,465,465,False,176,308,54208,0.6650390625,176,308,54208,0.5714285714285714,Very Large,377.0,311.0,0.55359765051395,0.3037109375,top-center,697344,0.07773494860499265,Medium (5-15%)
00001702.jpg,866,1390,304,76,409,273,False,105,197,20685,0.6230215827338129,105,197,20685,0.5329949238578681,Large,356.5,174.5,0.41166281755196305,0.12553956834532373,top-center,1203740,0.01718394337647665,Small (1-5%)
00003103.jpg,1200,628,80,46,538,324,False,458,278,127324,1.910828025477707,458,278,127324,1.6474820143884892,Very Large,309.0,185.0,0.2575,0.2945859872611465,top-left,753600,0.16895435244161358,Large (15-30%)
00003103.jpg,1200,628,829,222,1026,342,False,197,120,23640,1.910828025477707,197,120,23640,1.6416666666666666,Large,927.5,282.0,0.7729166666666667,0.44904458598726116,middle-right,753600,0.03136942675159236,Small (1-5%)
00001072.jpg,1000,667,265,82,566,316,False,301,234,70434,1.4992503748125936,301,234,70434,1.2863247863247864,Very Large,415.5,199.0,0.4155,0.2983508245877061,top-center,667000,0.10559820089955023,Medium (5-15%)
00001066.jpg,1068,1700,382,203,574,551,False,192,348,66816,0.6282352941176471,192,348,66816,0.5517241379310345,Very Large,478.0,377.0,0.44756554307116103,0.22176470588235295,top-center,1815600,0.03680105750165235,Small (1-5%)
00003117.jpg,800,534,330,153,456,249,False,126,96,12096,1.4981273408239701,126,96,12096,1.3125,Medium,393.0,201.0,0.49125,0.37640449438202245,middle-center,427200,0.028314606741573035,Small (1-5%)
00002209.jpg,698,1050,200,93,548,688,False,348,595,207060,0.6647619047619048,348,595,207060,0.584873949579832,Very Large,374.0,390.5,0.5358166189111748,0.3719047619047619,middle-center,732900,0.2825214899713467,Large (15-30%)
00000436.jpg,4461,6680,1810,2047,2340,2991,False,530,944,500320,0.667814371257485,530,944,500320,0.5614406779661016,Very Large,2075.0,2519.0,0.4651423447657476,0.37709580838323353,middle-center,29799480,0.016789554717062175,Small (1-5%)
00002547.jpg,1300,1051,651,324,1198,838,False,547,514,281158,1.236917221693625,547,514,281158,1.0642023346303502,Very Large,924.5,581.0,0.7111538461538461,0.5528068506184586,middle-right,1366300,0.20578057527629365,Large (15-30%)
00002553.jpg,2560,1440,199,1,2203,1280,False,2004,1279,2563116,1.7777777777777777,2004,1279,2563116,1.566849100860047,Very Large,1201.0,640.5,0.469140625,0.44479166666666664,middle-center,3686400,0.6952897135416667,Very Large (>30%)
00000422.jpg,900,601,393,241,562,369,False,169,128,21632,1.497504159733777,169,128,21632,1.3203125,Large,477.5,305.0,0.5305555555555556,0.5074875207986689,middle-center,540900,0.03999260491772971,Small (1-5%)
00001933.jpg,1500,1101,595,67,974,399,False,379,332,125828,1.3623978201634876,379,332,125828,1.141566265060241,Very Large,784.5,233.0,0.523,0.21162579473206175,top-center,1651500,0.0761901301846806,Medium (5-15%)
00002584.jpg,1280,720,561,96,885,312,False,324,216,69984,1.7777777777777777,324,216,69984,1.5,Very Large,723.0,204.0,0.56484375,0.2833333333333333,top-center,921600,0.0759375,Medium (5-15%)
00002584.jpg,1280,720,655,112,979,324,False,324,212,68688,1.7777777777777777,324,212,68688,1.528301886792453,Very Large,817.0,218.0,0.63828125,0.30277777777777776,top-center,921600,0.07453125,Medium (5-15%)
00001099.jpg,612,408,1,1,511,404,False,510,403,205530,1.5,510,403,205530,1.2655086848635235,Very Large,256.0,202.5,0.41830065359477125,0.4963235294117647,middle-center,249696,0.8231209150326797,Very Large (>30%)
00000387.jpg,1280,720,295,1,1280,718,False,985,717,706245,1.7777777777777777,985,717,706245,1.3737796373779638,Very Large,787.5,359.5,0.615234375,0.49930555555555556,middle-center,921600,0.7663248697916667,Very Large (>30%)
00003467.jpg,236,157,44,29,112,83,False,68,54,3672,1.5031847133757963,68,54,3672,1.2592592592592593,Small,78.0,56.0,0.3305084745762712,0.35668789808917195,middle-center,37052,0.09910396199935226,Medium (5-15%)
00003467.jpg,236,157,117,29,187,84,False,70,55,3850,1.5031847133757963,70,55,3850,1.2727272727272727,Small,152.0,56.5,0.6440677966101694,0.35987261146496813,middle-center,37052,0.10390802115945158,Medium (5-15%)
00001270.jpg,1300,956,506,25,994,434,False,488,409,199592,1.3598326359832635,488,409,199592,1.1931540342298288,Very Large,750.0,229.5,0.5769230769230769,0.24006276150627615,top-center,1242800,0.16059864821371098,Large (15-30%)
00003301.jpg,800,800,213,32,357,196,False,144,164,23616,1.0,144,164,23616,0.8780487804878049,Large,285.0,114.0,0.35625,0.1425,top-center,640000,0.0369,Small (1-5%)
00001264.jpg,866,1300,322,628,528,988,False,206,360,74160,0.6661538461538462,206,360,74160,0.5722222222222222,Very Large,425.0,808.0,0.4907621247113164,0.6215384615384615,middle-center,1125800,0.06587315686622847,Medium (5-15%)
00003473.jpg,236,354,61,99,111,187,False,50,88,4400,0.6666666666666666,50,88,4400,0.5681818181818182,Small,86.0,143.0,0.3644067796610169,0.403954802259887,middle-center,83544,0.052666858182514605,Medium (5-15%)
00003473.jpg,236,354,126,15,163,79,False,37,64,2368,0.6666666666666666,37,64,2368,0.578125,Small,144.5,47.0,0.6122881355932204,0.1327683615819209,top-center,83544,0.028344345494589678,Small (1-5%)
00002745.jpg,1024,683,142,223,431,447,False,289,224,64736,1.499267935578331,289,224,64736,1.2901785714285714,Very Large,286.5,335.0,0.27978515625,0.4904831625183016,middle-left,699392,0.0925603953147877,Medium (5-15%)
00002745.jpg,1024,683,588,152,877,376,False,289,224,64736,1.499267935578331,289,224,64736,1.2901785714285714,Very Large,732.5,264.0,0.71533203125,0.38653001464128844,middle-right,699392,0.0925603953147877,Medium (5-15%)
00002745.jpg,1024,683,379,187,674,411,False,295,224,66080,1.499267935578331,295,224,66080,1.3169642857142858,Very Large,526.5,299.0,0.51416015625,0.4377745241581259,middle-center,699392,0.0944820644216691,Medium (5-15%)
00002023.jpg,1600,2000,927,554,1247,1030,False,320,476,152320,0.8,320,476,152320,0.6722689075630253,Very Large,1087.0,792.0,0.679375,0.396,middle-right,3200000,0.0476,Small (1-5%)
00002037.jpg,612,408,81,25,265,168,False,184,143,26312,1.5,184,143,26312,1.2867132867132867,Large,173.0,96.5,0.2826797385620915,0.23651960784313725,top-left,249696,0.1053761373830578,Medium (5-15%)
00002989.jpg,1707,2560,669,652,1130,1457,False,461,805,371105,0.666796875,461,805,371105,0.5726708074534161,Very Large,899.5,1054.5,0.5269478617457528,0.4119140625,middle-center,4369920,0.08492260727885179,Medium (5-15%)
00002751.jpg,1000,666,479,175,598,267,False,119,92,10948,1.5015015015015014,119,92,10948,1.2934782608695652,Medium,538.5,221.0,0.5385,0.33183183183183185,middle-center,666000,0.016438438438438438,Small (1-5%)
00000146.jpg,870,580,488,44,704,208,False,216,164,35424,1.5,216,164,35424,1.3170731707317074,Large,596.0,126.0,0.6850574712643678,0.21724137931034482,top-right,504600,0.07020214030915577,Medium (5-15%)
00002962.jpg,2048,1365,718,567,1295,1006,False,577,439,253303,1.5003663003663004,577,439,253303,1.3143507972665147,Very Large,1006.5,786.5,0.491455078125,0.5761904761904761,middle-center,2795520,0.09061033367673993,Medium (5-15%)
00000813.jpg,2613,1960,6,1,1528,1547,False,1522,1546,2353012,1.3331632653061225,1522,1546,2353012,0.9844760672703752,Very Large,767.0,774.0,0.2935323383084577,0.3948979591836735,middle-left,5121480,0.45943984941852745,Very Large (>30%)
00000807.jpg,1800,1202,816,199,1192,491,False,376,292,109792,1.497504159733777,376,292,109792,1.2876712328767124,Very Large,1004.0,345.0,0.5577777777777778,0.2870216306156406,top-center,2163600,0.050745054538731744,Medium (5-15%)
00002976.jpg,2048,2048,324,687,691,1115,False,367,428,157076,1.0,367,428,157076,0.8574766355140186,Very Large,507.5,901.0,0.247802734375,0.43994140625,middle-left,4194304,0.03744983673095703,Small (1-5%)
00002976.jpg,2048,2048,1595,7,1963,399,False,368,392,144256,1.0,368,392,144256,0.9387755102040817,Very Large,1779.0,203.0,0.86865234375,0.09912109375,top-right,4194304,0.034393310546875,Small (1-5%)
00002786.jpg,768,512,188,63,607,388,False,419,325,136175,1.5,419,325,136175,1.2892307692307692,Very Large,397.5,225.5,0.517578125,0.4404296875,middle-center,393216,0.34631093343098956,Very Large (>30%)
00003498.jpg,235,353,56,84,154,255,False,98,171,16758,0.6657223796033994,98,171,16758,0.5730994152046783,Medium,105.0,169.5,0.44680851063829785,0.4801699716713881,middle-center,82955,0.20201313965402928,Large (15-30%)
00000191.jpg,400,259,162,27,280,115,False,118,88,10384,1.5444015444015444,118,88,10384,1.3409090909090908,Medium,221.0,71.0,0.5525,0.27413127413127414,top-center,103600,0.10023166023166023,Medium (5-15%)
00000191.jpg,400,259,43,46,158,133,False,115,87,10005,1.5444015444015444,115,87,10005,1.3218390804597702,Medium,100.5,89.5,0.25125,0.34555984555984554,middle-left,103600,0.09657335907335908,Medium (5-15%)
00000191.jpg,400,259,268,40,367,114,False,99,74,7326,1.5444015444015444,99,74,7326,1.337837837837838,Medium,317.5,77.0,0.79375,0.2972972972972973,top-right,103600,0.07071428571428572,Medium (5-15%)
00003513.jpg,236,157,59,31,145,97,False,86,66,5676,1.5031847133757963,86,66,5676,1.303030303030303,Medium,102.0,64.0,0.4322033898305085,0.40764331210191085,middle-center,37052,0.1531901111950772,Large (15-30%)
00003275.jpg,236,353,83,82,126,155,False,43,73,3139,0.6685552407932012,43,73,3139,0.589041095890411,Small,104.5,118.5,0.4427966101694915,0.3356940509915014,middle-center,83308,0.03767945455418447,Small (1-5%)
00003261.jpg,612,408,286,57,495,220,False,209,163,34067,1.5,209,163,34067,1.2822085889570551,Large,390.5,138.5,0.6380718954248366,0.3394607843137255,middle-center,249696,0.1364339036268102,Medium (5-15%)
00001476.jpg,408,612,159,101,245,250,False,86,149,12814,0.6666666666666666,86,149,12814,0.5771812080536913,Medium,202.0,175.5,0.4950980392156863,0.2867647058823529,top-center,249696,0.05131840317826477,Medium (5-15%)
00000768.jpg,866,1390,261,56,371,261,False,110,205,22550,0.6230215827338129,110,205,22550,0.5365853658536586,Large,316.0,158.5,0.3648960739030023,0.11402877697841726,top-center,1203740,0.01873328127336468,Small (1-5%)
00002619.jpg,1024,683,780,114,980,269,False,200,155,31000,1.499267935578331,200,155,31000,1.2903225806451613,Large,880.0,191.5,0.859375,0.28038067349926793,top-right,699392,0.044324213030746705,Small (1-5%)
00002619.jpg,1024,683,567,44,781,210,False,214,166,35524,1.499267935578331,214,166,35524,1.2891566265060241,Large,674.0,127.0,0.658203125,0.18594436310395315,top-center,699392,0.05079268850658858,Medium (5-15%)
00002619.jpg,1024,683,464,96,629,227,False,165,131,21615,1.499267935578331,165,131,21615,1.2595419847328244,Large,546.5,161.5,0.53369140625,0.23645680819912152,top-center,699392,0.030905414989019032,Small (1-5%)
00003507.jpg,236,236,38,58,108,137,False,70,79,5530,1.0,70,79,5530,0.8860759493670886,Medium,73.0,97.5,0.3093220338983051,0.413135593220339,middle-left,55696,0.09928899741453605,Medium (5-15%)
00000026.jpg,1600,1158,258,300,783,742,False,525,442,232050,1.381692573402418,525,442,232050,1.1877828054298643,Very Large,520.5,521.0,0.3253125,0.44991364421416236,middle-left,1852800,0.1252428756476684,Medium (5-15%)
00000026.jpg,1600,1158,693,241,1256,715,False,563,474,266862,1.381692573402418,563,474,266862,1.1877637130801688,Very Large,974.5,478.0,0.6090625,0.41278065630397237,middle-center,1852800,0.14403173575129533,Medium (5-15%)
00002631.jpg,2000,1333,874,252,1274,562,False,400,310,124000,1.5003750937734435,400,310,124000,1.2903225806451613,Very Large,1074.0,407.0,0.537,0.30532633158289574,top-center,2666000,0.046511627906976744,Small (1-5%)
00003249.jpg,426,640,126,189,194,307,False,68,118,8024,0.665625,68,118,8024,0.576271186440678,Medium,160.0,248.0,0.3755868544600939,0.3875,middle-center,272640,0.02943075117370892,Small (1-5%)
00003249.jpg,426,640,259,116,331,239,False,72,123,8856,0.665625,72,123,8856,0.5853658536585366,Medium,295.0,177.5,0.6924882629107981,0.27734375,top-right,272640,0.03248239436619718,Small (1-5%)
00002157.jpg,400,453,52,19,223,244,False,171,225,38475,0.8830022075055187,171,225,38475,0.76,Large,137.5,131.5,0.34375,0.2902869757174393,top-center,181200,0.2123344370860927,Large (15-30%)
00000754.jpg,768,1024,307,174,514,495,False,207,321,66447,0.75,207,321,66447,0.6448598130841121,Very Large,410.5,334.5,0.5345052083333334,0.32666015625,top-center,786432,0.08449172973632812,Medium (5-15%)
00002143.jpg,612,408,255,38,495,224,False,240,186,44640,1.5,240,186,44640,1.2903225806451613,Large,375.0,131.0,0.6127450980392157,0.32107843137254904,top-center,249696,0.1787773933102653,Large (15-30%)
00002625.jpg,384,640,153,91,211,204,False,58,113,6554,0.6,58,113,6554,0.5132743362831859,Medium,182.0,147.5,0.4739583333333333,0.23046875,top-center,245760,0.026668294270833334,Small (1-5%)
00002625.jpg,384,640,175,33,217,115,False,42,82,3444,0.6,42,82,3444,0.5121951219512195,Small,196.0,74.0,0.5104166666666666,0.115625,top-center,245760,0.014013671875,Small (1-5%)
00000032.jpg,1600,1157,555,63,1447,830,False,892,767,684164,1.382886776145203,892,767,684164,1.1629726205997393,Very Large,1001.0,446.5,0.625625,0.3859118409680207,middle-center,1851200,0.3695786516853933,Very Large (>30%)
00002816.jpg,700,467,356,53,590,236,False,234,183,42822,1.4989293361884368,234,183,42822,1.278688524590164,Large,473.0,144.5,0.6757142857142857,0.3094218415417559,top-right,326900,0.13099418782502295,Medium (5-15%)
00000973.jpg,1600,1168,530,99,1066,555,False,536,456,244416,1.36986301369863,536,456,244416,1.1754385964912282,Very Large,798.0,327.0,0.49875,0.2799657534246575,top-center,1868800,0.1307876712328767,Medium (5-15%)
00002802.jpg,1024,576,223,129,432,266,False,209,137,28633,1.7777777777777777,209,137,28633,1.5255474452554745,Large,327.5,197.5,0.31982421875,0.3428819444444444,middle-left,589824,0.048544989691840276,Small (1-5%)
00002802.jpg,1024,576,586,19,814,168,False,228,149,33972,1.7777777777777777,228,149,33972,1.5302013422818792,Large,700.0,93.5,0.68359375,0.1623263888888889,top-right,589824,0.057596842447916664,Medium (5-15%)
00002802.jpg,1024,576,828,1,1024,125,False,196,124,24304,1.7777777777777777,196,124,24304,1.5806451612903225,Large,926.0,63.0,0.904296875,0.109375,top-right,589824,0.041205512152777776,Small (1-5%)
00002802.jpg,1024,576,412,57,631,197,False,219,140,30660,1.7777777777777777,219,140,30660,1.5642857142857143,Large,521.5,127.0,0.50927734375,0.2204861111111111,top-center,589824,0.051981608072916664,Medium (5-15%)
00002802.jpg,1024,576,12,210,199,333,False,187,123,23001,1.7777777777777777,187,123,23001,1.5203252032520325,Large,105.5,271.5,0.10302734375,0.4713541666666667,middle-left,589824,0.038996378580729164,Small (1-5%)
00000783.jpg,957,1300,380,199,499,387,False,119,188,22372,0.7361538461538462,119,188,22372,0.6329787234042553,Large,439.5,293.0,0.4592476489028213,0.22538461538461538,top-center,1244100,0.01798247729282212,Small (1-5%)
00002180.jpg,1300,971,586,225,782,392,False,196,167,32732,1.3388259526261586,196,167,32732,1.1736526946107784,Large,684.0,308.5,0.5261538461538462,0.3177136972193615,top-center,1262300,0.025930444426839894,Small (1-5%)
00003077.jpg,332,519,53,121,88,184,False,35,63,2205,0.6396917148362236,35,63,2205,0.5555555555555556,Small,70.5,152.5,0.21234939759036145,0.29383429672447015,top-left,172308,0.012796852148478307,Small (1-5%)
00003077.jpg,332,519,220,101,254,163,False,34,62,2108,0.6396917148362236,34,62,2108,0.5483870967741935,Small,237.0,132.0,0.713855421686747,0.2543352601156069,top-right,172308,0.012233906725166561,Small (1-5%)
00003077.jpg,332,519,93,171,130,238,False,37,67,2479,0.6396917148362236,37,67,2479,0.5522388059701493,Small,111.5,204.5,0.3358433734939759,0.3940269749518304,middle-center,172308,0.014387027880307357,Small (1-5%)
00001660.jpg,400,600,164,42,246,185,False,82,143,11726,0.6666666666666666,82,143,11726,0.5734265734265734,Medium,205.0,113.5,0.5125,0.18916666666666668,top-center,240000,0.04885833333333333,Small (1-5%)
00001106.jpg,1800,1202,553,396,856,632,False,303,236,71508,1.497504159733777,303,236,71508,1.2838983050847457,Very Large,704.5,514.0,0.3913888888888889,0.4276206322795341,middle-center,2163600,0.033050471436494734,Small (1-5%)
00001112.jpg,590,394,280,30,421,139,False,141,109,15369,1.49746192893401,141,109,15369,1.2935779816513762,Medium,350.5,84.5,0.5940677966101695,0.21446700507614214,top-center,232460,0.06611460036135249,Medium (5-15%)
00001674.jpg,1300,956,486,81,764,319,False,278,238,66164,1.3598326359832635,278,238,66164,1.1680672268907564,Very Large,625.0,200.0,0.4807692307692308,0.20920502092050208,top-center,1242800,0.05323785001609269,Medium (5-15%)
00001884.jpg,434,600,98,3,335,375,False,237,372,88164,0.7233333333333334,237,372,88164,0.6370967741935484,Very Large,216.5,189.0,0.4988479262672811,0.315,top-center,260400,0.3385714285714286,Very Large (>30%)
00000542.jpg,1067,1700,249,688,492,1138,False,243,450,109350,0.6276470588235294,243,450,109350,0.54,Very Large,370.5,913.0,0.34723523898781633,0.5370588235294118,middle-center,1813900,0.060284469926677325,Medium (5-15%)
00002433.jpg,2000,2000,1138,294,1392,583,False,254,289,73406,1.0,254,289,73406,0.8788927335640139,Very Large,1265.0,438.5,0.6325,0.21925,top-center,4000000,0.0183515,Small (1-5%)
00000230.jpg,600,400,258,90,456,244,False,198,154,30492,1.5,198,154,30492,1.2857142857142858,Large,357.0,167.0,0.595,0.4175,middle-center,240000,0.12705,Medium (5-15%)
00002341.jpg,1000,624,387,316,571,446,False,184,130,23920,1.6025641025641026,184,130,23920,1.4153846153846155,Large,479.0,381.0,0.479,0.6105769230769231,middle-center,624000,0.03833333333333333,Small (1-5%)
00001890.jpg,800,597,311,39,455,164,False,144,125,18000,1.340033500837521,144,125,18000,1.152,Medium,383.0,101.5,0.47875,0.17001675041876047,top-center,477600,0.03768844221105527,Small (1-5%)
00000556.jpg,2937,1960,796,302,1899,1158,False,1103,856,944168,1.498469387755102,1103,856,944168,1.2885514018691588,Very Large,1347.5,730.0,0.45880149812734083,0.37244897959183676,middle-center,5756520,0.16401714924989402,Large (15-30%)
00000556.jpg,2937,1960,2154,245,2937,1068,False,783,823,644409,1.498469387755102,783,823,644409,0.951397326852977,Very Large,2545.5,656.5,0.8667007150153218,0.3349489795918367,middle-right,5756520,0.11194419545141857,Medium (5-15%)
00000556.jpg,2937,1960,1470,17,2392,733,False,922,716,660152,1.498469387755102,922,716,660152,1.2877094972067038,Very Large,1931.0,375.0,0.6574736125297923,0.1913265306122449,top-center,5756520,0.11467900745589349,Medium (5-15%)
00000556.jpg,2937,1960,9,627,855,1619,False,846,992,839232,1.498469387755102,846,992,839232,0.8528225806451613,Very Large,432.0,1123.0,0.1470888661899898,0.5729591836734694,middle-left,5756520,0.14578808029851367,Medium (5-15%)
00000556.jpg,2937,1960,1161,371,2363,1285,False,1202,914,1098628,1.498469387755102,1202,914,1098628,1.3150984682713347,Very Large,1762.0,828.0,0.5999319033026899,0.42244897959183675,middle-center,5756520,0.19084933258287992,Large (15-30%)
00001648.jpg,1500,1101,739,240,1081,538,False,342,298,101916,1.3623978201634876,342,298,101916,1.1476510067114094,Very Large,910.0,389.0,0.6066666666666667,0.3533151680290645,middle-center,1651500,0.06171117166212534,Medium (5-15%)
00001847.jpg,683,1024,299,179,417,384,False,118,205,24190,0.6669921875,118,205,24190,0.5756097560975609,Large,358.0,281.5,0.5241581259150805,0.27490234375,top-center,699392,0.03458718429721815,Small (1-5%)
00001853.jpg,318,420,159,65,221,160,False,62,95,5890,0.7571428571428571,62,95,5890,0.6526315789473685,Medium,190.0,112.5,0.5974842767295597,0.26785714285714285,top-center,133560,0.04410002994908655,Small (1-5%)
00001853.jpg,318,420,81,128,130,204,False,49,76,3724,0.7571428571428571,49,76,3724,0.6447368421052632,Small,105.5,166.0,0.33176100628930816,0.3952380952380952,middle-center,133560,0.027882599580712788,Small (1-5%)
00001852.jpg,1000,563,7,1,1000,561,False,993,560,556080,1.7761989342806395,993,560,556080,1.7732142857142856,Very Large,503.5,281.0,0.5035,0.4991119005328597,middle-center,563000,0.987708703374778,Very Large (>30%)
00000580.jpg,2937,1960,1438,67,2401,832,False,963,765,736695,1.498469387755102,963,765,736695,1.2588235294117647,Very Large,1919.5,449.5,0.653558052434457,0.22933673469387755,top-center,5756520,0.12797575618602905,Medium (5-15%)
00000580.jpg,2937,1960,720,499,2003,1496,False,1283,997,1279151,1.498469387755102,1283,997,1279151,1.2868605817452357,Very Large,1361.5,997.5,0.46356826693905345,0.5089285714285714,middle-center,5756520,0.22220907770667,Large (15-30%)
00000580.jpg,2937,1960,628,45,1404,661,False,776,616,478016,1.498469387755102,776,616,478016,1.2597402597402598,Very Large,1016.0,353.0,0.3459312223357167,0.18010204081632653,top-center,5756520,0.0830390583199572,Medium (5-15%)
00000580.jpg,2937,1960,4,253,1010,1162,False,1006,909,914454,1.498469387755102,1006,909,914454,1.1067106710671066,Very Large,507.0,707.5,0.17262512768130744,0.36096938775510207,middle-left,5756520,0.15885535010735652,Large (15-30%)
00000580.jpg,2937,1960,2046,9,2937,1096,False,891,1087,968517,1.498469387755102,891,1087,968517,0.8196872125114996,Very Large,2491.5,552.5,0.848314606741573,0.28188775510204084,top-right,5756520,0.16824696170603073,Large (15-30%)
00001846.jpg,600,439,191,39,306,137,False,115,98,11270,1.366742596810934,115,98,11270,1.1734693877551021,Medium,248.5,88.0,0.4141666666666667,0.20045558086560364,top-center,263400,0.04278663629460896,Small (1-5%)
00000231.jpg,1024,683,194,7,791,460,False,597,453,270441,1.499267935578331,597,453,270441,1.3178807947019868,Very Large,492.5,233.5,0.48095703125,0.3418740849194729,middle-center,699392,0.38668014504026355,Very Large (>30%)
00002354.jpg,640,467,220,85,317,167,False,97,82,7954,1.3704496788008564,97,82,7954,1.1829268292682926,Medium,268.5,126.0,0.41953125,0.2698072805139186,top-center,298880,0.026612687366167023,Small (1-5%)
00000543.jpg,1620,1080,588,184,1193,653,False,605,469,283745,1.5,605,469,283745,1.2899786780383795,Very Large,890.5,418.5,0.5496913580246914,0.3875,middle-center,1749600,0.162177069044353,Large (15-30%)
00000543.jpg,1620,1080,105,304,552,659,False,447,355,158685,1.5,447,355,158685,1.2591549295774649,Very Large,328.5,481.5,0.20277777777777778,0.44583333333333336,middle-left,1749600,0.09069787379972565,Medium (5-15%)
00001885.jpg,1300,904,621,108,1038,446,False,417,338,140946,1.4380530973451326,417,338,140946,1.2337278106508875,Very Large,829.5,277.0,0.6380769230769231,0.3064159292035398,top-center,1175200,0.11993362831858408,Medium (5-15%)
00001113.jpg,626,418,236,2,626,152,False,390,150,58500,1.4976076555023923,390,150,58500,2.6,Very Large,431.0,77.0,0.6884984025559105,0.18421052631578946,top-right,261668,0.2235657397924087,Large (15-30%)
00003062.jpg,1400,1050,575,281,805,478,False,230,197,45310,1.3333333333333333,230,197,45310,1.16751269035533,Large,690.0,379.5,0.4928571428571429,0.36142857142857143,middle-center,1470000,0.03082312925170068,Small (1-5%)
00001675.jpg,1600,1168,883,93,1247,410,False,364,317,115388,1.36986301369863,364,317,115388,1.1482649842271293,Very Large,1065.0,251.5,0.665625,0.2153253424657534,top-center,1868800,0.06174443493150685,Medium (5-15%)
00001661.jpg,600,387,213,153,423,307,False,210,154,32340,1.550387596899225,210,154,32340,1.3636363636363635,Large,318.0,230.0,0.53,0.5943152454780362,middle-center,232200,0.1392764857881137,Medium (5-15%)
00003076.jpg,1916,2405,300,65,1544,1882,False,1244,1817,2260348,0.7966735966735967,1244,1817,2260348,0.6846450192625206,Very Large,922.0,973.5,0.4812108559498956,0.4047817047817048,middle-center,4607980,0.4905290387545085,Very Large (>30%)
00000219.jpg,681,1023,253,107,324,228,False,71,121,8591,0.6656891495601173,71,121,8591,0.5867768595041323,Medium,288.5,167.5,0.4236417033773862,0.16373411534701857,top-center,696663,0.012331643850757109,Small (1-5%)
00001107.jpg,533,849,231,68,297,191,False,66,123,8118,0.6277974087161367,66,123,8118,0.5365853658536586,Medium,264.0,129.5,0.49530956848030017,0.1525323910482921,top-center,452517,0.017939657515629245,Small (1-5%)
00001488.jpg,1300,866,147,1,1300,856,False,1153,855,985815,1.5011547344110854,1153,855,985815,1.3485380116959065,Very Large,723.5,428.5,0.5565384615384615,0.49480369515011546,middle-center,1125800,0.8756573103570794,Very Large (>30%)
00000796.jpg,1068,1700,548,114,740,469,False,192,355,68160,0.6282352941176471,192,355,68160,0.5408450704225352,Very Large,644.0,291.5,0.602996254681648,0.17147058823529412,top-center,1815600,0.037541308658294775,Small (1-5%)
00002181.jpg,470,627,197,55,289,198,False,92,143,13156,0.7496012759170654,92,143,13156,0.6433566433566433,Medium,243.0,126.5,0.5170212765957447,0.20175438596491227,top-center,294690,0.04464352370287421,Small (1-5%)
00002195.jpg,584,860,269,131,361,292,False,92,161,14812,0.6790697674418604,92,161,14812,0.5714285714285714,Medium,315.0,211.5,0.5393835616438356,0.24593023255813953,top-center,502240,0.029491876393755972,Small (1-5%)
00000972.jpg,612,408,92,82,231,190,False,139,108,15012,1.5,139,108,15012,1.287037037037037,Medium,161.5,136.0,0.2638888888888889,0.3333333333333333,middle-left,249696,0.060121107266435984,Medium (5-15%)
00002803.jpg,868,1300,358,128,528,424,False,170,296,50320,0.6676923076923077,170,296,50320,0.5743243243243243,Very Large,443.0,276.0,0.5103686635944701,0.2123076923076923,top-center,1128400,0.044594115561857495,Small (1-5%)
00002817.jpg,1500,1000,598,45,835,228,False,237,183,43371,1.5,237,183,43371,1.2950819672131149,Large,716.5,136.5,0.4776666666666667,0.1365,top-center,1500000,0.028914,Small (1-5%)
00002817.jpg,1500,1000,750,32,992,215,False,242,183,44286,1.5,242,183,44286,1.3224043715846994,Large,871.0,123.5,0.5806666666666667,0.1235,top-center,1500000,0.029524,Small (1-5%)
00002817.jpg,1500,1000,474,180,691,348,False,217,168,36456,1.5,217,168,36456,1.2916666666666667,Large,582.5,264.0,0.3883333333333333,0.264,top-center,1500000,0.024304,Small (1-5%)
00002817.jpg,1500,1000,892,243,1083,391,False,191,148,28268,1.5,191,148,28268,1.2905405405405406,Large,987.5,317.0,0.6583333333333333,0.317,top-center,1500000,0.018845333333333332,Small (1-5%)
00000966.jpg,1300,986,294,217,1085,914,False,791,697,551327,1.3184584178498986,791,697,551327,1.1348637015781922,Very Large,689.5,565.5,0.5303846153846153,0.5735294117647058,middle-center,1281800,0.43011936339522544,Very Large (>30%)
00002142.jpg,1200,675,705,100,911,235,False,206,135,27810,1.7777777777777777,206,135,27810,1.525925925925926,Large,808.0,167.5,0.6733333333333333,0.24814814814814815,top-right,810000,0.034333333333333334,Small (1-5%)
00002142.jpg,1200,675,149,4,459,207,False,310,203,62930,1.7777777777777777,310,203,62930,1.5270935960591132,Very Large,304.0,105.5,0.25333333333333335,0.1562962962962963,top-left,810000,0.07769135802469136,Medium (5-15%)
00002142.jpg,1200,675,433,26,695,197,False,262,171,44802,1.7777777777777777,262,171,44802,1.5321637426900585,Large,564.0,111.5,0.47,0.16518518518518518,top-center,810000,0.05531111111111111,Medium (5-15%)
00000755.jpg,800,533,253,42,539,264,False,286,222,63492,1.5009380863039399,286,222,63492,1.2882882882882882,Very Large,396.0,153.0,0.495,0.2870544090056285,top-center,426400,0.14890243902439024,Medium (5-15%)
00002624.jpg,612,408,151,98,263,183,False,112,85,9520,1.5,112,85,9520,1.3176470588235294,Medium,207.0,140.5,0.3382352941176471,0.3443627450980392,middle-center,249696,0.03812636165577342,Small (1-5%)
00001339.jpg,600,419,218,21,331,111,False,113,90,10170,1.431980906921241,113,90,10170,1.2555555555555555,Medium,274.5,66.0,0.4575,0.1575178997613365,top-center,251400,0.04045346062052506,Small (1-5%)
00000741.jpg,1600,1157,304,107,579,339,False,275,232,63800,1.382886776145203,275,232,63800,1.1853448275862069,Very Large,441.5,223.0,0.2759375,0.19273984442523767,top-left,1851200,0.034464131374243735,Small (1-5%)
00000741.jpg,1600,1157,998,39,1267,270,False,269,231,62139,1.382886776145203,269,231,62139,1.1645021645021645,Very Large,1132.5,154.5,0.7078125,0.13353500432152118,top-right,1851200,0.033566875540190146,Small (1-5%)
00000741.jpg,1600,1157,871,137,1118,345,False,247,208,51376,1.382886776145203,247,208,51376,1.1875,Very Large,994.5,241.0,0.6215625,0.20829732065687123,top-center,1851200,0.027752808988764047,Small (1-5%)
00000741.jpg,1600,1157,534,202,781,410,False,247,208,51376,1.382886776145203,247,208,51376,1.1875,Very Large,657.5,306.0,0.4109375,0.2644770959377701,top-center,1851200,0.027752808988764047,Small (1-5%)
00000741.jpg,1600,1157,720,228,978,450,False,258,222,57276,1.382886776145203,258,222,57276,1.162162162162162,Very Large,849.0,339.0,0.530625,0.2929991356957649,top-center,1851200,0.030939930855661192,Small (1-5%)
00000999.jpg,590,884,266,84,337,209,False,71,125,8875,0.667420814479638,71,125,8875,0.568,Medium,301.5,146.5,0.5110169491525424,0.16572398190045248,top-center,521560,0.01701625891556101,Small (1-5%)
00002156.jpg,692,1050,162,164,478,722,False,316,558,176328,0.659047619047619,316,558,176328,0.5663082437275986,Very Large,320.0,443.0,0.4624277456647399,0.4219047619047619,middle-center,726600,0.24267547481420315,Large (15-30%)
00003248.jpg,1300,956,574,119,798,310,False,224,191,42784,1.3598326359832635,224,191,42784,1.1727748691099475,Large,686.0,214.5,0.5276923076923077,0.2243723849372385,top-center,1242800,0.034425490827164465,Small (1-5%)
00003248.jpg,1300,956,388,201,606,388,False,218,187,40766,1.3598326359832635,218,187,40766,1.1657754010695187,Large,497.0,294.5,0.3823076923076923,0.3080543933054393,top-center,1242800,0.032801738010943035,Small (1-5%)
00001477.jpg,4000,6000,1247,517,2503,2710,False,1256,2193,2754408,0.6666666666666666,1256,2193,2754408,0.5727314181486548,Very Large,1875.0,1613.5,0.46875,0.2689166666666667,top-center,24000000,0.114767,Medium (5-15%)
00003260.jpg,480,720,259,216,330,340,False,71,124,8804,0.6666666666666666,71,124,8804,0.5725806451612904,Medium,294.5,278.0,0.6135416666666667,0.3861111111111111,middle-center,345600,0.02547453703703704,Small (1-5%)
00002618.jpg,510,340,218,44,389,177,False,171,133,22743,1.5,171,133,22743,1.2857142857142858,Large,303.5,110.5,0.5950980392156863,0.325,top-center,173400,0.131159169550173,Medium (5-15%)
00001311.jpg,736,942,143,80,544,678,False,401,598,239798,0.7813163481953291,401,598,239798,0.6705685618729097,Very Large,343.5,379.0,0.46671195652173914,0.4023354564755839,middle-center,693312,0.3458731422505308,Very Large (>30%)
00001305.jpg,1300,866,273,146,501,324,False,228,178,40584,1.5011547344110854,228,178,40584,1.2808988764044944,Large,387.0,235.0,0.2976923076923077,0.27136258660508084,top-left,1125800,0.036049031799609166,Small (1-5%)
00001305.jpg,1300,866,475,223,699,397,False,224,174,38976,1.5011547344110854,224,174,38976,1.2873563218390804,Large,587.0,310.0,0.45153846153846156,0.3579676674364896,middle-center,1125800,0.03462071415882039,Small (1-5%)
00001305.jpg,1300,866,574,84,802,265,False,228,181,41268,1.5011547344110854,228,181,41268,1.2596685082872927,Large,688.0,174.5,0.5292307692307693,0.20150115473441108,top-center,1125800,0.036656599751287974,Small (1-5%)
00001463.jpg,2000,1334,678,47,1363,579,False,685,532,364420,1.4992503748125936,685,532,364420,1.287593984962406,Very Large,1020.5,313.0,0.51025,0.23463268365817092,top-center,2668000,0.13658920539730135,Medium (5-15%)
00002787.jpg,720,810,232,159,411,392,False,179,233,41707,0.8888888888888888,179,233,41707,0.7682403433476395,Large,321.5,275.5,0.4465277777777778,0.34012345679012346,middle-center,583200,0.07151406035665295,Medium (5-15%)
00002787.jpg,720,810,360,60,586,350,False,226,290,65540,0.8888888888888888,226,290,65540,0.7793103448275862,Very Large,473.0,205.0,0.6569444444444444,0.25308641975308643,top-center,583200,0.11237997256515775,Medium (5-15%)
00002963.jpg,1800,900,1430,54,1800,315,False,370,261,96570,2.0,370,261,96570,1.417624521072797,Very Large,1615.0,184.5,0.8972222222222223,0.205,top-right,1620000,0.05961111111111111,Medium (5-15%)
00002963.jpg,1800,900,1060,77,1507,327,False,447,250,111750,2.0,447,250,111750,1.788,Very Large,1283.5,202.0,0.7130555555555556,0.22444444444444445,top-right,1620000,0.06898148148148148,Medium (5-15%)
00002963.jpg,1800,900,13,61,458,320,False,445,259,115255,2.0,445,259,115255,1.718146718146718,Very Large,235.5,190.5,0.13083333333333333,0.21166666666666667,top-left,1620000,0.07114506172839506,Medium (5-15%)
00002963.jpg,1800,900,714,498,1169,763,False,455,265,120575,2.0,455,265,120575,1.7169811320754718,Very Large,941.5,630.5,0.5230555555555556,0.7005555555555556,bottom-center,1620000,0.07442901234567902,Medium (5-15%)
00002963.jpg,1800,900,705,78,1151,337,False,446,259,115514,2.0,446,259,115514,1.722007722007722,Very Large,928.0,207.5,0.5155555555555555,0.23055555555555557,top-center,1620000,0.07130493827160495,Medium (5-15%)
00002963.jpg,1800,900,1106,507,1552,767,False,446,260,115960,2.0,446,260,115960,1.7153846153846153,Very Large,1329.0,637.0,0.7383333333333333,0.7077777777777777,bottom-right,1620000,0.07158024691358025,Medium (5-15%)
00000812.jpg,1156,1600,394,218,606,560,False,212,342,72504,0.7225,212,342,72504,0.6198830409356725,Very Large,500.0,389.0,0.43252595155709345,0.243125,top-center,1849600,0.03919982698961938,Small (1-5%)
00000621.jpg,1600,1156,790,259,1083,506,False,293,247,72371,1.3840830449826989,293,247,72371,1.1862348178137652,Very Large,936.5,382.5,0.5853125,0.33088235294117646,middle-center,1849600,0.03912791955017301,Small (1-5%)
00000621.jpg,1600,1156,832,62,979,186,False,147,124,18228,1.3840830449826989,147,124,18228,1.185483870967742,Medium,905.5,124.0,0.5659375,0.10726643598615918,top-center,1849600,0.009855103806228374,Tiny (<1%)
00000621.jpg,1600,1156,511,193,681,336,False,170,143,24310,1.3840830449826989,170,143,24310,1.1888111888111887,Large,596.0,264.5,0.3725,0.22880622837370243,top-center,1849600,0.013143382352941177,Small (1-5%)
00000621.jpg,1600,1156,611,303,786,450,False,175,147,25725,1.3840830449826989,175,147,25725,1.1904761904761905,Large,698.5,376.5,0.4365625,0.32569204152249137,top-center,1849600,0.013908412629757786,Small (1-5%)
00001259.jpg,1500,1101,811,99,1359,567,False,548,468,256464,1.3623978201634876,548,468,256464,1.170940170940171,Very Large,1085.0,333.0,0.7233333333333334,0.3024523160762943,top-right,1651500,0.15529155313351498,Large (15-30%)
00002988.jpg,321,254,126,75,209,151,False,83,76,6308,1.263779527559055,83,76,6308,1.0921052631578947,Medium,167.5,113.0,0.5218068535825545,0.4448818897637795,middle-center,81534,0.07736649741212255,Medium (5-15%)
00002744.jpg,681,1024,308,131,435,354,False,127,223,28321,0.6650390625,127,223,28321,0.5695067264573991,Large,371.5,242.5,0.5455212922173275,0.23681640625,top-center,697344,0.04061266749265786,Small (1-5%)
00000153.jpg,1500,844,1034,77,1327,269,False,293,192,56256,1.7772511848341233,293,192,56256,1.5260416666666667,Very Large,1180.5,173.0,0.787,0.20497630331753555,top-right,1266000,0.044436018957345974,Small (1-5%)
00000153.jpg,1500,844,155,56,442,248,False,287,192,55104,1.7772511848341233,287,192,55104,1.4947916666666667,Very Large,298.5,152.0,0.199,0.18009478672985782,top-left,1266000,0.0435260663507109,Small (1-5%)
00002022.jpg,1440,810,463,48,978,393,False,515,345,177675,1.7777777777777777,515,345,177675,1.4927536231884058,Very Large,720.5,220.5,0.5003472222222223,0.2722222222222222,top-center,1166400,0.15232767489711935,Large (15-30%)
00003314.jpg,1335,2000,769,297,1197,1044,False,428,747,319716,0.6675,428,747,319716,0.5729585006693441,Very Large,983.0,670.5,0.7363295880149813,0.33525,middle-right,2670000,0.1197438202247191,Medium (5-15%)
00003472.jpg,236,140,27,1,169,99,False,142,98,13916,1.6857142857142857,142,98,13916,1.4489795918367347,Medium,98.0,50.0,0.4152542372881356,0.35714285714285715,middle-center,33040,0.4211864406779661,Very Large (>30%)
00003472.jpg,236,140,91,1,235,105,False,144,104,14976,1.6857142857142857,144,104,14976,1.3846153846153846,Medium,163.0,53.0,0.690677966101695,0.37857142857142856,middle-right,33040,0.45326876513317194,Very Large (>30%)
00001271.jpg,667,1000,305,170,373,289,False,68,119,8092,0.667,68,119,8092,0.5714285714285714,Medium,339.0,229.5,0.5082458770614693,0.2295,top-center,667000,0.012131934032983509,Small (1-5%)
00003300.jpg,236,280,109,17,141,62,False,32,45,1440,0.8428571428571429,32,45,1440,0.7111111111111111,Small,125.0,39.5,0.5296610169491526,0.14107142857142857,top-center,66080,0.021791767554479417,Small (1-5%)
00001517.jpg,462,280,80,1,445,183,False,365,182,66430,1.65,365,182,66430,2.0054945054945055,Very Large,262.5,92.0,0.5681818181818182,0.32857142857142857,top-center,129360,0.5135281385281385,Very Large (>30%)
00000609.jpg,390,280,246,28,328,96,False,82,68,5576,1.3928571428571428,82,68,5576,1.2058823529411764,Medium,287.0,62.0,0.735897435897436,0.22142857142857142,top-right,109200,0.05106227106227106,Medium (5-15%)
00000609.jpg,390,280,188,73,266,138,False,78,65,5070,1.3928571428571428,78,65,5070,1.2,Medium,227.0,105.5,0.5820512820512821,0.3767857142857143,middle-center,109200,0.04642857142857143,Small (1-5%)
00000609.jpg,390,280,128,122,219,196,False,91,74,6734,1.3928571428571428,91,74,6734,1.2297297297297298,Medium,173.5,159.0,0.44487179487179485,0.5678571428571428,middle-center,109200,0.06166666666666667,Medium (5-15%)
00000609.jpg,390,280,213,159,293,225,False,80,66,5280,1.3928571428571428,80,66,5280,1.2121212121212122,Medium,253.0,192.0,0.6487179487179487,0.6857142857142857,bottom-center,109200,0.04835164835164835,Small (1-5%)
00000609.jpg,390,280,108,21,187,88,False,79,67,5293,1.3928571428571428,79,67,5293,1.1791044776119404,Medium,147.5,54.5,0.3782051282051282,0.19464285714285715,top-center,109200,0.04847069597069597,Small (1-5%)
00000609.jpg,390,280,53,104,131,169,False,78,65,5070,1.3928571428571428,78,65,5070,1.2,Medium,92.0,136.5,0.2358974358974359,0.4875,middle-left,109200,0.04642857142857143,Small (1-5%)
00000609.jpg,390,280,267,132,366,214,False,99,82,8118,1.3928571428571428,99,82,8118,1.2073170731707317,Medium,316.5,173.0,0.8115384615384615,0.6178571428571429,middle-right,109200,0.07434065934065934,Medium (5-15%)
00000609.jpg,390,280,195,12,265,71,False,70,59,4130,1.3928571428571428,70,59,4130,1.1864406779661016,Small,230.0,41.5,0.5897435897435898,0.14821428571428572,top-center,109200,0.03782051282051282,Small (1-5%)
00000609.jpg,390,280,82,144,160,209,False,78,65,5070,1.3928571428571428,78,65,5070,1.2,Medium,121.0,176.5,0.31025641025641026,0.6303571428571428,middle-left,109200,0.04642857142857143,Small (1-5%)
00000386.jpg,650,434,151,103,290,210,False,139,107,14873,1.4976958525345623,139,107,14873,1.2990654205607477,Medium,220.5,156.5,0.3392307692307692,0.36059907834101385,middle-center,282100,0.05272243885147111,Medium (5-15%)
00001926.jpg,1600,1156,180,7,1241,919,False,1061,912,967632,1.3840830449826989,1061,912,967632,1.1633771929824561,Very Large,710.5,463.0,0.4440625,0.4005190311418685,middle-center,1849600,0.5231574394463668,Very Large (>30%)
00000423.jpg,1001,1620,284,50,643,728,False,359,678,243402,0.6179012345679012,359,678,243402,0.5294985250737463,Very Large,463.5,389.0,0.463036963036963,0.24012345679012345,top-center,1621620,0.1500980500980501,Large (15-30%)
00002220.jpg,364,480,53,38,316,442,False,263,404,106252,0.7583333333333333,263,404,106252,0.650990099009901,Very Large,184.5,240.0,0.5068681318681318,0.5,middle-center,174720,0.6081272893772893,Very Large (>30%)
00000351.jpg,1300,956,529,104,929,446,False,400,342,136800,1.3598326359832635,400,342,136800,1.1695906432748537,Very Large,729.0,275.0,0.5607692307692308,0.28765690376569036,top-center,1242800,0.11007402639201802,Medium (5-15%)
00001067.jpg,500,333,160,27,389,208,False,229,181,41449,1.5015015015015014,229,181,41449,1.2651933701657458,Large,274.5,117.5,0.549,0.35285285285285284,middle-center,166500,0.24894294294294295,Large (15-30%)
00000379.jpg,467,700,238,18,297,121,False,59,103,6077,0.6671428571428571,59,103,6077,0.5728155339805825,Medium,267.5,69.5,0.5728051391862955,0.09928571428571428,top-center,326900,0.018589782808198226,Small (1-5%)
00003116.jpg,1280,854,433,277,673,459,False,240,182,43680,1.4988290398126465,240,182,43680,1.3186813186813187,Large,553.0,368.0,0.43203125,0.4309133489461358,middle-center,1093120,0.039959016393442626,Small (1-5%)
00001701.jpg,433,650,172,116,267,281,False,95,165,15675,0.6661538461538462,95,165,15675,0.5757575757575758,Medium,219.5,198.5,0.5069284064665127,0.30538461538461537,top-center,281450,0.055693728903890564,Medium (5-15%)
00003102.jpg,612,408,299,240,413,329,False,114,89,10146,1.5,114,89,10146,1.2808988764044944,Medium,356.0,284.5,0.5816993464052288,0.6973039215686274,bottom-center,249696,0.04063341022683583,Small (1-5%)
00003102.jpg,612,408,147,206,252,287,False,105,81,8505,1.5,105,81,8505,1.2962962962962963,Medium,199.5,246.5,0.32598039215686275,0.6041666666666666,middle-left,249696,0.03406141868512111,Small (1-5%)
00003102.jpg,612,408,282,130,378,205,False,96,75,7200,1.5,96,75,7200,1.28,Medium,330.0,167.5,0.5392156862745098,0.4105392156862745,middle-center,249696,0.02883506343713956,Small (1-5%)
00003102.jpg,612,408,221,52,311,122,False,90,70,6300,1.5,90,70,6300,1.2857142857142858,Medium,266.0,87.0,0.434640522875817,0.21323529411764705,top-center,249696,0.025230680507497116,Small (1-5%)
00003102.jpg,612,408,111,65,202,135,False,91,70,6370,1.5,91,70,6370,1.3,Medium,156.5,100.0,0.255718954248366,0.24509803921568626,top-left,249696,0.025511021402024863,Small (1-5%)
00003102.jpg,612,408,190,140,298,223,False,108,83,8964,1.5,108,83,8964,1.3012048192771084,Medium,244.0,181.5,0.39869281045751637,0.44485294117647056,middle-center,249696,0.035899653979238756,Small (1-5%)
00001073.jpg,333,519,135,12,227,178,False,92,166,15272,0.6416184971098265,92,166,15272,0.5542168674698795,Medium,181.0,95.0,0.5435435435435435,0.18304431599229287,top-center,172827,0.08836582246986871,Medium (5-15%)
00002542.jpg,1500,1000,123,5,1016,668,False,893,663,592059,1.5,893,663,592059,1.3469079939668176,Very Large,569.5,336.5,0.37966666666666665,0.3365,middle-center,1500000,0.394706,Very Large (>30%)
00002224.jpg,1000,777,647,150,733,227,False,86,77,6622,1.287001287001287,86,77,6622,1.1168831168831168,Medium,690.0,188.5,0.69,0.2425997425997426,top-right,777000,0.008522522522522523,Tiny (<1%)
00002230.jpg,640,881,130,135,292,400,False,162,265,42930,0.7264472190692395,162,265,42930,0.6113207547169811,Large,211.0,267.5,0.3296875,0.3036322360953462,top-left,563840,0.07613862088535754,Medium (5-15%)
00002230.jpg,640,881,326,204,438,384,False,112,180,20160,0.7264472190692395,112,180,20160,0.6222222222222222,Large,382.0,294.0,0.596875,0.3337116912599319,middle-center,563840,0.03575482406356413,Small (1-5%)
00001739.jpg,1000,667,337,66,689,339,False,352,273,96096,1.4992503748125936,352,273,96096,1.2893772893772895,Very Large,513.0,202.5,0.513,0.30359820089955025,top-center,667000,0.144071964017991,Medium (5-15%)
00000427.jpg,2316,2557,1620,834,2316,1853,False,696,1019,709224,0.9057489245209229,696,1019,709224,0.6830225711481845,Very Large,1968.0,1343.5,0.8497409326424871,0.5254204145482988,middle-right,5922012,0.11976064891459187,Medium (5-15%)
00000427.jpg,2316,2557,159,346,840,1222,False,681,876,596556,0.9057489245209229,681,876,596556,0.7773972602739726,Very Large,499.5,784.0,0.21567357512953367,0.3066093077825577,top-left,5922012,0.1007353581856977,Medium (5-15%)
00002556.jpg,5472,3648,1585,1720,3886,3505,False,2301,1785,4107285,1.5,2301,1785,4107285,1.289075630252101,Very Large,2735.5,2612.5,0.49990862573099415,0.7161458333333334,bottom-center,19961856,0.20575666911934443,Large (15-30%)
00002218.jpg,3734,4800,2096,478,2795,1525,False,699,1047,731853,0.7779166666666667,699,1047,731853,0.667621776504298,Very Large,2445.5,1001.5,0.6549276914836636,0.20864583333333334,top-center,17923200,0.04083271960364221,Small (1-5%)
00001705.jpg,1280,720,831,89,1056,237,False,225,148,33300,1.7777777777777777,225,148,33300,1.5202702702702702,Large,943.5,163.0,0.737109375,0.2263888888888889,top-right,921600,0.0361328125,Small (1-5%)
00001705.jpg,1280,720,159,63,490,280,False,331,217,71827,1.7777777777777777,331,217,71827,1.5253456221198156,Very Large,324.5,171.5,0.253515625,0.23819444444444443,top-left,921600,0.0779372829861111,Medium (5-15%)
00003112.jpg,390,280,160,1,338,104,False,178,103,18334,1.3928571428571428,178,103,18334,1.7281553398058251,Medium,249.0,52.5,0.6384615384615384,0.1875,top-center,109200,0.16789377289377289,Large (15-30%)
00001063.jpg,1500,1389,15,1,1032,883,False,1017,882,896994,1.079913606911447,1017,882,896994,1.153061224489796,Very Large,523.5,442.0,0.349,0.3182145428365731,top-center,2083500,0.43052267818574513,Very Large (>30%)
00001088.jpg,1800,1202,699,331,983,552,False,284,221,62764,1.497504159733777,284,221,62764,1.2850678733031675,Very Large,841.0,441.5,0.4672222222222222,0.3673044925124792,middle-center,2163600,0.029009058975781106,Small (1-5%)
00000396.jpg,600,400,148,61,377,242,False,229,181,41449,1.5,229,181,41449,1.2651933701657458,Large,262.5,151.5,0.4375,0.37875,middle-center,240000,0.17270416666666666,Large (15-30%)
00002581.jpg,1365,2048,552,134,897,750,False,345,616,212520,0.66650390625,345,616,212520,0.560064935064935,Very Large,724.5,442.0,0.5307692307692308,0.2158203125,top-center,2795520,0.07602163461538461,Medium (5-15%)
00001922.jpg,1000,667,383,39,587,198,False,204,159,32436,1.4992503748125936,204,159,32436,1.2830188679245282,Large,485.0,118.5,0.485,0.17766116941529236,top-center,667000,0.04862968515742129,Small (1-5%)
00002595.jpg,858,572,396,140,618,312,False,222,172,38184,1.5,222,172,38184,1.2906976744186047,Large,507.0,226.0,0.5909090909090909,0.3951048951048951,middle-center,490776,0.07780331556555332,Medium (5-15%)
00002026.jpg,683,1023,291,117,380,271,False,89,154,13706,0.667644183773216,89,154,13706,0.577922077922078,Medium,335.5,194.0,0.4912152269399707,0.18963831867057673,top-center,698709,0.019616177836552843,Small (1-5%)
00001249.jpg,236,297,50,5,151,153,False,101,148,14948,0.7946127946127947,101,148,14948,0.6824324324324325,Medium,100.5,79.0,0.4258474576271186,0.265993265993266,top-center,70092,0.21326256919477257,Large (15-30%)
00002740.jpg,1024,683,340,192,449,277,False,109,85,9265,1.499267935578331,109,85,9265,1.2823529411764707,Medium,394.5,234.5,0.38525390625,0.34333821376281115,middle-center,699392,0.013247220442898975,Small (1-5%)
00000143.jpg,736,919,218,121,444,449,False,226,328,74128,0.8008705114254625,226,328,74128,0.6890243902439024,Very Large,331.0,285.0,0.44972826086956524,0.3101196953210011,top-center,676384,0.10959454984151015,Medium (5-15%)
00000625.jpg,450,321,209,86,265,132,False,56,46,2576,1.4018691588785046,56,46,2576,1.2173913043478262,Small,237.0,109.0,0.5266666666666666,0.3395638629283489,middle-center,144450,0.017833160263066805,Small (1-5%)
00000625.jpg,450,321,255,104,308,149,False,53,45,2385,1.4018691588785046,53,45,2385,1.1777777777777778,Small,281.5,126.5,0.6255555555555555,0.3940809968847352,middle-center,144450,0.016510903426791276,Small (1-5%)
00002032.jpg,700,1050,282,76,405,291,False,123,215,26445,0.6666666666666666,123,215,26445,0.5720930232558139,Large,343.5,183.5,0.4907142857142857,0.17476190476190476,top-center,735000,0.035979591836734694,Small (1-5%)
00003304.jpg,1023,683,58,123,271,285,False,213,162,34506,1.4978038067349926,213,162,34506,1.3148148148148149,Large,164.5,204.0,0.16080156402737047,0.2986822840409956,top-left,698709,0.049385366440105966,Small (1-5%)
00003304.jpg,1023,683,759,58,987,231,False,228,173,39444,1.4978038067349926,228,173,39444,1.3179190751445087,Large,873.0,144.5,0.8533724340175953,0.21156661786237188,top-right,698709,0.05645268631146872,Medium (5-15%)
00001275.jpg,1242,1530,349,192,567,505,False,218,313,68234,0.8117647058823529,218,313,68234,0.6964856230031949,Very Large,458.0,348.5,0.3687600644122383,0.22777777777777777,top-center,1900260,0.03590771789123594,Small (1-5%)
00003476.jpg,236,157,85,25,138,67,False,53,42,2226,1.5031847133757963,53,42,2226,1.2619047619047619,Small,111.5,46.0,0.4724576271186441,0.2929936305732484,top-center,37052,0.060077728597646554,Medium (5-15%)
00002768.jpg,920,460,1,56,501,403,False,500,347,173500,2.0,500,347,173500,1.440922190201729,Very Large,251.0,229.5,0.2728260869565217,0.4989130434782609,middle-left,423200,0.40997164461247637,Very Large (>30%)
00003310.jpg,612,408,256,65,453,217,False,197,152,29944,1.5,197,152,29944,1.2960526315789473,Large,354.5,141.0,0.579248366013072,0.34558823529411764,middle-center,249696,0.11992182493912598,Medium (5-15%)
00000619.jpg,1024,683,157,257,416,458,False,259,201,52059,1.499267935578331,259,201,52059,1.2885572139303483,Very Large,286.5,357.5,0.27978515625,0.5234260614934114,middle-left,699392,0.07443465181185945,Medium (5-15%)
00000619.jpg,1024,683,255,122,435,261,False,180,139,25020,1.499267935578331,180,139,25020,1.2949640287769784,Large,345.0,191.5,0.3369140625,0.28038067349926793,top-center,699392,0.03577392935578331,Small (1-5%)
00000619.jpg,1024,683,363,230,559,383,False,196,153,29988,1.499267935578331,196,153,29988,1.2810457516339868,Large,461.0,306.5,0.4501953125,0.44875549048316254,middle-center,699392,0.04287724194729136,Small (1-5%)
00001507.jpg,640,963,229,35,421,372,False,192,337,64704,0.6645898234683282,192,337,64704,0.56973293768546,Very Large,325.0,203.5,0.5078125,0.21131879543094495,top-center,616320,0.10498442367601246,Medium (5-15%)
00002783.jpg,454,340,49,54,243,223,False,194,169,32786,1.3352941176470587,194,169,32786,1.1479289940828403,Large,146.0,138.5,0.32158590308370044,0.4073529411764706,middle-left,154360,0.2123995853848147,Large (15-30%)
00000194.jpg,866,1390,366,265,518,549,False,152,284,43168,0.6230215827338129,152,284,43168,0.5352112676056338,Large,442.0,407.0,0.5103926096997691,0.29280575539568343,top-center,1203740,0.03586156478973865,Small (1-5%)
00000180.jpg,1000,624,340,35,750,332,False,410,297,121770,1.6025641025641026,410,297,121770,1.3804713804713804,Very Large,545.0,183.5,0.545,0.29407051282051283,top-center,624000,0.19514423076923076,Large (15-30%)
00002797.jpg,1000,667,206,43,306,121,False,100,78,7800,1.4992503748125936,100,78,7800,1.2820512820512822,Medium,256.0,82.0,0.256,0.12293853073463268,top-left,667000,0.011694152923538231,Small (1-5%)
00003489.jpg,222,288,117,46,152,99,False,35,53,1855,0.7708333333333334,35,53,1855,0.660377358490566,Small,134.5,72.5,0.6058558558558559,0.2517361111111111,top-center,63936,0.02901338838838839,Small (1-5%)
00000816.jpg,299,450,1,5,112,327,False,111,322,35742,0.6644444444444444,111,322,35742,0.3447204968944099,Large,56.5,166.0,0.18896321070234115,0.3688888888888889,middle-left,134550,0.26564102564102565,Large (15-30%)
00000802.jpg,682,1024,253,85,329,218,False,76,133,10108,0.666015625,76,133,10108,0.5714285714285714,Medium,291.0,151.5,0.42668621700879766,0.14794921875,top-center,698368,0.014473744501466275,Small (1-5%)
00002152.jpg,1280,861,589,300,766,439,False,177,139,24603,1.48664343786295,177,139,24603,1.2733812949640289,Large,677.5,369.5,0.529296875,0.4291521486643438,middle-center,1102080,0.022324150696864112,Small (1-5%)
00000023.jpg,1000,1500,375,285,562,612,False,187,327,61149,0.6666666666666666,187,327,61149,0.5718654434250765,Very Large,468.5,448.5,0.4685,0.299,top-center,1500000,0.040766,Small (1-5%)
00002634.jpg,333,519,52,117,116,232,False,64,115,7360,0.6416184971098265,64,115,7360,0.5565217391304348,Medium,84.0,174.5,0.25225225225225223,0.33622350674373797,middle-left,172827,0.042585938539695764,Small (1-5%)
00002634.jpg,333,519,126,163,191,281,False,65,118,7670,0.6416184971098265,65,118,7670,0.5508474576271186,Medium,158.5,222.0,0.47597597597597596,0.4277456647398844,middle-center,172827,0.0443796397553623,Small (1-5%)
00002634.jpg,333,519,194,121,255,232,False,61,111,6771,0.6416184971098265,61,111,6771,0.5495495495495496,Medium,224.5,176.5,0.6741741741741741,0.3400770712909441,middle-right,172827,0.03917790622992935,Small (1-5%)
00002620.jpg,1600,1167,771,117,1369,624,False,598,507,303186,1.3710368466152527,598,507,303186,1.1794871794871795,Very Large,1070.0,370.5,0.66875,0.31748071979434445,top-center,1867200,0.16237467866323907,Large (15-30%)
00002620.jpg,1600,1167,262,6,900,502,False,638,496,316448,1.3710368466152527,638,496,316448,1.2862903225806452,Very Large,581.0,254.0,0.363125,0.21765209940017138,top-center,1867200,0.16947729220222793,Large (15-30%)
00001329.jpg,600,420,139,1,276,56,False,137,55,7535,1.4285714285714286,137,55,7535,2.4909090909090907,Medium,207.5,28.5,0.3458333333333333,0.06785714285714285,top-center,252000,0.02990079365079365,Small (1-5%)
00000989.jpg,1000,667,422,102,868,448,False,446,346,154316,1.4992503748125936,446,346,154316,1.2890173410404624,Very Large,645.0,275.0,0.645,0.4122938530734633,middle-center,667000,0.23135832083958022,Large (15-30%)
00000751.jpg,733,1023,294,76,431,299,False,137,223,30551,0.7165200391006843,137,223,30551,0.6143497757847534,Large,362.5,187.5,0.4945429740791269,0.18328445747800587,top-center,749859,0.040742326223996775,Small (1-5%)
00003258.jpg,626,417,143,48,257,137,False,114,89,10146,1.501199040767386,114,89,10146,1.2808988764044944,Medium,200.0,92.5,0.3194888178913738,0.22182254196642687,top-left,261042,0.038867308708943386,Small (1-5%)
00003258.jpg,626,417,385,60,513,157,False,128,97,12416,1.501199040767386,128,97,12416,1.3195876288659794,Medium,449.0,108.5,0.7172523961661342,0.26019184652278177,top-right,261042,0.04756322737337287,Small (1-5%)
00003258.jpg,626,417,241,179,372,281,False,131,102,13362,1.501199040767386,131,102,13362,1.2843137254901962,Medium,306.5,230.0,0.48961661341853036,0.5515587529976019,middle-center,261042,0.05118716528374744,Medium (5-15%)
00002146.jpg,397,600,159,70,233,199,False,74,129,9546,0.6616666666666666,74,129,9546,0.5736434108527132,Medium,196.0,134.5,0.49370277078085645,0.22416666666666665,top-center,238200,0.040075566750629725,Small (1-5%)
00000779.jpg,1600,1168,315,155,672,465,False,357,310,110670,1.36986301369863,357,310,110670,1.1516129032258065,Very Large,493.5,310.0,0.3084375,0.2654109589041096,top-left,1868800,0.05921982020547945,Medium (5-15%)
00002608.jpg,2000,1333,1121,404,1548,728,False,427,324,138348,1.5003750937734435,427,324,138348,1.3179012345679013,Very Large,1334.5,566.0,0.66725,0.42460615153788445,middle-center,2666000,0.05189347336834209,Medium (5-15%)
00002608.jpg,2000,1333,752,223,1111,501,False,359,278,99802,1.5003750937734435,359,278,99802,1.29136690647482,Very Large,931.5,362.0,0.46575,0.27156789197299325,top-center,2666000,0.0374351087771943,Small (1-5%)
00002608.jpg,2000,1333,914,590,1258,857,False,344,267,91848,1.5003750937734435,344,267,91848,1.2883895131086143,Very Large,1086.0,723.5,0.543,0.5427606901725431,middle-center,2666000,0.034451612903225806,Small (1-5%)
00001301.jpg,385,280,55,38,168,134,False,113,96,10848,1.375,113,96,10848,1.1770833333333333,Medium,111.5,86.0,0.2896103896103896,0.30714285714285716,top-left,107800,0.10063079777365491,Medium (5-15%)
00001315.jpg,689,900,156,6,470,484,False,314,478,150092,0.7655555555555555,314,478,150092,0.6569037656903766,Very Large,313.0,245.0,0.45428156748911463,0.2722222222222222,top-center,620100,0.24204483147879374,Large (15-30%)
00003502.jpg,200,150,1,1,200,149,False,199,148,29452,1.3333333333333333,199,148,29452,1.3445945945945945,Large,100.5,75.0,0.5025,0.5,middle-center,30000,0.9817333333333333,Very Large (>30%)
00003264.jpg,1001,1001,373,17,626,305,False,253,288,72864,1.0,253,288,72864,0.8784722222222222,Very Large,499.5,161.0,0.499000999000999,0.16083916083916083,top-center,1002001,0.07271849030090788,Medium (5-15%)
00001473.jpg,736,736,181,91,547,517,False,366,426,155916,1.0,366,426,155916,0.8591549295774648,Very Large,364.0,304.0,0.4945652173913043,0.41304347826086957,middle-center,541696,0.28782933601134214,Large (15-30%)
00000786.jpg,1024,683,27,1,650,452,False,623,451,280973,1.499267935578331,623,451,280973,1.3813747228381374,Very Large,338.5,226.5,0.33056640625,0.33162518301610544,middle-center,699392,0.4017389389641288,Very Large (>30%)
00002191.jpg,400,285,74,24,158,92,False,84,68,5712,1.4035087719298245,84,68,5712,1.2352941176470589,Medium,116.0,58.0,0.29,0.20350877192982456,top-left,114000,0.050105263157894736,Medium (5-15%)
00002191.jpg,400,285,316,62,390,124,False,74,62,4588,1.4035087719298245,74,62,4588,1.1935483870967742,Small,353.0,93.0,0.8825,0.3263157894736842,top-right,114000,0.040245614035087716,Small (1-5%)
00000792.jpg,1000,1000,262,33,728,575,False,466,542,252572,1.0,466,542,252572,0.8597785977859779,Very Large,495.0,304.0,0.495,0.304,top-center,1000000,0.252572,Large (15-30%)
00000962.jpg,700,525,82,10,557,424,False,475,414,196650,1.3333333333333333,475,414,196650,1.1473429951690821,Very Large,319.5,217.0,0.4564285714285714,0.41333333333333333,middle-center,367500,0.5351020408163265,Very Large (>30%)
00002807.jpg,600,369,275,45,452,172,False,177,127,22479,1.6260162601626016,177,127,22479,1.3937007874015748,Large,363.5,108.5,0.6058333333333333,0.2940379403794038,top-center,221400,0.10153116531165311,Medium (5-15%)
00002807.jpg,600,369,399,40,579,166,False,180,126,22680,1.6260162601626016,180,126,22680,1.4285714285714286,Large,489.0,103.0,0.815,0.2791327913279133,top-right,221400,0.1024390243902439,Medium (5-15%)
00000976.jpg,1202,1800,332,499,572,927,False,240,428,102720,0.6677777777777778,240,428,102720,0.5607476635514018,Very Large,452.0,713.0,0.37603993344425957,0.39611111111111114,middle-center,2163600,0.04747642817526345,Small (1-5%)
00002436.jpg,925,1200,231,70,683,753,False,452,683,308716,0.7708333333333334,452,683,308716,0.6617862371888726,Very Large,457.0,411.5,0.49405405405405406,0.34291666666666665,middle-center,1110000,0.2781225225225225,Large (15-30%)
00000547.jpg,1001,1600,30,327,222,692,False,192,365,70080,0.625625,192,365,70080,0.5260273972602739,Very Large,126.0,509.5,0.1258741258741259,0.3184375,top-left,1601600,0.043756243756243755,Small (1-5%)
00000547.jpg,1001,1600,233,416,380,691,False,147,275,40425,0.625625,147,275,40425,0.5345454545454545,Large,306.5,553.5,0.3061938061938062,0.3459375,middle-left,1601600,0.025240384615384616,Small (1-5%)
00000547.jpg,1001,1600,449,494,653,875,False,204,381,77724,0.625625,204,381,77724,0.5354330708661418,Very Large,551.0,684.5,0.5504495504495505,0.4278125,middle-center,1601600,0.04852897102897103,Small (1-5%)
00001881.jpg,900,556,192,27,740,429,False,548,402,220296,1.618705035971223,548,402,220296,1.36318407960199,Very Large,466.0,228.0,0.5177777777777778,0.41007194244604317,middle-center,500400,0.44023980815347724,Very Large (>30%)
00001659.jpg,1280,720,1,1,1280,712,False,1279,711,909369,1.7777777777777777,1279,711,909369,1.79887482419128,Very Large,640.5,356.5,0.500390625,0.4951388888888889,middle-center,921600,0.986728515625,Very Large (>30%)
00002350.jpg,750,440,333,50,454,133,False,121,83,10043,1.7045454545454546,121,83,10043,1.4578313253012047,Medium,393.5,91.5,0.5246666666666666,0.20795454545454545,top-center,330000,0.030433333333333333,Small (1-5%)
00000553.jpg,800,582,202,40,418,223,False,216,183,39528,1.3745704467353952,216,183,39528,1.180327868852459,Large,310.0,131.5,0.3875,0.2259450171821306,top-center,465600,0.08489690721649484,Medium (5-15%)
00000553.jpg,800,582,350,80,571,263,False,221,183,40443,1.3745704467353952,221,183,40443,1.2076502732240437,Large,460.5,171.5,0.575625,0.29467353951890035,top-center,465600,0.08686211340206186,Medium (5-15%)
00000553.jpg,800,582,442,71,658,254,False,216,183,39528,1.3745704467353952,216,183,39528,1.180327868852459,Large,550.0,162.5,0.6875,0.27920962199312716,top-right,465600,0.08489690721649484,Medium (5-15%)
00000235.jpg,4000,6000,1521,1867,1939,2580,False,418,713,298034,0.6666666666666666,418,713,298034,0.5862552594670407,Very Large,1730.0,2223.5,0.4325,0.3705833333333333,middle-center,24000000,0.012418083333333333,Small (1-5%)
00002422.jpg,500,500,177,294,291,427,False,114,133,15162,1.0,114,133,15162,0.8571428571428571,Medium,234.0,360.5,0.468,0.721,bottom-center,250000,0.060648,Medium (5-15%)
00002422.jpg,500,500,174,49,349,253,False,175,204,35700,1.0,175,204,35700,0.8578431372549019,Large,261.5,151.0,0.523,0.302,top-center,250000,0.1428,Medium (5-15%)
00003072.jpg,612,408,220,78,351,179,False,131,101,13231,1.5,131,101,13231,1.297029702970297,Medium,285.5,128.5,0.4665032679738562,0.31495098039215685,top-center,249696,0.05298843393566577,Medium (5-15%)
00003072.jpg,612,408,94,151,182,220,False,88,69,6072,1.5,88,69,6072,1.2753623188405796,Medium,138.0,185.5,0.22549019607843138,0.45465686274509803,middle-left,249696,0.02431757016532103,Small (1-5%)
00001665.jpg,1000,667,413,90,645,267,False,232,177,41064,1.4992503748125936,232,177,41064,1.310734463276836,Large,529.0,178.5,0.529,0.26761619190404795,top-center,667000,0.06156521739130435,Medium (5-15%)
00003066.jpg,1157,887,296,70,487,240,False,191,170,32470,1.3043968432919955,191,170,32470,1.1235294117647059,Large,391.5,155.0,0.3383751080380294,0.17474633596392333,top-center,1026259,0.03163918659909438,Small (1-5%)
00003066.jpg,1157,887,509,124,708,301,False,199,177,35223,1.3043968432919955,199,177,35223,1.1242937853107344,Large,608.5,212.5,0.5259291270527225,0.2395715896279594,top-center,1026259,0.03432174529041889,Small (1-5%)
00003066.jpg,1157,887,101,172,328,374,False,227,202,45854,1.3043968432919955,227,202,45854,1.1237623762376239,Large,214.5,273.0,0.1853932584269663,0.30777903043968435,top-left,1026259,0.04468072874391357,Small (1-5%)
00001117.jpg,1500,1201,454,130,1045,681,False,591,551,325641,1.2489592006661117,591,551,325641,1.072595281306715,Very Large,749.5,405.5,0.49966666666666665,0.3376353039134055,middle-center,1801500,0.1807610324729392,Large (15-30%)
00002393.jpg,1400,1120,532,346,944,729,False,412,383,157796,1.25,412,383,157796,1.0757180156657964,Very Large,738.0,537.5,0.5271428571428571,0.4799107142857143,middle-center,1568000,0.10063520408163265,Medium (5-15%)
00000584.jpg,6000,3887,2014,1076,2654,1559,False,640,483,309120,1.5436068947774633,640,483,309120,1.3250517598343685,Very Large,2334.0,1317.5,0.389,0.3389503473115513,middle-center,23322000,0.013254437869822486,Small (1-5%)
00001842.jpg,700,1050,313,100,419,284,False,106,184,19504,0.6666666666666666,106,184,19504,0.5760869565217391,Medium,366.0,192.0,0.5228571428571429,0.18285714285714286,top-center,735000,0.026536054421768707,Small (1-5%)
00000590.jpg,1000,571,521,281,721,414,False,200,133,26600,1.7513134851138354,200,133,26600,1.5037593984962405,Large,621.0,347.5,0.621,0.6085814360770578,middle-center,571000,0.04658493870402802,Small (1-5%)
00000590.jpg,1000,571,277,294,481,430,False,204,136,27744,1.7513134851138354,204,136,27744,1.5,Large,379.0,362.0,0.379,0.6339754816112084,middle-center,571000,0.048588441330998246,Small (1-5%)
00001856.jpg,364,280,1,1,276,138,False,275,137,37675,1.3,275,137,37675,2.0072992700729926,Large,138.5,69.5,0.3804945054945055,0.24821428571428572,top-center,101920,0.3696526687598116,Very Large (>30%)
00002387.jpg,388,480,162,76,287,255,False,125,179,22375,0.8083333333333333,125,179,22375,0.6983240223463687,Large,224.5,165.5,0.5786082474226805,0.34479166666666666,middle-center,186240,0.12014067869415808,Medium (5-15%)
00003098.jpg,1023,682,827,413,934,496,False,107,83,8881,1.5,107,83,8881,1.2891566265060241,Medium,880.5,454.5,0.8607038123167156,0.6664222873900293,middle-right,697686,0.012729222028247665,Small (1-5%)
00001843.jpg,682,1024,254,75,438,397,False,184,322,59248,0.666015625,184,322,59248,0.5714285714285714,Very Large,346.0,236.0,0.5073313782991202,0.23046875,top-center,698368,0.08483779325513197,Medium (5-15%)
00000585.jpg,1500,1000,1037,113,1259,285,False,222,172,38184,1.5,222,172,38184,1.2906976744186047,Large,1148.0,199.0,0.7653333333333333,0.199,top-right,1500000,0.025456,Small (1-5%)
00000585.jpg,1500,1000,244,121,476,301,False,232,180,41760,1.5,232,180,41760,1.288888888888889,Large,360.0,211.0,0.24,0.211,top-left,1500000,0.02784,Small (1-5%)
00003067.jpg,1600,1066,781,431,1033,626,False,252,195,49140,1.5009380863039399,252,195,49140,1.2923076923076924,Large,907.0,528.5,0.566875,0.49577861163227016,middle-center,1705600,0.0288109756097561,Small (1-5%)
00003067.jpg,1600,1066,910,180,1259,451,False,349,271,94579,1.5009380863039399,349,271,94579,1.2878228782287824,Very Large,1084.5,315.5,0.6778125,0.2959662288930582,top-right,1705600,0.05545204033771107,Medium (5-15%)
00002379.jpg,550,350,183,15,414,186,False,231,171,39501,1.5714285714285714,231,171,39501,1.3508771929824561,Large,298.5,100.5,0.5427272727272727,0.28714285714285714,top-center,192500,0.2052,Large (15-30%)
00001670.jpg,1024,768,248,66,569,346,False,321,280,89880,1.3333333333333333,321,280,89880,1.1464285714285714,Very Large,408.5,206.0,0.39892578125,0.2682291666666667,top-center,786432,0.114288330078125,Medium (5-15%)
00000208.jpg,773,580,162,79,252,158,False,90,79,7110,1.3327586206896551,90,79,7110,1.139240506329114,Medium,207.0,118.5,0.2677878395860285,0.2043103448275862,top-left,448340,0.015858500245349513,Small (1-5%)
00003073.jpg,1300,866,700,233,1127,571,False,427,338,144326,1.5011547344110854,427,338,144326,1.2633136094674555,Very Large,913.5,402.0,0.7026923076923077,0.46420323325635104,middle-right,1125800,0.1281986143187067,Medium (5-15%)
00001894.jpg,1600,1167,621,94,947,371,False,326,277,90302,1.3710368466152527,326,277,90302,1.1768953068592058,Very Large,784.0,232.5,0.49,0.19922879177377892,top-center,1867200,0.04836225364181662,Small (1-5%)
00002423.jpg,612,459,138,4,526,344,False,388,340,131920,1.3333333333333333,388,340,131920,1.1411764705882352,Very Large,332.0,174.0,0.5424836601307189,0.3790849673202614,middle-center,280908,0.46961994674412977,Very Large (>30%)
00000220.jpg,450,328,207,83,262,128,False,55,45,2475,1.3719512195121952,55,45,2475,1.2222222222222223,Small,234.5,105.5,0.5211111111111111,0.32164634146341464,top-center,147600,0.01676829268292683,Small (1-5%)
00000220.jpg,450,328,139,66,194,113,False,55,47,2585,1.3719512195121952,55,47,2585,1.1702127659574468,Small,166.5,89.5,0.37,0.2728658536585366,top-center,147600,0.017513550135501356,Small (1-5%)
00000220.jpg,450,328,267,68,320,114,False,53,46,2438,1.3719512195121952,53,46,2438,1.1521739130434783,Small,293.5,91.0,0.6522222222222223,0.2774390243902439,top-center,147600,0.016517615176151763,Small (1-5%)
00002437.jpg,866,1300,326,332,586,778,False,260,446,115960,0.6661538461538462,260,446,115960,0.5829596412556054,Very Large,456.0,555.0,0.5265588914549654,0.4269230769230769,middle-center,1125800,0.10300230946882218,Medium (5-15%)
00002351.jpg,800,534,387,128,510,224,False,123,96,11808,1.4981273408239701,123,96,11808,1.28125,Medium,448.5,176.0,0.560625,0.3295880149812734,top-center,427200,0.027640449438202246,Small (1-5%)
00001658.jpg,1300,956,443,131,834,458,False,391,327,127857,1.3598326359832635,391,327,127857,1.1957186544342508,Very Large,638.5,294.5,0.49115384615384616,0.3080543933054393,top-center,1242800,0.1028781783070486,Medium (5-15%)
00000963.jpg,800,582,230,73,707,477,False,477,404,192708,1.3745704467353952,477,404,192708,1.1806930693069306,Very Large,468.5,275.0,0.585625,0.4725085910652921,middle-center,465600,0.4138917525773196,Very Large (>30%)
00000793.jpg,1111,980,301,6,893,602,False,592,596,352832,1.133673469387755,592,596,352832,0.9932885906040269,Very Large,597.0,304.0,0.5373537353735374,0.31020408163265306,top-center,1088780,0.32406179393449547,Very Large (>30%)
00002190.jpg,735,489,39,93,457,417,False,418,324,135432,1.5030674846625767,418,324,135432,1.2901234567901234,Very Large,248.0,255.0,0.33741496598639453,0.5214723926380368,middle-center,359415,0.37681232002003257,Very Large (>30%)
00002190.jpg,735,489,267,1,734,392,False,467,391,182597,1.5030674846625767,467,391,182597,1.1943734015345269,Very Large,500.5,196.5,0.680952380952381,0.401840490797546,middle-right,359415,0.508039453000014,Very Large (>30%)
00001499.jpg,800,527,224,22,465,207,False,241,185,44585,1.5180265654648957,241,185,44585,1.3027027027027027,Large,344.5,114.5,0.430625,0.21726755218216318,top-center,421600,0.10575189753320684,Medium (5-15%)
00000787.jpg,650,434,281,68,429,180,False,148,112,16576,1.4976958525345623,148,112,16576,1.3214285714285714,Medium,355.0,124.0,0.5461538461538461,0.2857142857142857,top-center,282100,0.058759305210918114,Medium (5-15%)
00001472.jpg,1000,1500,383,1,1000,1054,False,617,1053,649701,0.6666666666666666,617,1053,649701,0.5859449192782527,Very Large,691.5,527.5,0.6915,0.3516666666666667,middle-right,1500000,0.433134,Very Large (>30%)
00000778.jpg,1200,1800,267,289,636,919,False,369,630,232470,0.6666666666666666,369,630,232470,0.5857142857142857,Very Large,451.5,604.0,0.37625,0.33555555555555555,middle-center,2160000,0.107625,Medium (5-15%)
00003517.jpg,236,236,81,40,160,132,False,79,92,7268,1.0,79,92,7268,0.8586956521739131,Medium,120.5,86.0,0.510593220338983,0.3644067796610169,middle-center,55696,0.13049411088767596,Medium (5-15%)
00003517.jpg,236,236,162,71,215,134,False,53,63,3339,1.0,53,63,3339,0.8412698412698413,Small,188.5,102.5,0.798728813559322,0.4343220338983051,middle-right,55696,0.05995044527434645,Medium (5-15%)
00003517.jpg,236,236,36,14,104,92,False,68,78,5304,1.0,68,78,5304,0.8717948717948718,Medium,70.0,53.0,0.2966101694915254,0.2245762711864407,top-left,55696,0.09523125538638322,Medium (5-15%)
00003517.jpg,236,236,88,122,127,169,False,39,47,1833,1.0,39,47,1833,0.8297872340425532,Small,107.5,145.5,0.4555084745762712,0.6165254237288136,middle-center,55696,0.03291080149382362,Small (1-5%)
00002621.jpg,1050,700,237,151,425,297,False,188,146,27448,1.5,188,146,27448,1.2876712328767124,Large,331.0,224.0,0.31523809523809526,0.32,top-left,735000,0.03734421768707483,Small (1-5%)
00002621.jpg,1050,700,423,170,624,326,False,201,156,31356,1.5,201,156,31356,1.2884615384615385,Large,523.5,248.0,0.49857142857142855,0.35428571428571426,middle-center,735000,0.04266122448979592,Small (1-5%)
00002147.jpg,667,1000,295,13,566,486,False,271,473,128183,0.667,271,473,128183,0.572938689217759,Very Large,430.5,249.5,0.6454272863568216,0.2495,top-center,667000,0.1921784107946027,Large (15-30%)
00000988.jpg,1300,866,269,86,497,263,False,228,177,40356,1.5011547344110854,228,177,40356,1.2881355932203389,Large,383.0,174.5,0.2946153846153846,0.20150115473441108,top-left,1125800,0.03584650914904956,Small (1-5%)
00002153.jpg,688,1050,231,111,313,253,False,82,142,11644,0.6552380952380953,82,142,11644,0.5774647887323944,Medium,272.0,182.0,0.3953488372093023,0.17333333333333334,top-center,722400,0.016118493909191584,Small (1-5%)
00000022.jpg,767,512,475,129,558,194,False,83,65,5395,1.498046875,83,65,5395,1.2769230769230768,Medium,516.5,161.5,0.6734028683181226,0.3154296875,top-right,392704,0.013738082627118644,Small (1-5%)
00002972.jpg,2000,1333,479,205,996,606,False,517,401,207317,1.5003750937734435,517,401,207317,1.2892768079800498,Very Large,737.5,405.5,0.36875,0.30420105026256566,top-center,2666000,0.07776331582895724,Medium (5-15%)
00002972.jpg,2000,1333,857,303,1433,750,False,576,447,257472,1.5003750937734435,576,447,257472,1.2885906040268456,Very Large,1145.0,526.5,0.5725,0.39497374343585895,middle-center,2666000,0.096576144036009,Medium (5-15%)
00000803.jpg,1500,2250,613,575,1105,1415,False,492,840,413280,0.6666666666666666,492,840,413280,0.5857142857142857,Very Large,859.0,995.0,0.5726666666666667,0.44222222222222224,middle-center,3375000,0.12245333333333333,Medium (5-15%)
00000817.jpg,667,1000,268,32,410,280,False,142,248,35216,0.667,142,248,35216,0.5725806451612904,Large,339.0,156.0,0.5082458770614693,0.156,top-center,667000,0.0527976011994003,Medium (5-15%)
00002966.jpg,660,367,214,102,287,150,False,73,48,3504,1.7983651226158037,73,48,3504,1.5208333333333333,Small,250.5,126.0,0.3795454545454545,0.34332425068119893,middle-center,242220,0.014466187763190488,Small (1-5%)
00002966.jpg,660,367,332,24,414,77,False,82,53,4346,1.7983651226158037,82,53,4346,1.5471698113207548,Small,373.0,50.5,0.5651515151515152,0.13760217983651227,top-center,242220,0.017942366443728843,Small (1-5%)
00002796.jpg,800,800,370,194,596,456,False,226,262,59212,1.0,226,262,59212,0.8625954198473282,Very Large,483.0,325.0,0.60375,0.40625,middle-center,640000,0.09251875,Medium (5-15%)
00000181.jpg,1600,1158,451,30,1306,750,False,855,720,615600,1.381692573402418,855,720,615600,1.1875,Very Large,878.5,390.0,0.5490625,0.33678756476683935,middle-center,1852800,0.3322538860103627,Very Large (>30%)
00002782.jpg,608,406,169,30,231,79,False,62,49,3038,1.4975369458128078,62,49,3038,1.2653061224489797,Small,200.0,54.5,0.32894736842105265,0.13423645320197045,top-left,246848,0.012307168784029038,Small (1-5%)
00002769.jpg,960,640,114,7,650,423,False,536,416,222976,1.5,536,416,222976,1.2884615384615385,Very Large,382.0,215.0,0.39791666666666664,0.3359375,middle-center,614400,0.36291666666666667,Very Large (>30%)
00003477.jpg,235,176,132,52,182,95,False,50,43,2150,1.3352272727272727,50,43,2150,1.1627906976744187,Small,157.0,73.5,0.6680851063829787,0.41761363636363635,middle-center,41360,0.0519825918762089,Medium (5-15%)
00003477.jpg,235,176,47,50,96,93,False,49,43,2107,1.3352272727272727,49,43,2107,1.1395348837209303,Small,71.5,71.5,0.30425531914893617,0.40625,middle-left,41360,0.05094294003868472,Medium (5-15%)
00003477.jpg,235,176,78,45,131,90,False,53,45,2385,1.3352272727272727,53,45,2385,1.1777777777777778,Small,104.5,67.5,0.44468085106382976,0.3835227272727273,middle-center,41360,0.05766441005802708,Medium (5-15%)
00001260.jpg,867,1390,282,83,543,559,False,261,476,124236,0.6237410071942446,261,476,124236,0.5483193277310925,Very Large,412.5,321.0,0.4757785467128028,0.23093525179856114,top-center,1205130,0.10308929327126534,Medium (5-15%)
00001506.jpg,653,1024,321,190,433,391,False,112,201,22512,0.6376953125,112,201,22512,0.5572139303482587,Large,377.0,290.5,0.5773353751914242,0.28369140625,top-center,668672,0.03366673047473201,Small (1-5%)
00000618.jpg,800,582,62,11,313,224,False,251,213,53463,1.3745704467353952,251,213,53463,1.1784037558685445,Very Large,187.5,117.5,0.234375,0.20189003436426117,top-left,465600,0.11482603092783505,Medium (5-15%)
00000618.jpg,800,582,241,71,509,298,False,268,227,60836,1.3745704467353952,268,227,60836,1.1806167400881058,Very Large,375.0,184.5,0.46875,0.3170103092783505,top-center,465600,0.1306615120274914,Medium (5-15%)
00003311.jpg,1280,853,424,116,853,448,False,429,332,142428,1.5005861664712778,429,332,142428,1.2921686746987953,Very Large,638.5,282.0,0.498828125,0.3305978898007034,middle-center,1091840,0.13044768464243844,Medium (5-15%)
00003305.jpg,200,300,78,44,137,147,False,59,103,6077,0.6666666666666666,59,103,6077,0.5728155339805825,Medium,107.5,95.5,0.5375,0.31833333333333336,top-center,60000,0.10128333333333334,Medium (5-15%)
00003463.jpg,550,366,104,24,366,231,False,262,207,54234,1.5027322404371584,262,207,54234,1.2657004830917875,Very Large,235.0,127.5,0.42727272727272725,0.3483606557377049,middle-center,201300,0.2694187779433681,Large (15-30%)
00000142.jpg,600,750,260,1,546,370,False,286,369,105534,0.8,286,369,105534,0.7750677506775068,Very Large,403.0,185.5,0.6716666666666666,0.24733333333333332,top-right,450000,0.23452,Large (15-30%)
00002755.jpg,994,663,603,222,816,387,False,213,165,35145,1.4992458521870287,213,165,35145,1.290909090909091,Large,709.5,304.5,0.7137826961770624,0.4592760180995475,middle-right,659022,0.05332902391725921,Medium (5-15%)
00002033.jpg,864,1390,272,61,427,345,False,155,284,44020,0.6215827338129496,155,284,44020,0.545774647887324,Large,349.5,203.0,0.4045138888888889,0.1460431654676259,top-center,1200960,0.036654010125233144,Small (1-5%)
00003339.jpg,626,352,222,139,383,245,False,161,106,17066,1.7784090909090908,161,106,17066,1.5188679245283019,Medium,302.5,192.0,0.48322683706070285,0.5454545454545454,middle-center,220352,0.07744880917804241,Medium (5-15%)
00001248.jpg,891,1000,421,170,562,353,False,141,183,25803,0.891,141,183,25803,0.7704918032786885,Large,491.5,261.5,0.5516273849607183,0.2615,top-center,891000,0.02895959595959596,Small (1-5%)
00001923.jpg,1500,1029,590,121,890,360,False,300,239,71700,1.4577259475218658,300,239,71700,1.2552301255230125,Very Large,740.0,240.5,0.49333333333333335,0.2337220602526725,top-center,1543500,0.046452866861030125,Small (1-5%)
00002594.jpg,650,975,286,154,382,325,False,96,171,16416,0.6666666666666666,96,171,16416,0.5614035087719298,Medium,334.0,239.5,0.5138461538461538,0.24564102564102563,top-center,633750,0.025902958579881657,Small (1-5%)
00002580.jpg,1400,1000,412,150,1400,993,False,988,843,832884,1.4,988,843,832884,1.1720047449584816,Very Large,906.0,571.5,0.6471428571428571,0.5715,middle-center,1400000,0.5949171428571428,Very Large (>30%)
00001089.jpg,1000,667,207,39,477,248,False,270,209,56430,1.4992503748125936,270,209,56430,1.291866028708134,Very Large,342.0,143.5,0.342,0.2151424287856072,top-center,667000,0.08460269865067466,Medium (5-15%)
00001937.jpg,800,533,258,32,474,196,False,216,164,35424,1.5009380863039399,216,164,35424,1.3170731707317074,Large,366.0,114.0,0.4575,0.21388367729831145,top-center,426400,0.08307692307692308,Medium (5-15%)
00003113.jpg,1000,667,79,157,438,430,False,359,273,98007,1.4992503748125936,359,273,98007,1.315018315018315,Very Large,258.5,293.5,0.2585,0.44002998500749624,middle-left,667000,0.14693703148425788,Medium (5-15%)
00003113.jpg,1000,667,302,200,590,419,False,288,219,63072,1.4992503748125936,288,219,63072,1.3150684931506849,Very Large,446.0,309.5,0.446,0.46401799100449775,middle-center,667000,0.09456071964017991,Medium (5-15%)
00001704.jpg,683,1023,370,39,516,293,False,146,254,37084,0.667644183773216,146,254,37084,0.5748031496062992,Large,443.0,166.0,0.6486090775988287,0.16226783968719452,top-center,698709,0.05307502837375789,Medium (5-15%)
00001710.jpg,626,417,203,36,330,135,False,127,99,12573,1.501199040767386,127,99,12573,1.2828282828282829,Medium,266.5,85.5,0.4257188498402556,0.20503597122302158,top-center,261042,0.04816466315765279,Small (1-5%)
00002219.jpg,306,423,99,49,219,242,False,120,193,23160,0.723404255319149,120,193,23160,0.6217616580310881,Large,159.0,145.5,0.5196078431372549,0.34397163120567376,middle-center,129438,0.17892736290733788,Large (15-30%)
00000426.jpg,686,1029,303,119,450,375,False,147,256,37632,0.6666666666666666,147,256,37632,0.57421875,Large,376.5,247.0,0.5488338192419825,0.2400388726919339,top-center,705894,0.053311120366513955,Medium (5-15%)
00001738.jpg,974,1390,412,392,514,561,False,102,169,17238,0.7007194244604317,102,169,17238,0.6035502958579881,Medium,463.0,476.5,0.4753593429158111,0.3428057553956835,middle-center,1353860,0.012732483417783227,Small (1-5%)
00002231.jpg,900,680,688,23,821,140,False,133,117,15561,1.3235294117647058,133,117,15561,1.1367521367521367,Medium,754.5,81.5,0.8383333333333334,0.11985294117647059,top-right,612000,0.025426470588235293,Small (1-5%)
00002231.jpg,900,680,67,206,172,298,False,105,92,9660,1.3235294117647058,105,92,9660,1.141304347826087,Medium,119.5,252.0,0.13277777777777777,0.37058823529411766,middle-left,612000,0.015784313725490197,Small (1-5%)
00002231.jpg,900,680,540,24,657,127,False,117,103,12051,1.3235294117647058,117,103,12051,1.1359223300970873,Medium,598.5,75.5,0.665,0.11102941176470588,top-center,612000,0.019691176470588236,Small (1-5%)
00002231.jpg,900,680,204,104,313,201,False,109,97,10573,1.3235294117647058,109,97,10573,1.1237113402061856,Medium,258.5,152.5,0.2872222222222222,0.22426470588235295,top-left,612000,0.017276143790849675,Small (1-5%)
00002231.jpg,900,680,354,55,469,155,False,115,100,11500,1.3235294117647058,115,100,11500,1.15,Medium,411.5,105.0,0.4572222222222222,0.15441176470588236,top-center,612000,0.018790849673202614,Small (1-5%)
00002557.jpg,1500,1120,218,45,735,494,False,517,449,232133,1.3392857142857142,517,449,232133,1.1514476614699332,Very Large,476.5,269.5,0.31766666666666665,0.240625,top-left,1680000,0.13817440476190476,Medium (5-15%)
00000340.jpg,800,583,469,99,629,235,False,160,136,21760,1.3722126929674099,160,136,21760,1.1764705882352942,Large,549.0,167.0,0.68625,0.2864493996569468,top-right,466400,0.046655231560891935,Small (1-5%)
00002225.jpg,700,933,281,132,407,327,False,126,195,24570,0.7502679528403001,126,195,24570,0.6461538461538462,Large,344.0,229.5,0.49142857142857144,0.2459807073954984,top-center,653100,0.03762057877813505,Small (1-5%)
00000432.jpg,700,467,367,52,569,209,False,202,157,31714,1.4989293361884368,202,157,31714,1.286624203821656,Large,468.0,130.5,0.6685714285714286,0.27944325481798715,top-center,326900,0.09701437748546957,Medium (5-15%)
00002555.jpg,1024,656,750,143,964,302,False,214,159,34026,1.5609756097560976,214,159,34026,1.3459119496855345,Large,857.0,222.5,0.8369140625,0.3391768292682927,middle-right,671744,0.050653225038109755,Medium (5-15%)
00002555.jpg,1024,656,10,54,233,217,False,223,163,36349,1.5609756097560976,223,163,36349,1.3680981595092025,Large,121.5,135.5,0.11865234375,0.20655487804878048,top-left,671744,0.0541113876714939,Medium (5-15%)
00002555.jpg,1024,656,398,64,631,238,False,233,174,40542,1.5609756097560976,233,174,40542,1.339080459770115,Large,514.5,151.0,0.50244140625,0.2301829268292683,top-center,671744,0.060353348894817076,Medium (5-15%)
00002555.jpg,1024,656,631,54,859,224,False,228,170,38760,1.5609756097560976,228,170,38760,1.3411764705882352,Large,745.0,139.0,0.7275390625,0.21189024390243902,top-right,671744,0.057700552591463415,Medium (5-15%)
00002555.jpg,1024,656,685,278,923,456,False,238,178,42364,1.5609756097560976,238,178,42364,1.3370786516853932,Large,804.0,367.0,0.78515625,0.5594512195121951,middle-right,671744,0.06306569169207317,Medium (5-15%)
00002555.jpg,1024,656,95,179,328,349,False,233,170,39610,1.5609756097560976,233,170,39610,1.3705882352941177,Large,211.5,264.0,0.20654296875,0.4024390243902439,middle-left,671744,0.058965915586890245,Medium (5-15%)
00002555.jpg,1024,656,321,269,554,447,False,233,178,41474,1.5609756097560976,233,178,41474,1.3089887640449438,Large,437.5,358.0,0.42724609375,0.5457317073170732,middle-center,671744,0.0617407822027439,Medium (5-15%)
00002233.jpg,700,933,342,100,498,342,False,156,242,37752,0.7502679528403001,156,242,37752,0.6446280991735537,Large,420.0,221.0,0.6,0.23687031082529475,top-center,653100,0.057804317868626554,Medium (5-15%)
00000430.jpg,800,800,278,165,380,283,False,102,118,12036,1.0,102,118,12036,0.864406779661017,Medium,329.0,224.0,0.41125,0.28,top-center,640000,0.01880625,Small (1-5%)
00002227.jpg,1000,667,95,5,895,574,False,800,569,455200,1.4992503748125936,800,569,455200,1.40597539543058,Very Large,495.0,289.5,0.495,0.4340329835082459,middle-center,667000,0.6824587706146926,Very Large (>30%)
00001048.jpg,1000,1250,458,390,634,646,False,176,256,45056,0.8,176,256,45056,0.6875,Large,546.0,518.0,0.546,0.4144,middle-center,1250000,0.0360448,Small (1-5%)
00001060.jpg,1300,956,735,81,959,272,False,224,191,42784,1.3598326359832635,224,191,42784,1.1727748691099475,Large,847.0,176.5,0.6515384615384615,0.1846234309623431,top-center,1242800,0.034425490827164465,Small (1-5%)
00001706.jpg,1300,867,444,177,843,488,False,399,311,124089,1.4994232987312572,399,311,124089,1.2829581993569132,Very Large,643.5,332.5,0.495,0.38350634371395614,middle-center,1127100,0.11009582113388341,Medium (5-15%)
00003111.jpg,500,333,186,112,321,217,False,135,105,14175,1.5015015015015014,135,105,14175,1.2857142857142858,Medium,253.5,164.5,0.507,0.493993993993994,middle-center,166500,0.08513513513513514,Medium (5-15%)
00003111.jpg,500,333,73,18,244,148,False,171,130,22230,1.5015015015015014,171,130,22230,1.3153846153846154,Large,158.5,83.0,0.317,0.24924924924924924,top-left,166500,0.1335135135135135,Medium (5-15%)
00001074.jpg,1600,1156,655,75,913,291,False,258,216,55728,1.3840830449826989,258,216,55728,1.1944444444444444,Very Large,784.0,183.0,0.49,0.1583044982698962,top-center,1849600,0.03012975778546713,Small (1-5%)
00002596.jpg,960,641,248,143,658,462,False,410,319,130790,1.497659906396256,410,319,130790,1.2852664576802508,Very Large,453.0,302.5,0.471875,0.4719188767550702,middle-center,615360,0.2125422516900676,Large (15-30%)
00000381.jpg,829,580,291,49,530,240,False,239,191,45649,1.4293103448275861,239,191,45649,1.2513089005235603,Large,410.5,144.5,0.4951749095295537,0.24913793103448276,top-center,480820,0.09493989434715694,Medium (5-15%)
00001921.jpg,1300,956,372,57,847,464,False,475,407,193325,1.3598326359832635,475,407,193325,1.1670761670761671,Very Large,609.5,260.5,0.46884615384615386,0.27248953974895396,top-center,1242800,0.15555600257483101,Large (15-30%)
00001935.jpg,1300,956,394,109,1000,628,False,606,519,314514,1.3598326359832635,606,519,314514,1.1676300578034682,Very Large,697.0,368.5,0.5361538461538462,0.3854602510460251,middle-center,1242800,0.2530688767299646,Large (15-30%)
00000626.jpg,500,334,299,31,443,143,False,144,112,16128,1.4970059880239521,144,112,16128,1.2857142857142858,Medium,371.0,87.0,0.742,0.26047904191616766,top-right,167000,0.0965748502994012,Medium (5-15%)
00000626.jpg,500,334,93,49,225,151,False,132,102,13464,1.4970059880239521,132,102,13464,1.2941176470588236,Medium,159.0,100.0,0.318,0.2994011976047904,top-left,167000,0.08062275449101797,Medium (5-15%)
00000626.jpg,500,334,340,38,490,155,False,150,117,17550,1.4970059880239521,150,117,17550,1.2820512820512822,Medium,415.0,96.5,0.83,0.28892215568862273,top-right,167000,0.10508982035928144,Medium (5-15%)
00000626.jpg,500,334,1,86,191,244,False,190,158,30020,1.4970059880239521,190,158,30020,1.2025316455696202,Large,96.0,165.0,0.192,0.4940119760479042,middle-left,167000,0.17976047904191617,Large (15-30%)
00000626.jpg,500,334,151,71,394,252,False,243,181,43983,1.4970059880239521,243,181,43983,1.3425414364640884,Large,272.5,161.5,0.545,0.48353293413173654,middle-center,167000,0.26337125748502993,Large (15-30%)
00002031.jpg,2000,1333,645,66,1500,744,False,855,678,579690,1.5003750937734435,855,678,579690,1.261061946902655,Very Large,1072.5,405.0,0.53625,0.3038259564891223,top-center,2666000,0.21743810952738185,Large (15-30%)
00003449.jpg,236,354,69,37,155,188,False,86,151,12986,0.6666666666666666,86,151,12986,0.5695364238410596,Medium,112.0,112.5,0.4745762711864407,0.3177966101694915,top-center,83544,0.15543905008139425,Large (15-30%)
00000154.jpg,626,398,345,91,465,179,False,120,88,10560,1.5728643216080402,120,88,10560,1.3636363636363635,Medium,405.0,135.0,0.646964856230032,0.3391959798994975,middle-center,249148,0.042384446192624464,Small (1-5%)
00002743.jpg,900,596,289,79,508,248,False,219,169,37011,1.5100671140939597,219,169,37011,1.2958579881656804,Large,398.5,163.5,0.44277777777777777,0.27432885906040266,top-center,536400,0.06899888143176734,Medium (5-15%)
00003475.jpg,236,115,78,1,234,104,False,156,103,16068,2.0521739130434784,156,103,16068,1.5145631067961165,Medium,156.0,52.5,0.6610169491525424,0.45652173913043476,middle-center,27140,0.5920412675018423,Very Large (>30%)
00001276.jpg,800,533,191,1,677,346,False,486,345,167670,1.5009380863039399,486,345,167670,1.4086956521739131,Very Large,434.0,173.5,0.5425,0.325515947467167,top-center,426400,0.39322232645403377,Very Large (>30%)
00000168.jpg,1000,667,228,12,906,527,False,678,515,349170,1.4992503748125936,678,515,349170,1.316504854368932,Very Large,567.0,269.5,0.567,0.404047976011994,middle-center,667000,0.5234932533733133,Very Large (>30%)
00001510.jpg,1600,1168,559,113,1360,795,False,801,682,546282,1.36986301369863,801,682,546282,1.1744868035190617,Very Large,959.5,454.0,0.5996875,0.3886986301369863,middle-center,1868800,0.2923169948630137,Large (15-30%)
00002019.jpg,600,419,191,29,306,122,False,115,93,10695,1.431980906921241,115,93,10695,1.2365591397849462,Medium,248.5,75.5,0.4141666666666667,0.1801909307875895,top-center,251400,0.0425417661097852,Small (1-5%)
00002019.jpg,600,419,338,40,433,116,False,95,76,7220,1.431980906921241,95,76,7220,1.25,Medium,385.5,78.0,0.6425,0.18615751789976134,top-center,251400,0.02871917263325378,Small (1-5%)
00001289.jpg,1005,1300,234,156,694,834,False,460,678,311880,0.7730769230769231,460,678,311880,0.6784660766961652,Very Large,464.0,495.0,0.4616915422885572,0.38076923076923075,middle-center,1306500,0.2387141216991963,Large (15-30%)
00000829.jpg,2000,3000,802,380,1248,1158,False,446,778,346988,0.6666666666666666,446,778,346988,0.5732647814910026,Very Large,1025.0,769.0,0.5125,0.25633333333333336,top-center,6000000,0.05783133333333333,Medium (5-15%)
00000801.jpg,406,612,151,38,273,253,False,122,215,26230,0.6633986928104575,122,215,26230,0.5674418604651162,Large,212.0,145.5,0.5221674876847291,0.23774509803921567,top-center,248472,0.10556521459158376,Medium (5-15%)
00002970.jpg,1000,1000,599,608,760,796,False,161,188,30268,1.0,161,188,30268,0.8563829787234043,Large,679.5,702.0,0.6795,0.702,bottom-right,1000000,0.030268,Small (1-5%)
00002964.jpg,640,360,14,20,215,151,False,201,131,26331,1.7777777777777777,201,131,26331,1.534351145038168,Large,114.5,85.5,0.17890625,0.2375,top-left,230400,0.11428385416666667,Medium (5-15%)
00000752.jpg,967,1300,424,74,635,412,False,211,338,71318,0.7438461538461538,211,338,71318,0.6242603550295858,Very Large,529.5,243.0,0.5475698035160289,0.18692307692307691,top-center,1257100,0.05673216132368149,Medium (5-15%)
00002145.jpg,866,1300,378,456,506,680,False,128,224,28672,0.6661538461538462,128,224,28672,0.5714285714285714,Large,442.0,568.0,0.5103926096997691,0.4369230769230769,middle-center,1125800,0.025468111565109256,Small (1-5%)
00000020.jpg,1000,667,288,20,516,193,False,228,173,39444,1.4992503748125936,228,173,39444,1.3179190751445087,Large,402.0,106.5,0.402,0.15967016491754124,top-center,667000,0.05913643178410795,Medium (5-15%)
00002151.jpg,320,405,115,116,182,212,False,67,96,6432,0.7901234567901234,67,96,6432,0.6979166666666666,Medium,148.5,164.0,0.4640625,0.4049382716049383,middle-center,129600,0.04962962962962963,Small (1-5%)
00001458.jpg,650,433,366,113,554,256,False,188,143,26884,1.5011547344110854,188,143,26884,1.3146853146853146,Large,460.0,184.5,0.7076923076923077,0.42609699769053117,middle-right,281450,0.09551963048498845,Medium (5-15%)
00003267.jpg,509,340,300,87,406,169,False,106,82,8692,1.4970588235294118,106,82,8692,1.2926829268292683,Medium,353.0,128.0,0.693516699410609,0.3764705882352941,middle-right,173060,0.050225355368080433,Medium (5-15%)
00002179.jpg,1600,900,434,25,1179,513,False,745,488,363560,1.7777777777777777,745,488,363560,1.526639344262295,Very Large,806.5,269.0,0.5040625,0.29888888888888887,top-center,1440000,0.2524722222222222,Large (15-30%)
00001470.jpg,1365,2048,483,495,1067,1514,False,584,1019,595096,0.66650390625,584,1019,595096,0.5731108930323847,Very Large,775.0,1004.5,0.5677655677655677,0.490478515625,middle-center,2795520,0.21287488553113554,Large (15-30%)
00000008.jpg,1300,867,820,234,1016,387,False,196,153,29988,1.4994232987312572,196,153,29988,1.2810457516339868,Large,918.0,310.5,0.7061538461538461,0.35813148788927335,middle-right,1127100,0.02660633484162896,Small (1-5%)
00001316.jpg,626,418,105,3,539,154,False,434,151,65534,1.4976076555023923,434,151,65534,2.8741721854304636,Very Large,322.0,78.5,0.5143769968051118,0.18779904306220097,top-center,261668,0.2504471314795848,Large (15-30%)
00003501.jpg,236,365,94,104,138,184,False,44,80,3520,0.6465753424657534,44,80,3520,0.55,Small,116.0,144.0,0.4915254237288136,0.39452054794520547,middle-center,86140,0.040863710239145576,Small (1-5%)
00001302.jpg,800,532,101,91,458,367,False,357,276,98532,1.5037593984962405,357,276,98532,1.2934782608695652,Very Large,279.5,229.0,0.349375,0.43045112781954886,middle-center,425600,0.23151315789473684,Large (15-30%)
00003273.jpg,612,408,184,75,299,164,False,115,89,10235,1.5,115,89,10235,1.2921348314606742,Medium,241.5,119.5,0.3946078431372549,0.2928921568627451,top-center,249696,0.04098984364987825,Small (1-5%)
00003273.jpg,612,408,111,66,210,142,False,99,76,7524,1.5,99,76,7524,1.3026315789473684,Medium,160.5,104.0,0.2622549019607843,0.2549019607843137,top-left,249696,0.03013264129181084,Small (1-5%)
00002186.jpg,1082,1689,418,169,608,514,False,190,345,65550,0.640615748963884,190,345,65550,0.5507246376811594,Very Large,513.0,341.5,0.47412199630314233,0.20219064535227946,top-center,1827498,0.035868712305020305,Small (1-5%)
00003298.jpg,750,500,333,113,515,252,False,182,139,25298,1.5,182,139,25298,1.3093525179856116,Large,424.0,182.5,0.5653333333333334,0.365,middle-center,375000,0.06746133333333333,Medium (5-15%)
00003298.jpg,750,500,94,166,272,305,False,178,139,24742,1.5,178,139,24742,1.2805755395683454,Large,183.0,235.5,0.244,0.471,middle-left,375000,0.06597866666666667,Medium (5-15%)
00000785.jpg,866,1390,351,209,439,374,False,88,165,14520,0.6230215827338129,88,165,14520,0.5333333333333333,Medium,395.0,291.5,0.4561200923787529,0.20971223021582733,top-center,1203740,0.012062405502849453,Small (1-5%)
00002192.jpg,800,470,6,73,237,231,False,231,158,36498,1.702127659574468,231,158,36498,1.4620253164556962,Large,121.5,152.0,0.151875,0.32340425531914896,top-left,376000,0.09706914893617022,Medium (5-15%)
00002192.jpg,800,470,167,270,342,387,False,175,117,20475,1.702127659574468,175,117,20475,1.4957264957264957,Large,254.5,328.5,0.318125,0.698936170212766,bottom-left,376000,0.054454787234042554,Medium (5-15%)
00002192.jpg,800,470,238,46,512,234,False,274,188,51512,1.702127659574468,274,188,51512,1.4574468085106382,Very Large,375.0,140.0,0.46875,0.2978723404255319,top-center,376000,0.137,Medium (5-15%)
00002804.jpg,509,339,25,81,134,166,False,109,85,9265,1.5014749262536873,109,85,9265,1.2823529411764707,Medium,79.5,123.5,0.15618860510805502,0.36430678466076694,middle-left,172551,0.05369427009985454,Medium (5-15%)
00002804.jpg,509,339,128,67,222,140,False,94,73,6862,1.5014749262536873,94,73,6862,1.2876712328767124,Medium,175.0,103.5,0.343811394891945,0.3053097345132743,top-center,172551,0.03976795266327057,Small (1-5%)
00002804.jpg,509,339,412,81,507,173,False,95,92,8740,1.5014749262536873,95,92,8740,1.0326086956521738,Medium,459.5,127.0,0.9027504911591355,0.3746312684365782,middle-right,172551,0.05065169138399662,Medium (5-15%)
00002804.jpg,509,339,314,76,401,143,False,87,67,5829,1.5014749262536873,87,67,5829,1.2985074626865671,Medium,357.5,109.5,0.7023575638506876,0.3230088495575221,top-right,172551,0.033781316828068224,Small (1-5%)
00002810.jpg,346,280,133,84,260,203,False,127,119,15113,1.2357142857142858,127,119,15113,1.0672268907563025,Medium,196.5,143.5,0.5679190751445087,0.5125,middle-center,96880,0.1559971098265896,Large (15-30%)
00002421.jpg,1210,988,111,256,227,366,False,116,110,12760,1.2246963562753037,116,110,12760,1.0545454545454545,Medium,169.0,311.0,0.1396694214876033,0.3147773279352227,top-left,1195480,0.010673536989326464,Small (1-5%)
00002421.jpg,1210,988,259,108,372,216,False,113,108,12204,1.2246963562753037,113,108,12204,1.0462962962962963,Medium,315.5,162.0,0.26074380165289257,0.16396761133603238,top-left,1195480,0.010208451835246093,Small (1-5%)
00002421.jpg,1210,988,614,314,727,420,False,113,106,11978,1.2246963562753037,113,106,11978,1.0660377358490567,Medium,670.5,367.0,0.5541322314049587,0.3714574898785425,middle-center,1195480,0.010019406430889685,Small (1-5%)
00002421.jpg,1210,988,881,324,1004,442,False,123,118,14514,1.2246963562753037,123,118,14514,1.0423728813559323,Medium,942.5,383.0,0.7789256198347108,0.3876518218623482,middle-right,1195480,0.012140730083313815,Small (1-5%)
00002421.jpg,1210,988,253,368,362,469,False,109,101,11009,1.2246963562753037,109,101,11009,1.0792079207920793,Medium,307.5,418.5,0.25413223140495866,0.423582995951417,middle-left,1195480,0.009208853347609328,Tiny (<1%)
00002421.jpg,1210,988,661,88,763,186,False,102,98,9996,1.2246963562753037,102,98,9996,1.0408163265306123,Medium,712.0,137.0,0.5884297520661157,0.13866396761133604,top-center,1195480,0.008361494964365777,Tiny (<1%)
00003059.jpg,1140,854,837,532,1009,682,False,172,150,25800,1.334894613583138,172,150,25800,1.1466666666666667,Large,923.0,607.0,0.8096491228070175,0.7107728337236534,bottom-right,973560,0.026500677924318993,Small (1-5%)
00000550.jpg,612,408,149,123,334,262,False,185,139,25715,1.5,185,139,25715,1.330935251798561,Large,241.5,192.5,0.3946078431372549,0.47181372549019607,middle-center,249696,0.10298523003972831,Medium (5-15%)
00000550.jpg,612,408,280,98,514,280,False,234,182,42588,1.5,234,182,42588,1.2857142857142858,Large,397.0,189.0,0.6486928104575164,0.4632352941176471,middle-center,249696,0.1705594002306805,Large (15-30%)
00000550.jpg,612,408,50,187,238,330,False,188,143,26884,1.5,188,143,26884,1.3146853146853146,Large,144.0,258.5,0.23529411764705882,0.633578431372549,middle-left,249696,0.10766692297834167,Medium (5-15%)
00000550.jpg,612,408,398,8,546,121,False,148,113,16724,1.5,148,113,16724,1.3097345132743363,Medium,472.0,64.5,0.7712418300653595,0.15808823529411764,top-right,249696,0.06697744457260028,Medium (5-15%)
00000550.jpg,612,408,436,108,609,262,False,173,154,26642,1.5,173,154,26642,1.1233766233766234,Large,522.5,185.0,0.8537581699346405,0.4534313725490196,middle-right,249696,0.10669774445726003,Medium (5-15%)
00000550.jpg,612,408,268,6,385,97,False,117,91,10647,1.5,117,91,10647,1.2857142857142858,Medium,326.5,51.5,0.5334967320261438,0.12622549019607843,top-center,249696,0.042639850057670126,Small (1-5%)
00000550.jpg,612,408,1,27,143,156,False,142,129,18318,1.5,142,129,18318,1.1007751937984496,Medium,72.0,91.5,0.11764705882352941,0.22426470588235295,top-left,249696,0.07336120722798924,Medium (5-15%)
00001882.jpg,1024,869,673,214,797,335,False,124,121,15004,1.1783659378596087,124,121,15004,1.024793388429752,Medium,735.0,274.5,0.7177734375,0.3158803222094361,top-right,889856,0.01686115506329114,Small (1-5%)
00001882.jpg,1024,869,564,128,709,271,False,145,143,20735,1.1783659378596087,145,143,20735,1.013986013986014,Large,636.5,199.5,0.62158203125,0.22957422324510932,top-center,889856,0.023301522943037976,Small (1-5%)
00001882.jpg,1024,869,717,418,824,524,False,107,106,11342,1.1783659378596087,107,106,11342,1.009433962264151,Medium,770.5,471.0,0.75244140625,0.5420023014959724,middle-right,889856,0.01274588247986191,Small (1-5%)
00002353.jpg,335,500,126,60,229,239,False,103,179,18437,0.67,103,179,18437,0.5754189944134078,Medium,177.5,149.5,0.5298507462686567,0.299,top-center,167500,0.11007164179104477,Medium (5-15%)
00000222.jpg,1300,956,466,151,776,415,False,310,264,81840,1.3598326359832635,310,264,81840,1.1742424242424243,Very Large,621.0,283.0,0.4776923076923077,0.29602510460251047,top-center,1242800,0.06585130350820727,Medium (5-15%)
00001114.jpg,865,1390,269,321,349,466,False,80,145,11600,0.6223021582733813,80,145,11600,0.5517241379310345,Medium,309.0,393.5,0.35722543352601155,0.28309352517985614,top-center,1202350,0.009647773110990975,Tiny (<1%)
00001672.jpg,600,420,44,52,302,262,False,258,210,54180,1.4285714285714286,258,210,54180,1.2285714285714286,Very Large,173.0,157.0,0.28833333333333333,0.3738095238095238,middle-left,252000,0.215,Large (15-30%)
00003065.jpg,1300,851,272,160,1013,736,False,741,576,426816,1.527614571092832,741,576,426816,1.2864583333333333,Very Large,642.5,448.0,0.49423076923076925,0.5264394829612221,middle-center,1106300,0.38580493537015276,Very Large (>30%)
00003071.jpg,550,309,59,136,198,227,False,139,91,12649,1.779935275080906,139,91,12649,1.5274725274725274,Medium,128.5,181.5,0.23363636363636364,0.587378640776699,middle-left,169950,0.07442777287437481,Medium (5-15%)
00003071.jpg,550,309,55,1,228,110,False,173,109,18857,1.779935275080906,173,109,18857,1.5871559633027523,Medium,141.5,55.5,0.25727272727272726,0.1796116504854369,top-left,169950,0.1109561635775228,Medium (5-15%)
00003071.jpg,550,309,175,109,348,222,False,173,113,19549,1.779935275080906,173,113,19549,1.5309734513274336,Medium,261.5,165.5,0.47545454545454546,0.5355987055016181,middle-center,169950,0.11502794939688143,Medium (5-15%)
00003071.jpg,550,309,258,175,417,276,False,159,101,16059,1.779935275080906,159,101,16059,1.5742574257425743,Medium,337.5,225.5,0.6136363636363636,0.7297734627831716,bottom-center,169950,0.09449249779346866,Medium (5-15%)
00000578.jpg,1024,682,102,139,378,353,False,276,214,59064,1.501466275659824,276,214,59064,1.2897196261682242,Very Large,240.0,246.0,0.234375,0.36070381231671556,middle-left,698368,0.08457432184750734,Medium (5-15%)
00000578.jpg,1024,682,592,137,780,279,False,188,142,26696,1.501466275659824,188,142,26696,1.323943661971831,Large,686.0,208.0,0.669921875,0.30498533724340177,top-center,698368,0.038226264662756596,Small (1-5%)
00000578.jpg,1024,682,717,161,950,341,False,233,180,41940,1.501466275659824,233,180,41940,1.2944444444444445,Large,833.5,251.0,0.81396484375,0.3680351906158358,middle-right,698368,0.060054298020527856,Medium (5-15%)
00000578.jpg,1024,682,405,163,658,355,False,253,192,48576,1.501466275659824,253,192,48576,1.3177083333333333,Large,531.5,259.0,0.51904296875,0.37976539589442815,middle-center,698368,0.06955645161290322,Medium (5-15%)
00000578.jpg,1024,682,130,213,549,530,False,419,317,132823,1.501466275659824,419,317,132823,1.3217665615141956,Very Large,339.5,371.5,0.33154296875,0.5447214076246334,middle-center,698368,0.19019055855938416,Large (15-30%)
00000578.jpg,1024,682,225,1,409,126,False,184,125,23000,1.501466275659824,184,125,23000,1.472,Large,317.0,63.5,0.3095703125,0.09310850439882698,top-left,698368,0.03293392595307918,Small (1-5%)
00000578.jpg,1024,682,371,65,529,185,False,158,120,18960,1.501466275659824,158,120,18960,1.3166666666666667,Medium,450.0,125.0,0.439453125,0.18328445747800587,top-center,698368,0.02714901026392962,Small (1-5%)
00000578.jpg,1024,682,482,53,657,189,False,175,136,23800,1.501466275659824,175,136,23800,1.286764705882353,Large,569.5,121.0,0.55615234375,0.1774193548387097,top-center,698368,0.034079453812316716,Small (1-5%)
00000578.jpg,1024,682,719,374,1021,664,False,302,290,87580,1.501466275659824,302,290,87580,1.0413793103448277,Very Large,870.0,519.0,0.849609375,0.7609970674486803,bottom-right,698368,0.12540666239002932,Medium (5-15%)
00000593.jpg,612,408,444,112,605,238,False,161,126,20286,1.5,161,126,20286,1.2777777777777777,Large,524.5,175.0,0.8570261437908496,0.42892156862745096,middle-right,249696,0.08124279123414072,Medium (5-15%)
00000593.jpg,612,408,244,143,405,266,False,161,123,19803,1.5,161,123,19803,1.3089430894308942,Medium,324.5,204.5,0.5302287581699346,0.5012254901960784,middle-center,249696,0.07930843906189927,Medium (5-15%)
00000593.jpg,612,408,440,23,573,124,False,133,101,13433,1.5,133,101,13433,1.316831683168317,Medium,506.5,73.5,0.8276143790849673,0.1801470588235294,top-right,249696,0.053797417659874405,Medium (5-15%)
00000593.jpg,612,408,83,62,210,159,False,127,97,12319,1.5,127,97,12319,1.309278350515464,Medium,146.5,110.5,0.23937908496732027,0.2708333333333333,top-left,249696,0.049335992566961424,Small (1-5%)
00000593.jpg,612,408,365,66,507,177,False,142,111,15762,1.5,142,111,15762,1.2792792792792793,Medium,436.0,121.5,0.7124183006535948,0.2977941176470588,top-right,249696,0.06312475970780469,Medium (5-15%)
00000593.jpg,612,408,268,9,413,122,False,145,113,16385,1.5,145,113,16385,1.2831858407079646,Medium,340.5,65.5,0.5563725490196079,0.16053921568627452,top-center,249696,0.06561979366910163,Medium (5-15%)
00000593.jpg,612,408,110,1,225,77,False,115,76,8740,1.5,115,76,8740,1.513157894736842,Medium,167.5,39.0,0.27369281045751637,0.09558823529411764,top-left,249696,0.03500256311674997,Small (1-5%)
00000593.jpg,612,408,1,102,144,215,False,143,113,16159,1.5,143,113,16159,1.2654867256637168,Medium,72.5,158.5,0.1184640522875817,0.38848039215686275,middle-left,249696,0.06471469306676919,Medium (5-15%)
00000593.jpg,612,408,322,2,459,104,False,137,102,13974,1.5,137,102,13974,1.3431372549019607,Medium,390.5,53.0,0.6380718954248366,0.12990196078431374,top-center,249696,0.0559640522875817,Medium (5-15%)
00001855.jpg,683,1024,320,100,395,230,False,75,130,9750,0.6669921875,75,130,9750,0.5769230769230769,Medium,357.5,165.0,0.5234260614934114,0.1611328125,top-center,699392,0.013940679904831626,Small (1-5%)
00002384.jpg,539,752,169,127,244,248,False,75,121,9075,0.7167553191489362,75,121,9075,0.6198347107438017,Medium,206.5,187.5,0.38311688311688313,0.24933510638297873,top-center,405328,0.02238927485887972,Small (1-5%)
00002390.jpg,550,350,137,15,400,210,False,263,195,51285,1.5714285714285714,263,195,51285,1.3487179487179488,Very Large,268.5,112.5,0.48818181818181816,0.32142857142857145,top-center,192500,0.26641558441558444,Large (15-30%)
00001699.jpg,798,1024,246,172,532,598,False,286,426,121836,0.779296875,286,426,121836,0.6713615023474179,Very Large,389.0,385.0,0.487468671679198,0.3759765625,middle-center,817152,0.14909833176691728,Medium (5-15%)
00001841.jpg,735,490,266,57,541,274,False,275,217,59675,1.5,275,217,59675,1.2672811059907834,Very Large,403.5,165.5,0.5489795918367347,0.3377551020408163,middle-center,360150,0.16569484936831877,Large (15-30%)
00001869.jpg,600,400,185,36,336,154,False,151,118,17818,1.5,151,118,17818,1.2796610169491525,Medium,260.5,95.0,0.43416666666666665,0.2375,top-center,240000,0.07424166666666666,Medium (5-15%)
00001868.jpg,590,393,356,91,505,204,False,149,113,16837,1.5012722646310432,149,113,16837,1.3185840707964602,Medium,430.5,147.5,0.7296610169491525,0.3753180661577608,middle-right,231870,0.07261396472161125,Medium (5-15%)
00001840.jpg,356,200,204,14,316,87,False,112,73,8176,1.78,112,73,8176,1.5342465753424657,Medium,260.0,50.5,0.7303370786516854,0.2525,top-right,71200,0.11483146067415731,Medium (5-15%)
00001698.jpg,2000,1335,190,92,944,679,False,754,587,442598,1.4981273408239701,754,587,442598,1.284497444633731,Very Large,567.0,385.5,0.2835,0.28876404494382024,top-left,2670000,0.16576704119850189,Large (15-30%)
00002391.jpg,408,612,82,273,202,482,False,120,209,25080,0.6666666666666666,120,209,25080,0.5741626794258373,Large,142.0,377.5,0.3480392156862745,0.6168300653594772,middle-center,249696,0.10044213763936947,Medium (5-15%)
00002391.jpg,408,612,187,43,310,257,False,123,214,26322,0.6666666666666666,123,214,26322,0.5747663551401869,Large,248.5,150.0,0.6090686274509803,0.24509803921568626,top-center,249696,0.10541618608227604,Medium (5-15%)
00002385.jpg,512,463,401,59,480,142,False,79,83,6557,1.1058315334773219,79,83,6557,0.9518072289156626,Medium,440.5,100.5,0.8603515625,0.21706263498920086,top-right,237056,0.027660130939524838,Small (1-5%)
00002385.jpg,512,463,252,68,328,147,False,76,79,6004,1.1058315334773219,76,79,6004,0.9620253164556962,Medium,290.0,107.5,0.56640625,0.23218142548596113,top-center,237056,0.025327348812095033,Small (1-5%)
00001854.jpg,612,367,278,23,507,182,False,229,159,36411,1.667574931880109,229,159,36411,1.440251572327044,Large,392.5,102.5,0.6413398692810458,0.279291553133515,top-center,224604,0.1621119837580809,Large (15-30%)
00000592.jpg,1500,1031,273,274,444,411,False,171,137,23427,1.454898157129001,171,137,23427,1.2481751824817517,Large,358.5,342.5,0.239,0.33220174587778856,middle-left,1546500,0.015148399612027158,Small (1-5%)
00000579.jpg,3840,2560,1264,921,2394,1797,False,1130,876,989880,1.5,1130,876,989880,1.2899543378995433,Very Large,1829.0,1359.0,0.47630208333333335,0.530859375,middle-center,9830400,0.10069580078125,Medium (5-15%)
00000579.jpg,3840,2560,2370,531,3044,1054,False,674,523,352502,1.5,674,523,352502,1.2887189292543022,Very Large,2707.0,792.5,0.7049479166666667,0.3095703125,top-right,9830400,0.03585835774739583,Small (1-5%)
00000579.jpg,3840,2560,1704,345,2456,916,False,752,571,429392,1.5,752,571,429392,1.316987740805604,Very Large,2080.0,630.5,0.5416666666666666,0.2462890625,top-center,9830400,0.04368001302083333,Small (1-5%)
00000579.jpg,3840,2560,868,267,1839,1021,False,971,754,732134,1.5,971,754,732134,1.2877984084880636,Very Large,1353.5,644.0,0.35247395833333334,0.2515625,top-center,9830400,0.07447652180989583,Medium (5-15%)
00000579.jpg,3840,2560,2912,273,3840,1189,False,928,916,850048,1.5,928,916,850048,1.0131004366812226,Very Large,3376.0,731.0,0.8791666666666667,0.285546875,top-right,9830400,0.08647135416666667,Medium (5-15%)
00000579.jpg,3840,2560,10,1018,1141,1914,False,1131,896,1013376,1.5,1131,896,1013376,1.2622767857142858,Very Large,575.5,1466.0,0.14986979166666667,0.57265625,middle-left,9830400,0.1030859375,Medium (5-15%)
00003070.jpg,681,1024,299,155,495,491,False,196,336,65856,0.6650390625,196,336,65856,0.5833333333333334,Very Large,397.0,323.0,0.5829662261380323,0.3154296875,top-center,697344,0.09443832599118943,Medium (5-15%)
00001673.jpg,500,750,186,41,321,276,False,135,235,31725,0.6666666666666666,135,235,31725,0.574468085106383,Large,253.5,158.5,0.507,0.21133333333333335,top-center,375000,0.0846,Medium (5-15%)
00001883.jpg,390,280,153,14,281,120,False,128,106,13568,1.3928571428571428,128,106,13568,1.2075471698113207,Medium,217.0,67.0,0.5564102564102564,0.2392857142857143,top-center,109200,0.12424908424908425,Medium (5-15%)
00000545.jpg,1200,800,743,26,1047,261,False,304,235,71440,1.5,304,235,71440,1.2936170212765958,Very Large,895.0,143.5,0.7458333333333333,0.179375,top-right,960000,0.07441666666666667,Medium (5-15%)
00000545.jpg,1200,800,315,90,577,293,False,262,203,53186,1.5,262,203,53186,1.29064039408867,Very Large,446.0,191.5,0.37166666666666665,0.239375,top-center,960000,0.05540208333333333,Medium (5-15%)
00002420.jpg,690,1000,185,33,578,696,False,393,663,260559,0.69,393,663,260559,0.5927601809954751,Very Large,381.5,364.5,0.5528985507246377,0.3645,middle-center,690000,0.3776217391304348,Very Large (>30%)
00001129.jpg,626,417,277,56,458,196,False,181,140,25340,1.501199040767386,181,140,25340,1.292857142857143,Large,367.5,126.0,0.5870607028753994,0.302158273381295,top-center,261042,0.09707250174301453,Medium (5-15%)
00001897.jpg,390,280,133,26,264,132,False,131,106,13886,1.3928571428571428,131,106,13886,1.2358490566037736,Medium,198.5,79.0,0.5089743589743589,0.28214285714285714,top-center,109200,0.12716117216117215,Medium (5-15%)
00000551.jpg,900,599,337,120,673,380,False,336,260,87360,1.5025041736227045,336,260,87360,1.2923076923076924,Very Large,505.0,250.0,0.5611111111111111,0.41736227045075125,middle-center,539100,0.162047857540345,Large (15-30%)
00000551.jpg,900,599,145,100,476,367,False,331,267,88377,1.5025041736227045,331,267,88377,1.2397003745318351,Very Large,310.5,233.5,0.345,0.38981636060100167,middle-center,539100,0.16393433500278243,Large (15-30%)
00000551.jpg,900,599,313,1,584,171,False,271,170,46070,1.5025041736227045,271,170,46070,1.5941176470588236,Large,448.5,86.0,0.49833333333333335,0.14357262103505844,top-center,539100,0.0854572435540716,Medium (5-15%)
00000551.jpg,900,599,580,1,862,167,False,282,166,46812,1.5025041736227045,282,166,46812,1.6987951807228916,Large,721.0,84.0,0.8011111111111111,0.14023372287145242,top-right,539100,0.08683361157484697,Medium (5-15%)
00000551.jpg,900,599,56,53,409,327,False,353,274,96722,1.5025041736227045,353,274,96722,1.2883211678832116,Very Large,232.5,190.0,0.25833333333333336,0.31719532554257096,top-left,539100,0.1794138378779447,Large (15-30%)
00003058.jpg,350,350,265,193,315,249,False,50,56,2800,1.0,50,56,2800,0.8928571428571429,Small,290.0,221.0,0.8285714285714286,0.6314285714285715,middle-right,122500,0.022857142857142857,Small (1-5%)
00003058.jpg,350,350,43,211,85,261,False,42,50,2100,1.0,42,50,2100,0.84,Small,64.0,236.0,0.18285714285714286,0.6742857142857143,bottom-left,122500,0.017142857142857144,Small (1-5%)
00002811.jpg,626,418,149,47,476,307,False,327,260,85020,1.4976076555023923,327,260,85020,1.2576923076923077,Very Large,312.5,177.0,0.4992012779552716,0.423444976076555,middle-center,261668,0.32491554183163396,Very Large (>30%)
00002811.jpg,626,418,1,1,327,291,False,326,290,94540,1.4976076555023923,326,290,94540,1.1241379310344828,Very Large,164.0,146.0,0.26198083067092653,0.3492822966507177,middle-left,261668,0.36129752205084303,Very Large (>30%)
00002811.jpg,626,418,298,1,625,277,False,327,276,90252,1.4976076555023923,327,276,90252,1.184782608695652,Very Large,461.5,139.0,0.737220447284345,0.33253588516746413,middle-right,261668,0.34491034440588836,Very Large (>30%)
00000974.jpg,462,280,77,34,183,108,False,106,74,7844,1.65,106,74,7844,1.4324324324324325,Medium,130.0,71.0,0.2813852813852814,0.25357142857142856,top-left,129360,0.06063698206555349,Medium (5-15%)
00002805.jpg,900,675,199,243,289,322,False,90,79,7110,1.3333333333333333,90,79,7110,1.139240506329114,Medium,244.0,282.5,0.27111111111111114,0.4185185185185185,middle-left,607500,0.011703703703703704,Small (1-5%)
00002805.jpg,900,675,675,16,754,84,False,79,68,5372,1.3333333333333333,79,68,5372,1.161764705882353,Medium,714.5,50.0,0.7938888888888889,0.07407407407407407,top-right,607500,0.008842798353909465,Tiny (<1%)
00000784.jpg,1300,866,284,103,935,608,False,651,505,328755,1.5011547344110854,651,505,328755,1.2891089108910891,Very Large,609.5,355.5,0.46884615384615386,0.4105080831408776,middle-center,1125800,0.2920190087049209,Large (15-30%)
00000948.jpg,800,582,170,82,327,215,False,157,133,20881,1.3745704467353952,157,133,20881,1.1804511278195489,Large,248.5,148.5,0.310625,0.2551546391752577,top-left,465600,0.044847508591065295,Small (1-5%)
00000948.jpg,800,582,329,72,469,189,False,140,117,16380,1.3745704467353952,140,117,16380,1.1965811965811965,Medium,399.0,130.5,0.49875,0.22422680412371135,top-center,465600,0.03518041237113402,Small (1-5%)
00000948.jpg,800,582,523,121,670,245,False,147,124,18228,1.3745704467353952,147,124,18228,1.185483870967742,Medium,596.5,183.0,0.745625,0.31443298969072164,top-right,465600,0.039149484536082475,Small (1-5%)
00000790.jpg,1058,1600,437,86,710,567,False,273,481,131313,0.66125,273,481,131313,0.5675675675675675,Very Large,573.5,326.5,0.5420604914933838,0.2040625,top-center,1692800,0.07757147920604915,Medium (5-15%)
00003299.jpg,500,367,206,113,294,186,False,88,73,6424,1.3623978201634876,88,73,6424,1.2054794520547945,Medium,250.0,149.5,0.5,0.40735694822888285,middle-center,183500,0.035008174386920984,Small (1-5%)
00002839.jpg,994,663,524,106,810,324,False,286,218,62348,1.4992458521870287,286,218,62348,1.311926605504587,Very Large,667.0,215.0,0.6710261569416499,0.32428355957767724,top-right,659022,0.09460685682723793,Medium (5-15%)
00003514.jpg,236,354,93,37,133,106,False,40,69,2760,0.6666666666666666,40,69,2760,0.5797101449275363,Small,113.0,71.5,0.4788135593220339,0.2019774011299435,top-center,83544,0.033036483769031885,Small (1-5%)
00001465.jpg,2048,1365,864,159,1480,637,False,616,478,294448,1.5003663003663004,616,478,294448,1.288702928870293,Very Large,1172.0,398.0,0.572265625,0.2915750915750916,top-center,2795520,0.10532852564102564,Medium (5-15%)
00002178.jpg,612,407,354,113,512,233,False,158,120,18960,1.5036855036855037,158,120,18960,1.3166666666666667,Medium,433.0,173.0,0.7075163398692811,0.4250614250614251,middle-right,249084,0.07611889964831141,Medium (5-15%)
00002178.jpg,612,407,227,152,450,329,False,223,177,39471,1.5036855036855037,223,177,39471,1.2598870056497176,Large,338.5,240.5,0.5531045751633987,0.5909090909090909,middle-center,249084,0.1584646143469673,Large (15-30%)
00003266.jpg,1300,1035,814,170,1038,377,False,224,207,46368,1.2560386473429952,224,207,46368,1.0821256038647342,Large,926.0,273.5,0.7123076923076923,0.2642512077294686,top-right,1345500,0.03446153846153846,Small (1-5%)
00003500.jpg,236,236,31,29,120,133,False,89,104,9256,1.0,89,104,9256,0.8557692307692307,Medium,75.5,81.0,0.3199152542372881,0.3432203389830508,middle-left,55696,0.16618787704682564,Large (15-30%)
00001317.jpg,1300,956,781,89,1009,280,False,228,191,43548,1.3598326359832635,228,191,43548,1.193717277486911,Large,895.0,184.5,0.6884615384615385,0.19299163179916318,top-right,1242800,0.035040231734792406,Small (1-5%)
00002636.jpg,1024,683,281,199,395,287,False,114,88,10032,1.499267935578331,114,88,10032,1.2954545454545454,Medium,338.0,243.0,0.330078125,0.3557833089311859,middle-center,699392,0.014343887262079063,Small (1-5%)
00001459.jpg,612,485,257,116,377,226,False,120,110,13200,1.2618556701030927,120,110,13200,1.0909090909090908,Medium,317.0,171.0,0.5179738562091504,0.3525773195876289,middle-center,296820,0.04447139680614514,Small (1-5%)
00002150.jpg,1300,918,797,190,981,342,False,184,152,27968,1.4161220043572984,184,152,27968,1.2105263157894737,Large,889.0,266.0,0.6838461538461539,0.289760348583878,top-right,1193400,0.023435562259091672,Small (1-5%)
00002144.jpg,2000,1333,657,52,1233,509,False,576,457,263232,1.5003750937734435,576,457,263232,1.2603938730853392,Very Large,945.0,280.5,0.4725,0.21042760690172543,top-center,2666000,0.09873668417104275,Medium (5-15%)
00000753.jpg,467,700,99,10,299,358,False,200,348,69600,0.6671428571428571,200,348,69600,0.5747126436781609,Very Large,199.0,184.0,0.4261241970021413,0.26285714285714284,top-center,326900,0.2129091465279902,Large (15-30%)
00002622.jpg,800,533,447,310,591,421,False,144,111,15984,1.5009380863039399,144,111,15984,1.2972972972972974,Medium,519.0,365.5,0.64875,0.6857410881801126,bottom-center,426400,0.0374859287054409,Small (1-5%)
00002622.jpg,800,533,361,162,498,269,False,137,107,14659,1.5009380863039399,137,107,14659,1.280373831775701,Medium,429.5,215.5,0.536875,0.40431519699812385,middle-center,426400,0.03437851782363977,Small (1-5%)
00002622.jpg,800,533,157,106,297,215,False,140,109,15260,1.5009380863039399,140,109,15260,1.2844036697247707,Medium,227.0,160.5,0.28375,0.30112570356472795,top-left,426400,0.03578799249530957,Small (1-5%)
00002965.jpg,500,334,136,60,359,237,False,223,177,39471,1.4970059880239521,223,177,39471,1.2598870056497176,Large,247.5,148.5,0.495,0.44461077844311375,middle-center,167000,0.23635329341317365,Large (15-30%)
00000814.jpg,900,600,468,64,769,298,False,301,234,70434,1.5,301,234,70434,1.2863247863247864,Very Large,618.5,181.0,0.6872222222222222,0.3016666666666667,top-right,540000,0.13043333333333335,Medium (5-15%)
00000800.jpg,352,500,116,137,224,316,False,108,179,19332,0.704,108,179,19332,0.6033519553072626,Medium,170.0,226.5,0.48295454545454547,0.453,middle-center,176000,0.10984090909090909,Medium (5-15%)
00002971.jpg,390,280,131,38,228,118,False,97,80,7760,1.3928571428571428,97,80,7760,1.2125,Medium,179.5,78.0,0.46025641025641023,0.2785714285714286,top-center,109200,0.07106227106227106,Medium (5-15%)
00001288.jpg,500,750,182,54,292,244,False,110,190,20900,0.6666666666666666,110,190,20900,0.5789473684210527,Large,237.0,149.0,0.474,0.19866666666666666,top-center,375000,0.055733333333333336,Medium (5-15%)
00000196.jpg,1600,1168,895,170,1467,656,False,572,486,277992,1.36986301369863,572,486,277992,1.176954732510288,Very Large,1181.0,413.0,0.738125,0.3535958904109589,middle-right,1868800,0.1487542808219178,Medium (5-15%)
00002959.jpg,1200,630,564,106,1032,392,False,468,286,133848,1.9047619047619047,468,286,133848,1.6363636363636365,Very Large,798.0,249.0,0.665,0.3952380952380952,middle-center,756000,0.17704761904761904,Large (15-30%)
00002781.jpg,1000,1500,401,331,551,594,False,150,263,39450,0.6666666666666666,150,263,39450,0.5703422053231939,Large,476.0,462.5,0.476,0.30833333333333335,top-center,1500000,0.0263,Small (1-5%)
00000828.jpg,300,470,95,40,154,147,False,59,107,6313,0.6382978723404256,59,107,6313,0.5514018691588785,Medium,124.5,93.5,0.415,0.19893617021276597,top-center,141000,0.04477304964539007,Small (1-5%)
00002795.jpg,1000,760,680,170,848,319,False,168,149,25032,1.3157894736842106,168,149,25032,1.1275167785234899,Large,764.0,244.5,0.764,0.32171052631578945,top-right,760000,0.03293684210526316,Small (1-5%)
00000182.jpg,1024,681,583,128,859,342,False,276,214,59064,1.5036710719530102,276,214,59064,1.2897196261682242,Very Large,721.0,235.0,0.7041015625,0.34508076358296624,middle-right,697344,0.08469851321585903,Medium (5-15%)
00000169.jpg,480,720,209,299,260,389,False,51,90,4590,0.6666666666666666,51,90,4590,0.5666666666666667,Small,234.5,344.0,0.48854166666666665,0.4777777777777778,middle-center,345600,0.01328125,Small (1-5%)
00001277.jpg,500,749,203,173,282,307,False,79,134,10586,0.6675567423230975,79,134,10586,0.5895522388059702,Medium,242.5,240.0,0.485,0.3204272363150868,top-center,374500,0.02826702269692924,Small (1-5%)
00003460.jpg,235,353,72,78,123,168,False,51,90,4590,0.6657223796033994,51,90,4590,0.5666666666666667,Small,97.5,123.0,0.4148936170212766,0.34844192634560905,middle-center,82955,0.05533120366463745,Medium (5-15%)
00003306.jpg,779,900,155,187,671,867,False,516,680,350880,0.8655555555555555,516,680,350880,0.7588235294117647,Very Large,413.0,527.0,0.5301668806161746,0.5855555555555556,middle-center,701100,0.5004706889174155,Very Large (>30%)
00002018.jpg,1080,1080,204,81,861,846,False,657,765,502605,1.0,657,765,502605,0.8588235294117647,Very Large,532.5,463.5,0.4930555555555556,0.42916666666666664,middle-center,1166400,0.4309027777777778,Very Large (>30%)
00003312.jpg,800,800,268,228,538,542,False,270,314,84780,1.0,270,314,84780,0.8598726114649682,Very Large,403.0,385.0,0.50375,0.48125,middle-center,640000,0.13246875,Medium (5-15%)
00000155.jpg,1000,684,483,276,585,357,False,102,81,8262,1.4619883040935673,102,81,8262,1.2592592592592593,Medium,534.0,316.5,0.534,0.46271929824561403,middle-center,684000,0.012078947368421052,Small (1-5%)
00002024.jpg,612,436,189,17,423,214,False,234,197,46098,1.4036697247706422,234,197,46098,1.1878172588832487,Large,306.0,115.5,0.5,0.26490825688073394,top-center,266832,0.17276038855909337,Large (15-30%)
00002030.jpg,640,640,470,68,536,144,False,66,76,5016,1.0,66,76,5016,0.868421052631579,Medium,503.0,106.0,0.7859375,0.165625,top-right,409600,0.01224609375,Small (1-5%)
00002030.jpg,640,640,554,85,618,161,False,64,76,4864,1.0,64,76,4864,0.8421052631578947,Small,586.0,123.0,0.915625,0.1921875,top-right,409600,0.011875,Small (1-5%)
00002030.jpg,640,640,207,100,272,175,False,65,75,4875,1.0,65,75,4875,0.8666666666666667,Small,239.5,137.5,0.37421875,0.21484375,top-center,409600,0.01190185546875,Small (1-5%)
00002030.jpg,640,640,20,120,84,193,False,64,73,4672,1.0,64,73,4672,0.8767123287671232,Small,52.0,156.5,0.08125,0.24453125,top-left,409600,0.01140625,Small (1-5%)
00002030.jpg,640,640,283,94,353,174,False,70,80,5600,1.0,70,80,5600,0.875,Medium,318.0,134.0,0.496875,0.209375,top-center,409600,0.013671875,Small (1-5%)
00002030.jpg,640,640,383,134,445,207,False,62,73,4526,1.0,62,73,4526,0.8493150684931506,Small,414.0,170.5,0.646875,0.26640625,top-center,409600,0.0110498046875,Small (1-5%)
00002030.jpg,640,640,581,147,640,217,False,59,70,4130,1.0,59,70,4130,0.8428571428571429,Small,610.5,182.0,0.95390625,0.284375,top-right,409600,0.0100830078125,Small (1-5%)
00002030.jpg,640,640,117,121,177,191,False,60,70,4200,1.0,60,70,4200,0.8571428571428571,Small,147.0,156.0,0.2296875,0.24375,top-left,409600,0.01025390625,Small (1-5%)
00001539.jpg,864,1300,206,391,450,808,False,244,417,101748,0.6646153846153846,244,417,101748,0.5851318944844125,Very Large,328.0,599.5,0.37962962962962965,0.46115384615384614,middle-center,1123200,0.09058760683760683,Medium (5-15%)
00000141.jpg,334,519,162,106,261,280,False,99,174,17226,0.6435452793834296,99,174,17226,0.5689655172413793,Medium,211.5,193.0,0.6332335329341318,0.371868978805395,middle-center,173346,0.09937350732061888,Medium (5-15%)
00000141.jpg,334,519,44,88,147,270,False,103,182,18746,0.6435452793834296,103,182,18746,0.5659340659340659,Medium,95.5,179.0,0.28592814371257486,0.3448940269749518,middle-left,173346,0.10814209730827362,Medium (5-15%)
00002756.jpg,1600,1157,68,15,409,302,False,341,287,97867,1.382886776145203,341,287,97867,1.1881533101045296,Very Large,238.5,158.5,0.1490625,0.13699222126188418,top-left,1851200,0.05286678910976664,Medium (5-15%)
00002756.jpg,1600,1157,338,354,672,635,False,334,281,93854,1.382886776145203,334,281,93854,1.188612099644128,Very Large,505.0,494.5,0.315625,0.42739844425237683,middle-left,1851200,0.05069900605012965,Medium (5-15%)
00002756.jpg,1600,1157,826,215,1153,484,False,327,269,87963,1.382886776145203,327,269,87963,1.2156133828996283,Very Large,989.5,349.5,0.6184375,0.3020743301642178,top-center,1851200,0.04751674589455488,Small (1-5%)
00002756.jpg,1600,1157,1105,92,1462,392,False,357,300,107100,1.382886776145203,357,300,107100,1.19,Very Large,1283.5,242.0,0.8021875,0.20916162489196197,top-right,1851200,0.05785436473638721,Medium (5-15%)
00002756.jpg,1600,1157,606,483,986,804,False,380,321,121980,1.382886776145203,380,321,121980,1.1838006230529594,Very Large,796.0,643.5,0.4975,0.5561797752808989,middle-center,1851200,0.06589239412273121,Medium (5-15%)
00001908.jpg,626,938,289,78,359,200,False,70,122,8540,0.6673773987206824,70,122,8540,0.5737704918032787,Medium,324.0,139.0,0.5175718849840255,0.14818763326226012,top-center,587188,0.01454389394878642,Small (1-5%)
00001934.jpg,1500,1120,662,91,1067,443,False,405,352,142560,1.3392857142857142,405,352,142560,1.1505681818181819,Very Large,864.5,267.0,0.5763333333333334,0.23839285714285716,top-center,1680000,0.08485714285714285,Medium (5-15%)
00002583.jpg,900,600,235,105,462,282,False,227,177,40179,1.5,227,177,40179,1.2824858757062148,Large,348.5,193.5,0.38722222222222225,0.3225,top-center,540000,0.07440555555555556,Medium (5-15%)
00000380.jpg,1500,1000,452,100,1265,717,False,813,617,501621,1.5,813,617,501621,1.3176661264181524,Very Large,858.5,408.5,0.5723333333333334,0.4085,middle-center,1500000,0.334414,Very Large (>30%)
00002597.jpg,681,1024,277,190,425,450,False,148,260,38480,0.6650390625,148,260,38480,0.5692307692307692,Large,351.0,320.0,0.5154185022026432,0.3125,top-center,697344,0.05518080029368576,Medium (5-15%)
00001920.jpg,865,1300,370,138,469,310,False,99,172,17028,0.6653846153846154,99,172,17028,0.5755813953488372,Medium,419.5,224.0,0.48497109826589596,0.1723076923076923,top-center,1124500,0.015142730102267675,Small (1-5%)
00001713.jpg,334,518,148,53,191,131,False,43,78,3354,0.6447876447876448,43,78,3354,0.5512820512820513,Small,169.5,92.0,0.5074850299401198,0.1776061776061776,top-center,173012,0.019385938547615195,Small (1-5%)
00003104.jpg,511,340,64,1,423,260,False,359,259,92981,1.5029411764705882,359,259,92981,1.386100386100386,Very Large,243.5,130.5,0.4765166340508806,0.38382352941176473,middle-center,173740,0.5351732473811442,Very Large (>30%)
00001075.jpg,570,537,203,20,361,197,False,158,177,27966,1.0614525139664805,158,177,27966,0.8926553672316384,Large,282.0,108.5,0.49473684210526314,0.20204841713221602,top-center,306090,0.09136528472018034,Medium (5-15%)
00001061.jpg,2000,3000,582,222,1111,1164,False,529,942,498318,0.6666666666666666,529,942,498318,0.5615711252653928,Very Large,846.5,693.0,0.42325,0.231,top-center,6000000,0.083053,Medium (5-15%)
00003110.jpg,600,400,95,100,272,237,False,177,137,24249,1.5,177,137,24249,1.2919708029197081,Large,183.5,168.5,0.30583333333333335,0.42125,middle-left,240000,0.1010375,Medium (5-15%)
00000419.jpg,489,500,238,105,326,209,False,88,104,9152,0.978,88,104,9152,0.8461538461538461,Medium,282.0,157.0,0.5766871165644172,0.314,top-center,244500,0.03743149284253579,Small (1-5%)
00001707.jpg,800,534,381,13,575,160,False,194,147,28518,1.4981273408239701,194,147,28518,1.3197278911564625,Large,478.0,86.5,0.5975,0.16198501872659177,top-center,427200,0.06675561797752809,Medium (5-15%)
00003138.jpg,508,339,207,72,444,260,False,237,188,44556,1.4985250737463127,237,188,44556,1.2606382978723405,Large,325.5,166.0,0.640748031496063,0.4896755162241888,middle-center,172212,0.2587276148003623,Large (15-30%)
00001049.jpg,1024,683,345,83,736,387,False,391,304,118864,1.499267935578331,391,304,118864,1.2861842105263157,Very Large,540.5,235.0,0.52783203125,0.3440702781844802,middle-center,699392,0.1699533308931186,Large (15-30%)
00002540.jpg,276,340,71,62,172,206,False,101,144,14544,0.8117647058823529,101,144,14544,0.7013888888888888,Medium,121.5,134.0,0.44021739130434784,0.3941176470588235,middle-center,93840,0.15498721227621484,Large (15-30%)
00002554.jpg,1200,900,451,107,707,330,False,256,223,57088,1.3333333333333333,256,223,57088,1.147982062780269,Very Large,579.0,218.5,0.4825,0.2427777777777778,top-center,1080000,0.05285925925925926,Medium (5-15%)
00002232.jpg,620,349,4,36,186,158,False,182,122,22204,1.7765042979942693,182,122,22204,1.4918032786885247,Large,95.0,97.0,0.1532258064516129,0.27793696275071633,top-left,216380,0.10261576855531934,Medium (5-15%)
00002232.jpg,620,349,122,103,344,248,False,222,145,32190,1.7765042979942693,222,145,32190,1.5310344827586206,Large,233.0,175.5,0.3758064516129032,0.502865329512894,middle-center,216380,0.14876605970976986,Medium (5-15%)
00002232.jpg,620,349,258,118,541,303,False,283,185,52355,1.7765042979942693,283,185,52355,1.5297297297297296,Very Large,399.5,210.5,0.6443548387096775,0.6031518624641834,middle-center,216380,0.24195859136703946,Large (15-30%)
00002232.jpg,620,349,215,11,362,108,False,147,97,14259,1.7765042979942693,147,97,14259,1.5154639175257731,Medium,288.5,59.5,0.4653225806451613,0.17048710601719197,top-center,216380,0.06589795729734726,Medium (5-15%)
00002232.jpg,620,349,330,1,487,81,False,157,80,12560,1.7765042979942693,157,80,12560,1.9625,Medium,408.5,41.0,0.6588709677419354,0.1174785100286533,top-center,216380,0.05804603013217488,Medium (5-15%)
